homem	pessoa/grupo/humano/indivíduo/marido/adulto/macho/agrupação
casa	lugar/família/ambiente/edifício/abertura/habitação/residência/prédio/lar/morada/vivenda/moradia/domicílio
mulher	pessoa/indivíduo/adulto/cônjuge/fêmea
água	coisa/líquido/vertente/substância/alimento/comida/nutriente
dinheiro	moeda/riqueza
criança	pessoa/jovem/filho/indivíduo/menino/menor/macho
campo	região/espaço/terreno/extensão/esfera
edifício	construção/estrutura/artefato
carta	papel/documento/texto/peixe
carro	veículo
arma	instrumento/armamento/ferramenta
estrada	meio/modo/caminho/via
automóvel	veículo
olho	abertura/órgão/buraco/janela/furo/orifício
máquina	pessoa/indivíduo/instrumento/aparelho/mecanismo/dispositivo/utensílio
animal	ser/pessoa/organismo
viatura	veículo
caixa	local/livro/moeda/contentor/recipiente
sol	local/sinal/luz/personagem/nota/estrela
cientista	pessoa/indivíduo
massa	grupo/dinheiro/corpo/quantidade/pasta/multidão/substância/mistura/turba
rapaz	homem/criança/masculino/menor/macho
café	local/estabelecimento/restaurante/árvore/bebida/semente
fruto	produção/produto
rapariga	mulher/moça
janela	estrutura/abertura/buraco
montanha	série/elevação
perna	apoio/membro/suporte/segmento
alimento	substância/comida/alimentação/pão/nutrição/mantimento/nutriente
chave	lista/objecto/instrumento/aparelho/mecanismo/dispositivo
folha	papel/imprensa/órgão/placa/pedaço/chapa/lâmina
armazém	estabelecimento/depósito
corda	linha/segmento/fio/lâmina
menino	pessoa/criança/indivíduo/rapaz/menor/macho/garoto/moço
pano	peça/tecido/pedaço/artefato
fumo	tabaco/erva/vapor/tira/evaporação/maconha
táxi	carro/automóvel/máquina/veículo/viatura/auto/carruagem
cofre	caixa
arco	entrada/estrutura/edifício/arma/objecto/instrumento/boca/curva/vara/pau
rosa	coisa/flor/mato/arbusto/moita
tinta	cor/líquido/substância/capa
lágrima	gota/pérola
esposa	mulher/cônjuge
balança	instrumento/símbolo/signo/constelação
farmácia	arte/estabelecimento/loja/colecção/profissão
bacalhau	peixe
camisa	peça/roupa/vestuário/folhelho
ambulância	veículo
alumínio	metal
xadrez	jogo/engradamento
