fazer	cumprir/realizar/representar/refazer/acabar/participar/ter/criar/praticar/recitar/responder/tornar/interpretar/intentar/motivar/surpreender/incitar/cometer/publicar/ocasionar/reagir/provocar/produzir/recompensar/esperar/ensaiar/causar/parir/construir/lutar/continuar/tentar/declamar/gerar/alternar/executar/prosseguir/aparecer/ousar/empreender/estimular/exercer/começar/proceder/premiar/reproduzir/atentar/procurar/efetuar
ir	saltar/acompanhar/andar/sair/rodar/ascender/adiantar/perseguir/recuar/avançar/dar/seguir/descer/deslizar/correr/continuar/demorar/viajar/voar/vir/subir/progredir/escapar/regressar/cair/caminhar/passar/preceder/circular/abandonar/escorregar/acelerar/partir/nadar/pousar
dizer	acentuar/notar/falar/resumir/apresentar/comentar/resmungar/sussurrar/dar/declarar/manifestar/articular/mencionar/denunciar/pronunciar/generalizar/responder/preceder/murmurar/denotar/proclamar/cantar/introduzir/entusiasmar/explicar/anunciar/indicar
dar	contribuir/contagiar/confiar/apresentar/dotar/pagar/conceder/concorrer/permitir/entregar/coincidir/outorgar/incluir/legar/vir/livrar/abastecer/facultar/oferecer/distribuir/facilitar/passar/cair/emprestar/renunciar/equipar/encarregar/abandonar/investir/transmitir/internar/alugar/fornecer/sair/acontecer/deixar/devolver/atribuir/ceder/prover/adjudicar/doar/render/transferir/abrir/compensar/suprir/prestar/depositar/suceder
ver	divisar/sentir/entrever/sonhar/apreciar/descobrir/detectar/enxergar/contemplar/olhar/admirar/controlar/observar
passar	livrar/sair/acontecer/confiar/fazer/cruzar/penetrar/cair/renunciar/encarregar/esfregar/concorrer/dar/entregar/coincidir/correr/atravessar/suceder/vir
vir	chegar/desembarcar/cair
afirmar	confirmar/provar/demonstrar/reafirmar/arguir/verificar
deixar	consentir/suportar/autorizar/curtir/engolir/dar/permitir/legitimar/incluir/romper/legalizar/sofrer/demorar/aturar/compadecer/comportar/renunciar/admitir/abandonar/padecer/digerir/aguentar/tolerar/tragar/partir/gramar
considerar	sentir/ver/repensar/rever/valorizar/apreciar/deduzir/comparar/julgar/olhar/incluir/prezar/favorecer/contar/estimar
começar	inaugurar/abrir
conseguir	alugar/recuperar/aceitar/lucrar/obter/realizar/recobrar/lograr/receber/ganhar/alcançar/adquirir
apresentar	tencionar/projetar/expor/argumentar/levar/exibir/dar/revelar/desvendar/manifestar/posar/mostrar/abrir
encontrar	cruzar/localizar/descobrir
acabar	resolver/cumprir/culminar/executar/realizar/encerrar/desaparecer/parar/decidir/dissolver/abandonar/finalizar/concluir/terminar/extinguir/apagar/interromper/romper/completar
falar	generalizar/conversar/acentuar/prosseguir/murmurar/discursar/cantar/comentar/sussurrar/resmungar/fofocar/discutir/declarar/entusiasmar/debater/continuar/anunciar/pronunciar
permitir	comportar/suportar/consentir/autorizar/curtir/admitir/aprovar/padecer/engolir/digerir/aguentar/tolerar/tragar/legitimar/incluir/legalizar/sofrer/aturar/compadecer/sancionar/gramar
receber	alugar/lucrar/obter/reconquistar/lograr/ganhar/colher/beneficiar/isolar/adquirir/conseguir/recuperar/reaver/encontrar/recolher/aceitar/comprar/recobrar/auferir/reunir/herdar
realizar	sair/cumprir/culminar/edificar/fazer/provocar/montar/produzir/compor/recortar/causar/consumar/construir/dar/bastar/gerar/chegar/procriar/instituir/criar/originar/organizar/estimular/derivar/começar/recriar/fabricar/preparar/reproduzir/reunir/incitar/engendrar
abrir	criar/estabelecer/inaugurar/desenvolver/destrancar/desatar
manter	conservar/guardar/preservar/armazenar/prosseguir/proclamar/persistir/arguir/perpetuar/declarar/afirmar/reter/alegar/acumular/continuar/negar/perseverar/prolongar
pensar	sentir/inferir/remoer/raciocinar/interligar/concluir/deduzir/suspeitar/dar/matutar/planejar/ligar/cogitar/refletir/cismar/centrar/conectar/ver/associar/ponderar/julgar/contemplar/opinar/prestar/considerar/parafusar/magicar/caracterizar/banzar/focar/meditar/ruminar
acontecer	resultar/concorrer/coincidir/ir/materializar/cair/suceder/repetir/vir
entrar	perfurar/invadir/penetrar/embarcar
criar	publicar/edificar/fazer/provocar/fixar/montar/produzir/compor/recortar/causar/construir/conceber/desenvolver/gerar/procriar/instituir/originar/cruzar/organizar/pintar/estimular/derivar/começar/recriar/fabricar/preparar/reproduzir/reunir/incitar/engendrar
tentar	batalhar/arriscar/expor/esforçar
pôr	botar/encostar/inserir/semear/assentar/arranjar/dispor/sentar/aconchegar/engarrafar/sepultar/enterrar/introduzir/sobrepor/plantar/situar/instalar/depositar/espaçar/repor/deitar/colocar/justapor/apoiar
explicar	justificar/esclarecer/interpretar
defender	proteger/justificar/guardar/preservar/suportar/resistir/desculpar/salvar/salvaguardar/cobrir
decidir	decretar/resolver/escolher/julgar/governar/medir/regularizar/selecionar/eleger/concertar/regular
contar	relatar/somar
tomar	adotar/sorver/provar/lucrar/aliviar/arrebatar/lograr/retirar/comer/segurar/experimentar/aproveitar/engolir/chupar/desnudar/confiscar/libar/pegar/ingurgitar/tirar/agarrar/ter/lamber/arrancar/despir/apreender/aceitar/fartar/privar/beber/capturar/usar/acumular/fumar/reunir/sugar
pedir	mendigar/rogar/reservar/reivindicar/convidar/reclamar/solicitar/chamar/convocar/encomendar/requerer/invitar/exigir
sair	escapar/partir/vazar/demorar/abandonar
colocar	assentar/dirigir/sentar/enfiar/aconchegar/especular/sobrepor/plantar/apoiar/encostar/inserir/semear/arranjar/dispor/engarrafar/orientar/pôr/introduzir/situar/instalar/depositar/espaçar/repor/deitar/justapor
mostrar	tencionar/projetar/enfatizar/formular/expor/ostentar/apresentar/exibir/demonstrar/revelar/desvendar/sugerir/manifestar/alegar/evocar/refletir/apontar
pagar	contribuir/financiar/devolver/corromper/reparar/recompensar/despender/remunerar/compensar/ressarcir/expender/subornar/indenizar/enviar/gastar/reembolsar
tornar	urbanizar/aprimorar/reduzir/confundir/transviar/aumentar/acabar/terminar/despertar/viciar/afazer/centralizar/colocar/aviltar/desvirtuar/aquecer/corromper/gelar/apodrecer/estragar/contaminar/adornar/exacerbar/desodorizar/dissolver/misturar/encobrir/minar/subverter/ocultar/relaxar/refrigerar/agravar/desligar/temperar/transformar/endurecer/concluir/incrementar/revolucionar/limpar/enfeitar/vestir/animalizar/fechar/modificar/alentar/obscurecer/restabelecer/fertilizar/engordar/encher/arrefecer/ulcerar/pôr/equiparar/preparar/fecundar/manchar/embelezar/ajustar/desestabilizar/esquentar/nivelar/acurar/moderar/aguçar/debilitar/melhorar/degenerar/converter/acordar/desencaminhar/afiar/chamar/perverter/permitir/afetar/desenvolver/desmoralizar/habilitar/corrigir/madurar/deformar/habituar/adulterar/amadurecer/simplificar/costumar/desagravar/empestar/unir/debochar/depravar/decorar/paramentar/requintar/secar/concentrar/degradar/acalmar/congelar/emulsionar/esfriar/animar/fazer/diminuir/aperfeiçoar/recolher/burilar/civilizar/esvaziar/piorar/apurar/acostumar/alterar/refrescar/abrir/esmerar/abastardar/levantar/desregrar/acrescentar/complicar/destruir/purificar/comparar/estar/estabelecer/transportar/igualar/recair/preencher/naturalizar/esconder/desmanchar
lançar	arrojar/atirar/jogar
acrescentar	adicionar/subir/avultar/altear/crescer/enriquecer/alargar/combinar/ampliar/aumentar/misturar/amontoar/intensificar/elevar/unir/qualificar/incluir/alongar/estender/modificar/acumular/reunir/prolongar
trabalhar	ocupar/lavrar/assistir/ajudar/colaborar/servir/exercer
escrever	transcrever/registrar/assinar/subscrever/redigir/anotar/citar/rabiscar
representar	constituir/ressaltar/fazer/pintar/formar/apresentar/compor/personificar/encarnar/dar/desenhar/revelar/caracterizar/mostrar/propor
aceitar	adotar/consentir/deixar/abraçar/confiar/admitir/ceder/engolir/crer/permitir/honrar/reconhecer/acreditar
tratar	medicar/conduzir/dirigir/falar/organizar/discursar/cauterizar/cuidar/administrar/curar/manipular/massagear/analisar/operar/dispensar
atingir	alugar/lucrar/culminar/obter/reconquistar/lograr/ganhar/beneficiar/isolar/conseguir/adquirir/encontrar/recuperar/reaver/recolher/aceitar/comprar/recobrar/chocar/receber/auferir/herdar
terminar	cumprir/culminar/realizar/encerrar/parar/concluir/acabar/extinguir/desempenhar/apagar/romper/suspender/clausurar/resolver/executar/abortar/desaparecer/decidir/arrematar/dissolver/finalizar/abandonar/interromper/matar/completar/efetuar
utilizar	oferecer/explorar/desfrutar/consagrar/desperdiçar/aproveitar/comprometer/sagrar/exercer/tributar/recorrer/devotar/reciclar/dedicar/compartilhar/aplicar/partilhar/perder/gozar
provocar	originar/ocasionar/molestar/irritar/impulsionar/estimular/comover/impelir/importunar/fomentar/perturbar/incomodar/concitar/incitar/seduzir
registar	documentar/registrar/gravar/fotografar/marcar/inscrever
