próprio	competente/bom/pertinente/respectivo/natural/peculiar/particular/genuíno/especial/privativo/cómodo
único	só/sem-segundo/incomparável/sozinho/inigualável/uno/particular/privilegiado/singular/unário/simples/isolado
antigo	ancestral/obsoleto/senecto/velho/vedro/vetusto/ancião/prisco
longo	prolixo/comprido/extenso
plano	macio/plaino/direito/raso/chão
junto	conjunto/anexo/adjunto/vizinho/ajuntado/contíguo/apenso/unido
claro	declarado/lúcido/espelhento/branco/sereno/perspícuo/nítido/alvo/literal/cândido/flagrante/aberto/categórico/inegável/diáfano/desvelado/inteligível/óbvio/preciso/inequívoco/cristalino/limpo/fácil/patente/luminoso/aparente/notório/distinto/explícito/evidente/directo/transparente/manifesto/visível
mau	perro/cruel/sinistro/maligno/perigoso/pernicioso/maléfico/avesso/perverso/negro/ruim/prejudicial/malvado/satânico/macareno/malévolo/nocivo
recente	moderno/fresco/hodierno/tenro/novo
verdadeiro	sincero/sério/fiel/franco/histórico/certo/real/exato/legítimo/positivo/veraz/puro/efectivo/verídico/efetivo/vero
comum	corrente/standard/frequente/geral/familiar/público/prosaico/ramerraneiro/simples/medíocre/trivial/vulgar/ordinário
capaz	competente/digno/suficiente/susceptível/apropriado/apto/hábil/idóneo
interno	intestino/interior
branco	cano/lacticolor/alvo/cão
enorme	desmesurado/ingente/sobejo/desmedido/espantoso/agigantado/incomensurável/homérico/desproporcionado/incalculável/descompassado/descomunal/imenso/monstruoso/eterno/terrível/monumental/colossal
fundamental	primeiro/básico/primário/central/substancial/radical/cardeal/orgânico/elementar/vital/decisivo
sério	solene/austero/grave/probo/perigoso/judicioso/capaz/crítico/sentencioso/conspícuo/sisudo/severo/íntegro/honesto
demasiado	sobrado/sobejo/excessivo/descomedido/demais/nímio
essencial	capital/obrigatório/substancial/radical/cardeal/basilar/crucial/fundamental/constitutivo/principal/básico/central/precípuo/elementar/vital
semelhante	par/similar/semelhável/comparado/vizinho/parceiro/parente/paralelo/aparente/parecido/símile/cômpar/símil/convizinho/análogo/parelho/parecente/idêntico
habitual	normal/usual/consueto/costumeiro/sólito/acostumado/ordinário/familiar/costumado/regular/comum/clássico
vizinho	vicinal/adjacente/finítimo/pegado/chegado/imediato/convizinho/rente/cercão/próximo/propínquo
evidente	ostensível/axiomático/declarado/óbvio/inequívoco/perspícuo/certo/palpável/patente/formal/notório/aparente/flagrante/aberto/inegável/irrefutável/intuitivo/manifesto/transparente/iniludível
elevado	procero/proeminente/exaltado/subido/belo/alto/exorbitante/grandíloquo/eminente/altíloquo/nobre/altivo/graduado/privilegiado/grandioso/imódico/supino
excelente	mimoso/famoso/genial/delicioso/magnífico/brilhante/fino/especial/espantoso/excelso/eminente/superior/primoroso/soberano/porreiro/sensacional/maravilhoso/exímio/espetacular/opimo/prestante/pindérico/ótimo/óptimo
pronto	prestes/súbito/preparado/aposto/vivaz
fraco	escanastrado/frouxo/ameninado/ignavo/franzino/abatido/decrépito/frágil/delicado/débil/impotente/pálido/mulherico/insignificante/doente/lânguido/imbele/magro
puro	sagrado/pudico/virgem/alvo/donzel/simples/cândido/incorrupto/santo/ático/mundo/castiço/limpo/singelo/legítimo/terso/columbino/casto/angélico/intemerato/impoluto/ingênuo/inviolado/estreme/intacto
passageiro	efêmero/transitório/precário/passadiço/transiente/momentâneo/interino/fátuo/fluxo/meteórico/provisório/perfunctório/temporal/breve/mortal
marítimo	oceânico/marinho/pelágico
eficaz	seguro/virtuoso/válido/efetuoso/eficiente/santo/efetivo/presentâneo
belo	perfeito/bonito/delicado/radiante/luminoso/rico/bem-parecido/galante/formoso/estético/pulcro/preclaro/especioso/lindo
patente	pátulo/descoberto/notório/óbvio/pérvio/exposto/comperto/franco/manifesto
intenso	violento/grave/profundo/ardente/rijo/denso/forte/vivo/volumoso/agudo/acrisolado/grande
indispensável	necessário/obrigatório/essencial/urgente/fundamental/forçoso/vital
autêntico	verdadeiro/original/confiável/real/genuíno/lídimo/legítimo
célebre	famoso/ínclito/abalizado/ilustre/famigerado/brilhante/insigne/falado/memorável/eminente/afamado/distinto/nomeado/nobre/preclaro/esclarecido/egrégio/assinalado
preto	negro/atro
provisório	provisional/temporário
rural	rústico/pastoril/agrário
contínuo	frequente/permanente/aturado/assíduo/sucessivo/contino/perpétuo/incessante/continuado/porfioso/perene/seguido/ininterrupto
perito	experto/sabido/adestrado/destro/matraqueado/esperto/entendedor/sábio/versado/louvado/conhecido/entendido
amplo	latitudinário/lato/aberto/extensivo/ancho/camposo/largo/capaz/grande/folgado/vasto
mortal	perecedouro/perecedor/letal/morredouro/transitório/mortífero/fatal
brilhante	lúcido/florescente/luzente/espelhento/magnífico/nítido/lustroso/radiante/rutilante/ostentoso/esplêndido/preclaro/flamante/luzidio/radioso/luculento/flamejante/claro/luminoso/áureo/micante/pomposo/fulgente/flórido/luzido/estelante/fúlgido
distinto	preeminente/excelente/qualificado/marcado/esmerado/discreto/alto/notável/elegante/patrício/diverso/primoroso/conspícuo/exímio/extremado/separado/galhardo/garboso/inteligível/proeminente/ínclito/abalizado/diferente/fino/especial/emérito/superior/nobre/galante/graduado/privilegiado/esclarecido
firme	seguro/tenaz/fiel/assente/consistente/sólido/inconcusso/indestrutível/testo
calmo	imperturbado/plácido/remansado/bonançoso/quedo/tranquilo/sereno/silencioso/manso/remansoso/pacato
modesto	recatado/desartificioso/humilde/caseiro/despretensioso/composto/módico/pequeno/simples
agradável	gentil/delicioso/amável/brando/fausto/temperado/regalado/fruitivo/aprazível/atraente/grato/simpático/macio/mavioso/risonho/jucundo/deleitável/amorável/melodioso/fagueiro/cordial/lindo/lobeiro/cariciável
