obra	plural
relação	plural
coisa	plural
direito	plural
noite	metáfora
condição	plural
tarde	metáfora
população	plural
morte	eufemismo
modo	plural
termo	plural
base	plural
ordem	plural
face	sinédoque
autoridade	plural
entrada	plural
gente	plural
debate	plural
povo	plural
resto	plural
intenção	plural
prisão	calão/gíria/jargão
maneira	plural
respeito	plural
canal	plural
sede	plural
bairro	calão/gíria/jargão
chinês	calão/gíria/jargão
cor	plural
verão	metáfora
habitação	plural
crédito	plural
tom	plural
cadeia	calão/gíria/jargão
desejo	plural
obrigação	plural
rico	plural
judeu	calão/gíria/jargão
mecanismo	plural
superfície	plural
cientista	calão/gíria/jargão
assalto	calão/gíria/jargão
sexo	vulgaridade/palavrão/indecência/obscenidade/calão/gíria/jargão
cumprimento	plural
cara	plural/sinédoque
ronda	plural
rosto	sinédoque
telecomunicação	plural
desempregado	plural
mina	calão/gíria/jargão
pobreza	plural
tecido	plural
apartamento	plural
chefia	plural
windows	marca
quartel	plural
lar	sinédoque
móvel	plural
deliberação	plural
mobiliário	plural
escada	plural
monopólio	marca
espólio	plural
coroa	plural
asa	plural
calça	plural
meia	plural
matriz	plural
relações	plural
vara	vulgaridade/palavrão/indecência/obscenidade
nervo	plural
pau	vulgaridade/palavrão/indecência/obscenidade
reticência	plural
acessório	plural
moradia	plural
luto	plural
tronco	plural
barriga	calão/gíria/jargão
foguete	plural
saudação	plural
rabo	calão/gíria/jargão
conexão	plural
aparelhagem	plural
pilhagem	plural
esmola	plural
chaminé	sinédoque
raridade	plural
merda	vulgaridade/palavrão/indecência/obscenidade
urina	vulgaridade/palavrão/indecência/obscenidade
casca	plural
pénis	vulgaridade/palavrão/indecência/obscenidade
convés	plural
salina	plural
jeans	plural
chance	plural
mobília	plural
confraria	plural
estima	plural
binóculo	plural
cueca	plural
arauto	formalidade
tesoura	plural
farpa	plural
devastação	plural
neutralização	eufemismo
mantimento	plural
sapatilha	plural
tenaz	plural
short	plural
forca	plural
fole	plural
presídio	calão/gíria/jargão
soluço	plural
algema	plural
garota	calão/gíria/jargão
rola	vulgaridade/palavrão/indecência/obscenidade
walkman	marca
verga	vulgaridade/palavrão/indecência/obscenidade
mexerico	calão/gíria/jargão
ânus	calão/gíria/jargão
pinto	vulgaridade/palavrão/indecência/obscenidade
collants	plural
chuteira	plural
plasticina	marca
cacete	vulgaridade/palavrão/indecência/obscenidade
aveia	plural
suspensório	plural
tralha	plural
alicate	plural
expiração	eufemismo
gabardine	plural
castanhola	plural
caralho	vulgaridade/palavrão/indecência/obscenidade
arquibancada	plural
calcinha	plural
depredação	plural
bosta	vulgaridade/palavrão/indecência/obscenidade
fedor	calão/gíria/jargão
cadafalso	plural
pica	vulgaridade/palavrão/indecência/obscenidade
borra	plural
eta	plural
bermuda	plural
pê	vulgaridade/palavrão/indecência/obscenidade
pipi	vulgaridade/palavrão/indecência/obscenidade
ferraria	plural
fórceps	plural
winchester	marca
xixi	vulgaridade/palavrão/indecência/obscenidade
vaselina	marca
abc	plural
mijo	vulgaridade/palavrão/indecência/obscenidade
patíbulo	plural
soqueira	plural
besteira	vulgaridade/palavrão/indecência/obscenidade/calão/gíria/jargão
sapatão	calão/gíria/jargão
velcro	marca
fedayin	plural
cara-pálida	calão/gíria/jargão
foda	vulgaridade/palavrão/indecência/obscenidade/calão/gíria/jargão
picha	vulgaridade/palavrão/indecência/obscenidade
ativo	plural
besteirol	calão/gíria/jargão
kleenex	marca
baquelite	marca
freon	marca
pyrex	marca
scrabble	marca
umma	plural
fufa	calão/gíria/jargão
torquês	plural
white_trash	calão/gíria/jargão
lavanderia	plural
cagalhão	vulgaridade/palavrão/indecência/obscenidade
duralumínio	marca
cocô	vulgaridade/palavrão/indecência/obscenidade
frisbee	marca
culote	plural
