dialeto	harmonioso/sonoro
eufemismo	expiração/falecido/neutralização/morto/morte
metáfora	verão/tarde/noite
jargão	fufa/sapatão/ânus/rabo/foda/sexo/bairro/fedor/garota/mina/barriga/chinês/judeu/prisão/cadeia/presídio/assalto/cientista/mexerico/cara-pálida/besteira/besteirol
língua	harmonioso/sonoro
palavrão	cacete/vara/cagalhão/bosta/cocô/pau/merda/pinto/verga/picha/caralho/pénis/rola/pica/besteira/foda/sexo/pê/urina/mijo/pipi/xixi
vulgaridade	cacete/vara/cagalhão/bosta/cocô/pau/merda/pinto/verga/picha/caralho/pénis/rola/pica/besteira/foda/sexo/pê/urina/mijo/pipi/xixi
plural	ronda/salina/fole/aparelhagem/desejo/fedayin/superfície/rico/raridade/convés/arquibancada/aveia/ferraria/soqueira/suspensório/desempregado/esmola/luto/gabardine/devastação/reticência/ETA/casca/abc/depredação/estima/cumprimento/asa/relação/relações/fórceps/pobreza/sapatilha/telecomunicação/ordem/bermuda/cueca/calça/tecido/chuteira/patíbulo/forca/cadafalso/canal/ativo/mantimento/culote/Umma/deliberação/debate/maneira/modo/resto/base/sede/matriz/short/borra/meia/espólio/pilhagem/mecanismo/tralha/coisa/obrigação/torquês/alicate/tenaz/algema/jeans/condição/termo/escada/entrada/coroa/tom/nervo/farpa/calcinha/tesoura/quartel/saudação/obra/respeito/gente/povo/população/soluço/conexão/confraria/castanhola/mobiliário/móvel/mobília/cara/direito/binóculo/lavanderia/foguete/intenção/tronco/cor/chance/acessório/chefia/autoridade/crédito/moradia/habitação/apartamento/Via_Crucis
obscenidade	cacete/vara/cagalhão/bosta/cocô/pau/merda/pinto/verga/picha/caralho/pénis/rola/pica/besteira/foda/sexo/pê/urina/mijo/pipi/xixi
marca	frisbee/Winchester/Kleenex/duralumínio/Linux/plasticina/velcro/Freon/Windows/Microsoft_Windows/vaselina/baquelite/Spam/Rollerblade/Monopólio
ironia	realmente/merecedor/digno
acrónimo	NIMBY/MPEG
formalidade	arauto
gíria	fufa/sapatão/ânus/rabo/foda/sexo/bairro/fedor/garota/mina/barriga/chinês/judeu/prisão/cadeia/presídio/assalto/cientista/mexerico/cara-pálida/besteira/besteirol
calão	fufa/sapatão/ânus/rabo/foda/sexo/bairro/fedor/garota/mina/barriga/chinês/judeu/prisão/cadeia/presídio/assalto/cientista/mexerico/cara-pálida/besteira/besteirol
idioma	harmonioso/sonoro
dialecto	harmonioso/sonoro
sigla	NIMBY/MPEG
indecência	cacete/vara/cagalhão/bosta/cocô/pau/merda/pinto/verga/picha/caralho/pénis/rola/pica/besteira/foda/sexo/pê/urina/mijo/pipi/xixi
comparativo	anterior/menos/melhor/pior
