Brigadas_vermelhas	Itália/Italia/República_Italiana
Babilónia	Mesopotâmia
revolução_cultural	República_Popular_da_China/China
ministro	Reino_Unido/Grã-Bretanha/Reino-Unido
Revolução_Francesa	República_Francesa/França
legionário	República_Francesa/França
calamar	Itália/Italia/República_Italiana
moshav	Israel/Estado_de_Israel
Floresta_negra	Alemanha/República_Federal_da_Alemanha
trojan	Grécia
torrada	México/Estados_Unidos_Mexicanos
mercantilismo	Europa
polenta	Itália/Italia/República_Italiana
conquistador	Espanha/México/Estados_Unidos_Mexicanos
negra	Africa/África
par	Reino_Unido/Grã-Bretanha/Reino-Unido
avaliador	Reino_Unido/Grã-Bretanha/Reino-Unido
paella	Espanha
Associação_de_defesa_do_ulster	Irlanda_do_Norte
Guerra_da_Coreia	Coréia/Coreia
bilhão	Reino_Unido/Grã-Bretanha/Reino-Unido/Estados_Unidos/EUA/E.U.A.
Revolução_cultural_chinesa	República_Popular_da_China/China
Movimento_Revolucionário_Tupac_Amaru	Peru
Exército_Vermelho_Japonês	Japão
Cartel_de_Medellín	Colômbia/Colombia/Colómbia
galego	Espanha
lavabo	Reino_Unido/Grã-Bretanha/Reino-Unido
Moshav	Israel/Estado_de_Israel
Guerra_dos_Seis_Dias	Médio_Oriente/Médio-Oriente/Oriente_Médio
tribo	Estados_Unidos/EUA/E.U.A.
ETA	Espanha
Código_de_estrada	Reino_Unido/Grã-Bretanha/Reino-Unido
cola	Estados_Unidos/EUA/E.U.A.
Frente_revolucionária_unida	Serra_leoa/Serra_Leoa
Língua_Chinesa	República_Popular_da_China/China
Norte	Estados_Unidos/EUA/E.U.A.
Panzer	República_Federal_da_Alemanha/Alemanha
Rupert_Murdoch	Austrália
negro	Africa/África
primeira_linha	Reino_Unido/Grã-Bretanha/Reino-Unido
Basilicata	Itália/Italia/República_Italiana
paelha	Espanha
Ieoh_ming_pei	República_Popular_da_China/China
Revolução_francesa	República_Francesa/França
fisionomia	Reino_Unido/Grã-Bretanha/Reino-Unido
Associação_de_Defesa_do_Ulster	Irlanda_do_Norte
prisão	Reino_Unido/Grã-Bretanha/Reino-Unido
parlamento	Reino_Unido/Grã-Bretanha/Reino-Unido
Saqué	Japão
merenda	Reino_Unido/Grã-Bretanha/Reino-Unido
fenício	Fenícia
Exército_vermelho_japonês	Japão
pãozinho	Escocia/Escócia
nous	Reino_Unido/Grã-Bretanha/Reino-Unido
Grapo	Espanha
República_das_Ilhas_Marshall	Estados_Unidos/EUA/E.U.A.
gladiador	Roma
pai-nosso	Reino_Unido/Grã-Bretanha/Reino-Unido
gaélico	Irlanda
dólar	Estados_Unidos/EUA/E.U.A.
criança	Escocia/Escócia
Lug	Irlanda
língua_castelhana	Espanha
Lady	Reino_Unido/Grã-Bretanha/Reino-Unido
sobremesa	Reino_Unido/Grã-Bretanha/Reino-Unido
bar	Reino_Unido/Grã-Bretanha/Reino-Unido
francês	República_Francesa/França
Orleães	República_Francesa/França
solicitador	Roma
Ieoh_Ming_Pei	República_Popular_da_China/China
proxenetismo	Inglaterra
Termópilas	Grécia
sala_de_estar	Reino_Unido/Grã-Bretanha/Reino-Unido
jiu-jitsu	Japão
bandido	Estados_Unidos/EUA/E.U.A.
pancadaria	Reino_Unido/Grã-Bretanha/Reino-Unido
sushi	Japão
charneca	Reino_Unido/Grã-Bretanha/Reino-Unido
residente	Reino_Unido/Grã-Bretanha/Reino-Unido
proxeneta	Inglaterra
Inanna	Suméria
melaço	Reino_Unido/Grã-Bretanha/Reino-Unido
Soissons	República_Francesa/França
Xamanismo	Estados_Unidos/EUA/E.U.A.
escravo	Europa
coca	Estados_Unidos/EUA/E.U.A.
Guerra_das_rosas	Inglaterra
gringo	Estados_Unidos/EUA/E.U.A.
pietismo	Alemanha/República_Federal_da_Alemanha
havaiano	Havaí/Havai
salão	Reino_Unido/Grã-Bretanha/Reino-Unido
Guerra_das_Rosas	Inglaterra
cookie	Reino_Unido/Grã-Bretanha/Reino-Unido
Hinduismo	República_da_Índia/Índia/Nepal/Ceilão/Sri-Lanka/Sri_lanka/Sri_Lanca/Sri_Lanka
Isaac_Stern	URSS/União_das_Repúblicas_Socialistas_Soviéticas/Rússia
Isaac_stern	URSS/União_das_Repúblicas_Socialistas_Soviéticas/Rússia
skiffle	Reino_Unido/Grã-Bretanha/Reino-Unido
Mercantilismo	Europa
Euskadi_Ta_Askatasuna	Espanha
alfândega	Reino_Unido/Grã-Bretanha/Reino-Unido/Estados_Unidos/EUA/E.U.A.
cientista	Reino_Unido/Grã-Bretanha/Reino-Unido
Danu	Irlanda
ianque	Estados_Unidos/EUA/E.U.A.
Peter_O'Toole	Irlanda
go	Japão
Safari	Africa/África
catalão	Espanha
língua_chinesa	República_Popular_da_China/China
vale	Reino_Unido/Grã-Bretanha/Reino-Unido
recatado	Escocia/Escócia
tricolor	República_Francesa/França
Acupuntura	República_Popular_da_China/China
Sherwood	Inglaterra
maquiado	Reino_Unido/Grã-Bretanha/Reino-Unido
emir	Africa/África/Arábia
taberna	Reino_Unido/Grã-Bretanha/Reino-Unido
Guerra_Civil_Espanhola	Espanha
Somme	República_Francesa/França
alemão	Alemanha/República_Federal_da_Alemanha
Curling	Escocia/Escócia
Mexicano-americanos	México/Estados_Unidos_Mexicanos
Frente_de_Libertação_Nacional_da_Córsega	República_Francesa/França
Kamikaze	Japão
chanceler	Reino_Unido/Grã-Bretanha/Reino-Unido
preceptor	Reino_Unido/Grã-Bretanha/Reino-Unido
Dagon	Fenícia
Mel_gibson	Estados_Unidos/EUA/E.U.A.
face	Reino_Unido/Grã-Bretanha/Reino-Unido
kolkhoz	URSS/União_das_Repúblicas_Socialistas_Soviéticas/Rússia
estagiário	Reino_Unido/Grã-Bretanha/Reino-Unido
Salerno	Itália/Italia/República_Italiana
Luau	Havaí/Havai
Cartel_de_Cali	Colômbia/Colombia/Colómbia
Guerra_de_Secessão	Estados_Unidos/EUA/E.U.A.
Calábria	Itália/Italia/República_Italiana
bolacha	Reino_Unido/Grã-Bretanha/Reino-Unido
karatê	Japão
tortilla	México/Estados_Unidos_Mexicanos
Mel_Gibson	Estados_Unidos/EUA/E.U.A.
Ilhas_marshall	Estados_Unidos/EUA/E.U.A.
puritanismo	Inglaterra
Revolução_de_Fevereiro	URSS/União_das_Repúblicas_Socialistas_Soviéticas/Rússia
taco	México/Estados_Unidos_Mexicanos
estaminé	Reino_Unido/Grã-Bretanha/Reino-Unido
Guerra_de_secessão	Estados_Unidos/EUA/E.U.A.
Corno_de_África	Africa/África
cadeia	Reino_Unido/Grã-Bretanha/Reino-Unido
língua_portuguesa	Portugal
Groundhog_Day	Estados_Unidos/EUA/E.U.A.
Guerra_Civil_Americana	Estados_Unidos/EUA/E.U.A.
Seiji_Ozawa	Japão
Atlanta	Georgia
trapézio	Estados_Unidos/EUA/E.U.A.
Revolução_de_Outubro	Rússia/União_das_Repúblicas_Socialistas_Soviéticas/URSS
estagiária	Reino_Unido/Grã-Bretanha/Reino-Unido
Kolkhoz	URSS/União_das_Repúblicas_Socialistas_Soviéticas/Rússia
subcontinente	República_da_Índia/Índia/Groenlândia
Preceptor	Reino_Unido/Grã-Bretanha/Reino-Unido
Namíbia	Africa/África
Corno_de_áfrica	Africa/África
pudim	Reino_Unido/Grã-Bretanha/Reino-Unido
Pleven	Bulgária/República_da_Bulgária
Serviço_Aéreo_Especial	Reino_Unido/Grã-Bretanha/Reino-Unido
Abu_Sayyaf	Filipinas
Khmer_Vermelho	Camboja/Reino_do_Camboja
russo	URSS/União_das_Repúblicas_Socialistas_Soviéticas/Rússia
Baco	Roma/Grécia
Philip_Marlowe	Estados_Unidos/EUA/E.U.A.
ribeiro	Sudoeste
Magna_carta	Reino_Unido/Grã-Bretanha/Reino-Unido
Tiamat	Mesopotâmia
saxão	Inglaterra
Ishtar	Assíria/Babilónia
Guerra_dos_boers	Africa/África
Revolução_Cultural_Chinesa	República_Popular_da_China/China
acupuntura	República_Popular_da_China/China
golfinho	Havaí/Havai
Ypres	Bélgica/Belgica
totem	Estados_Unidos/EUA/E.U.A.
Toronto	Canadá/Canada
Jihad_Islâmica	Estado_da_palestina/Estado_da_Palestina/Palestina
Ordem_de_Orange	Irlanda_do_Norte
Minden	Alemanha/República_Federal_da_Alemanha
banshee	Irlanda
estrada	Reino_Unido/Grã-Bretanha/Reino-Unido
ravina	Escocia/Escócia
sangria	Espanha
italiano	República_Italiana/Italia/Itália
Brigadas_Vermelhas	Itália/Italia/República_Italiana
polegada	Reino_Unido/Grã-Bretanha/Reino-Unido/Estados_Unidos/EUA/E.U.A.
Condestável	Reino_Unido/Grã-Bretanha/Reino-Unido
Rupert_murdoch	Austrália
Kibutz	Israel/Estado_de_Israel
Guerra_dos_seis_dias	Médio_Oriente/Médio-Oriente/Oriente_Médio
patronímico	Irlanda
xamanismo	Estados_Unidos/EUA/E.U.A.
Banshee	Irlanda
pouquinho	Escocia/Escócia
cruzamento	Roma
Niña	Babilónia
almirantado	Reino_Unido/Grã-Bretanha/Reino-Unido
Frente_Revolucionária_Unida	Serra_leoa/Serra_Leoa
Haganah	Israel/Estado_de_Israel
catacumba	Roma
mil_milhões	Reino_Unido/Grã-Bretanha/Reino-Unido
safado	Inglaterra
condado	Reino_Unido/Grã-Bretanha/Reino-Unido/Estados_Unidos/EUA/E.U.A.
pub	Reino_Unido/Grã-Bretanha/Reino-Unido
bicicleta	Reino_Unido/Grã-Bretanha/Reino-Unido
desfiladeiro	América_do_Norte
cara-pálida	Estados_Unidos/EUA/E.U.A.
Revolução_mexicana	México/Estados_Unidos_Mexicanos
râguebi	Reino_Unido/Grã-Bretanha/Reino-Unido
reitor	Reino_Unido/Grã-Bretanha/Reino-Unido
América_Latina	América_do_Sul/América_do_Norte
ditirambo	Grécia
Guido	Reino_Unido/Grã-Bretanha/Reino-Unido
Origami	Japão
Guerra_civil_inglesa	Inglaterra
Khmer_vermelho	Camboja/Reino_do_Camboja
Euskadi_ta_askatasuna	Espanha
mod	Reino_Unido/Grã-Bretanha/Reino-Unido
pia	Reino_Unido/Grã-Bretanha/Reino-Unido
Macintosh	Reino_Unido/Grã-Bretanha/Reino-Unido
Ilhas_Marshall	Estados_Unidos/EUA/E.U.A.
pintado	Reino_Unido/Grã-Bretanha/Reino-Unido
Chapultepec	México/Estados_Unidos_Mexicanos
musculoso	Escocia/Escócia
chulo	Inglaterra
Calabria	Itália/Italia/República_Italiana
Guerra_dos_Boers	Africa/África
saqué	Japão
Leyte	Filipinas
Safári	Africa/África
canhão	América_do_Norte
barra	Reino_Unido/Grã-Bretanha/Reino-Unido
sala	Reino_Unido/Grã-Bretanha/Reino-Unido
hinduísmo	República_da_Índia/Índia/Nepal/Ceilão/Sri-Lanka/Sri_lanka/Sri_Lanca/Sri_Lanka
Forças_armadas_revolucionárias_da_colômbia	Colômbia/Colombia/Colómbia
perdiz	Estados_Unidos/EUA/E.U.A.
caratê	Japão
maçaneta	Reino_Unido/Grã-Bretanha/Reino-Unido
Peter_o'toole	Irlanda
romano	Roma
Guerra_Civil_Inglesa	Inglaterra
qui	República_Popular_da_China/China
Totem	Estados_Unidos/EUA/E.U.A.
Floresta_Negra	Alemanha/República_Federal_da_Alemanha
Poitiers	República_Francesa/França
Cartel_de_cali	Colômbia/Colombia/Colómbia
GRAPO	Espanha
Cartel_de_medellín	Colômbia/Colombia/Colómbia
burrito	México/Estados_Unidos_Mexicanos
bilião	Reino_Unido/Grã-Bretanha/Reino-Unido
ukulele	Havaí/Havai
macacão	Reino_Unido/Grã-Bretanha/Reino-Unido
Partido_dos_Trabalhadores_do_Curdistão	Turquia/República_da_Turquia
Revolução_Mexicana	México/Estados_Unidos_Mexicanos
Guerra_da_Crimeia	Crimeia
Grã_Bretanha	Reino_Unido/Grã-Bretanha/Reino-Unido
saxônio	Inglaterra
sesta	Reino_Unido/Grã-Bretanha/Reino-Unido
trilhão	Reino_Unido/Grã-Bretanha/Reino-Unido/Alemanha/República_Federal_da_Alemanha/Estados_Unidos/EUA/E.U.A.
anglo-saxão	Reino_Unido/Grã-Bretanha/Reino-Unido
português	Portugal
Hizbollah	Libano/Líbano
farinha	Reino_Unido/Grã-Bretanha/Reino-Unido
tímido	Escocia/Escócia
anoraque	Reino_Unido/Grã-Bretanha/Reino-Unido
Midas	Grécia
Baía_de_Manila	Filipinas
Hangzhou	República_Popular_da_China/China
kibutz	Israel/Estado_de_Israel
boteco	Reino_Unido/Grã-Bretanha/Reino-Unido
Corregidor	Filipinas
Pita	Médio_Oriente/Médio-Oriente/Oriente_Médio
acadiano	Mesopotâmia
Sayeret_Matkal	Israel/Estado_de_Israel
Grã-Bretanha	Reino_Unido/Reino-Unido
Puebla	México/Estados_Unidos_Mexicanos
autoridades_locais	Reino_Unido/Grã-Bretanha/Reino-Unido
futon	Japão
Sayeret_matkal	Israel/Estado_de_Israel
centurião	Roma
patrão	República_Francesa/França
stone	Reino_Unido/Grã-Bretanha/Reino-Unido
gafe	Reino_Unido/Grã-Bretanha/Reino-Unido
Yakuza	Japão
espanhol	Espanha
parca	Reino_Unido/Grã-Bretanha/Reino-Unido
Partido_dos_trabalhadores_do_curdistão	Turquia/República_da_Turquia
Namibia	Africa/África
deputado	Reino_Unido/Grã-Bretanha/Reino-Unido/República_Francesa/França
chinês	República_Popular_da_China/China
Revolução_de_outubro	Rússia/União_das_Repúblicas_Socialistas_Soviéticas/URSS
suchi	Japão
Magna_Carta	Reino_Unido/Grã-Bretanha/Reino-Unido
rod	Reino_Unido/Grã-Bretanha/Reino-Unido
estepe	URSS/União_das_Repúblicas_Socialistas_Soviéticas/Rússia
Forças_Armadas_Revolucionárias_da_Colômbia	Colômbia/Colombia/Colómbia
Ravenna	Itália/Italia/República_Italiana
Siracusa	Sicília
sashimi	Japão
União	Estados_Unidos/EUA/E.U.A.
Baía_de_manila	Filipinas
origami	Japão
