cocô	vulgaridade/palavrão/indecência/obscenidade
soluço	plural
mobília	plural
velcro	marca
foguete	plural
chance	plural
habitação	plural
castanhola	plural
baquelite	marca
pénis	vulgaridade/palavrão/indecência/obscenidade
jeans	plural
suspensório	plural
modo	plural
espólio	plural
binóculo	plural
cacete	vulgaridade/palavrão/indecência/obscenidade
tralha	plural
picha	vulgaridade/palavrão/indecência/obscenidade
foda	vulgaridade/palavrão/indecência/obscenidade/calão/gíria/jargão
debate	plural
direito	plural
mexerico	calão/gíria/jargão
abc	plural
melhor	comparativo
calça	plural
Microsoft_Windows	marca
algema	plural
merda	vulgaridade/palavrão/indecência/obscenidade
gente	plural
condição	plural
noite	metáfora
chefia	plural
pipi	vulgaridade/palavrão/indecência/obscenidade
relações	plural
short	plural
cara-pálida	calão/gíria/jargão
acessório	plural
cueca	plural
superfície	plural
escada	plural
menos	comparativo
judeu	calão/gíria/jargão
realmente	ironia
povo	plural
salina	plural
população	plural
mantimento	plural
tronco	plural
sapatão	calão/gíria/jargão
Linux	marca
luto	plural
aveia	plural
patíbulo	plural
tecido	plural
tesoura	plural
morto	eufemismo
presídio	calão/gíria/jargão
falecido	eufemismo
tom	plural
fedor	calão/gíria/jargão
arauto	formalidade
coroa	plural
entrada	plural
base	plural
conexão	plural
crédito	plural
anterior	comparativo
mijo	vulgaridade/palavrão/indecência/obscenidade
cagalhão	vulgaridade/palavrão/indecência/obscenidade
vara	vulgaridade/palavrão/indecência/obscenidade
forca	plural
coisa	plural
pobreza	plural
aparelhagem	plural
nervo	plural
relação	plural
esmola	plural
tarde	metáfora
culote	plural
casca	plural
calcinha	plural
maneira	plural
xixi	vulgaridade/palavrão/indecência/obscenidade
MPEG	acrónimo/sigla
verga	vulgaridade/palavrão/indecência/obscenidade
cara	plural
obrigação	plural
cor	plural
duralumínio	marca
chinês	calão/gíria/jargão
besteirol	calão/gíria/jargão
bermuda	plural
moradia	plural
mina	calão/gíria/jargão
ferraria	plural
resto	plural
obra	plural
Freon	marca
mobiliário	plural
desempregado	plural
Winchester	marca
verão	metáfora
estima	plural
convés	plural
bosta	vulgaridade/palavrão/indecência/obscenidade
Monopólio	marca
borra	plural
ordem	plural
rico	plural
depredação	plural
prisão	calão/gíria/jargão
soqueira	plural
farpa	plural
pê	vulgaridade/palavrão/indecência/obscenidade
garota	calão/gíria/jargão
sapatilha	plural
neutralização	eufemismo
Windows	marca
pica	vulgaridade/palavrão/indecência/obscenidade
Spam	marca
alicate	plural
ETA	plural
autoridade	plural
urina	vulgaridade/palavrão/indecência/obscenidade
ativo	plural
termo	plural
raridade	plural
chuteira	plural
torquês	plural
pilhagem	plural
frisbee	marca
mecanismo	plural
merecedor	ironia
Via_Crucis	plural
digno	ironia
Umma	plural
harmonioso	dialeto/língua/idioma/dialecto
assalto	calão/gíria/jargão
cumprimento	plural
fufa	calão/gíria/jargão
cientista	calão/gíria/jargão
quartel	plural
meia	plural
plasticina	marca
pinto	vulgaridade/palavrão/indecência/obscenidade
pior	comparativo
desejo	plural
telecomunicação	plural
vaselina	marca
cadafalso	plural
arquibancada	plural
Rollerblade	marca
gabardine	plural
devastação	plural
sexo	vulgaridade/palavrão/indecência/obscenidade/calão/gíria/jargão
rabo	calão/gíria/jargão
fórceps	plural
ânus	calão/gíria/jargão
barriga	calão/gíria/jargão
canal	plural
apartamento	plural
tenaz	plural
cadeia	calão/gíria/jargão
intenção	plural
pau	vulgaridade/palavrão/indecência/obscenidade
deliberação	plural
sonoro	dialeto/língua/idioma/dialecto
reticência	plural
ronda	plural
Kleenex	marca
fedayin	plural
asa	plural
lavanderia	plural
morte	eufemismo
NIMBY	acrónimo/sigla
expiração	eufemismo
sede	plural
bairro	calão/gíria/jargão
fole	plural
saudação	plural
matriz	plural
rola	vulgaridade/palavrão/indecência/obscenidade
móvel	plural
caralho	vulgaridade/palavrão/indecência/obscenidade
confraria	plural
besteira	vulgaridade/palavrão/indecência/obscenidade/calão/gíria/jargão
respeito	plural
