defraudar	lograr/iludir/enganar
amaldiçoar	condenar
povoar	emigrar
desfrutar	despender/esgotar/gastar
polir	esfregar
viciar	usar/consumir
sacar	partir/retirar-se/sair
tirar	partir/retirar-se/sair
esperar	conceber
reservar	adquirir/atingir
ultrapassar	vencer
gorar	cheirar/recender
misturar	confraternizar
caminhar	andar
recamar	bordar
ligar	discar
escrever	soletrar
discernir	perceber/aperceber/aperceber-se
gerir	andar/caminhar/viajar
tatuar	picar/alfinetar
revisar	emendar/reparar/consertar
desgostar	desaprovar
lavrar	cultivar
aludir	significar/denotar
ranger	esfregar
punheta	afagar/acariciar
tricotar	bordar
mirar	enxergar/ver/olhar
tomar	engolir/deglutir/ingurgitar
solucionar	raciocinar
despertar	capotar
concordar	reconsiderar
comprimir	prensar
fumar	expirar/inspirar/inalar
estourar	vaiar
direcionar	andar/caminhar/viajar
sentenciar	condenar
agitar	segurar
pilotar	voar
gaguejar	duvidar
enviar	transferir
vencer	competir/concorrer
gozar	despender/esgotar/gastar
saudar	gesticular
delongar	cancelar
incendiar	acender
ter	conceber/calcular/perceber/aperceber/aperceber-se
levitar	subir
hesitar	duvidar
identificar	classificar
beber	engolir/deglutir/ingurgitar
colar	grudar
esfregar	tocar/bater
aliviar	tomar/consumir
gastar	consumir
furar	dividir
lixar	esfregar
trompetear	assoprar
oferecer	pechinchar/regatear
sufocar	cobrir/tampar
empurrar	prensar/mexer/mover/deslocar
falar	verbalizar/dizer/conversar/proferir
pronunciar	verbalizar/falar/dizer/conversar/proferir
corresponder-se	redigir/escrever
desenrolar	separar/partir/dividir
congelar	solidificar
escoltar	defender/proteger
carregar	mexer/mover/deslocar
eclodir	assentar-se/sentar/sentar-se
escolher	apresentar/encenar/filmar/executar/desempenhar
desfigurar	lesionar/lesar/machucar/ferir
postergar	cancelar
debandar	apressar
hospedar	consumir/tomar
preencher	registrar
roubar	cobrar/invadir
estudar	ler
penalizar	chutar/estimar
ressonar	capotar
deslindar	separar/partir/dividir
ostracizar	evitar
excitar	comprazer/embevecer/agradar/aprazer/encantar
desagradar	decepcionar/desapontar/desiludir
ovacionar	sancionar/deferir
carbonizar	aquecer
apagar	esfregar
notar	perceber/aperceber/aperceber-se
metralhar	atirar
escutar	sentir/ouvir
espirar	inspirar/inalar/expirar
derrotar	vencer
ver	perceber/enxergar/aperceber/aperceber-se/olhar/mirar
imigrar	chegar
olhar	enxergar/ver
seduzir	transar/trepar/meter/copular/comer
arguir	diferir/discordar
examinar	eliminar/ver/olhar/mirar
discutir	diferir/discordar
pedalar	tocar/retocar/executar
compor	soletrar/escrever
brigar	competir/concorrer
debater	diferir/discordar
desafiar	perguntar
ocultar	cobrir/tampar
aplaudir	sancionar/deferir
bater	vencer
exercer	trabalhar
aguardar	conceber
chutar	deslocar/mover
alisar	esfregar
inspecionar	ver/olhar/mirar
perder	competir/andar/caminhar/viajar/concorrer
defender	debater-se/brigar
lustrar	esfregar
respirar	inspirar/inalar/expirar
dançar	andar/caminhar
estrangular	contrair/comprimir
amuar	ressentir
debater-se	competir/concorrer
registrar	perceber/aperceber/aperceber-se
brandir	segurar
intimidar	alertar/advertir/avisar
cauterizar	esturricar
entrar	atuar/representar
engordar	alimentar
cevar	alimentar
cerzir	bordar
queimar	acender
masturbar-se	afagar/acariciar
decidir	debater/deliberar
transplantar	mexer/mover/deslocar
absolver	balizar/julgar/avaliar
ensaboar	lavar-se/limpar
comprar	pagar/selecionar/escolher
confidenciar	crer
consertar	confeccionar/coser/costurar
comer	mastigar/mascar/ingurgitar/deglutir/engolir
patinar	dançar
conceber	copular/acasalar
prorrogar	cancelar
tropeçar	caminhar/andar
condenar	balizar/julgar/avaliar
espiar	investigar/averiguar/apurar
saciar	tomar/consumir
aclamar	sancionar/deferir
autenticar	verificar
bafejar	inspirar/inalar/expirar
declamar	verbalizar/falar/dizer/conversar/proferir
brindar	tomar/beber
certificar	sancionar/deferir
superar	vencer/recuperar/convalescer/melhorar
fisgar	usar/consumir
empalar	furar/perfurar
governar	andar/caminhar/viajar
temer	recear/apavorar
surrar	golpear/bater
asfixiar	cobrir/tampar
inocentar	balizar/julgar/avaliar
vazar	destruir/quebrar
perceber	aperceber/aperceber-se
provocar	excitar/decepcionar/desapontar/desiludir
despender	gastar/consumir
dirigir	andar/caminhar/viajar
marginalizar	evitar
abortar	conceber
chancelar	prender
sonhar	capotar
levantar-se	capotar
exercitar	mexer/mover/deslocar
marrar	ler
amarrar	prender
mapear	quantificar/mensurar
encobrir	cobrir/tampar
recitar	verbalizar/falar/dizer/conversar/proferir
alterar	confeccionar/coser/costurar
alavancar	afrouxar
precipitar	condensar/destilar
vestir	arrumar-se/vestir-se
desemaranhar	separar/partir/dividir
amassar	golpear/bater
roncar	capotar
devorar	comer
sobreviver	recuperar/convalescer/melhorar
digerir	tomar/consumir
antipatizar	desaprovar
tampar	inserir/introduzir
arrolhar	inserir/introduzir
andar	caminhar
reconhecer	conhecer
encorpar	registrar
circuncidar	dividir
jazer	estender-se/acamar/deitar-se
inscrever-se	adquirir/atingir
consumar	transar/trepar/meter/copular/comer
escavar	remover/tirar
saquear	destroçar/arruinar/destruir/estraçalhar/detonar
malhar	mexer/mover/deslocar
desmamar	aleitar/amamentar/lactar
instigar	provocar/excitar/decepcionar/desapontar/desiludir
protelar	cancelar
abandonar	protestar
cancelar	planificar/programar/agendar
tecer	bordar
reportar-se	significar/denotar
bombear	derramar/entornar
lacrar	prender
admitir	ressentir
trapacear	lograr/iludir/enganar
praticar	trabalhar
esconder	cobrir/tampar
masturbar	afagar/acariciar
licenciar	sancionar/deferir
infestar	manar/fluir
espirrar	expirar
perfurar	dividir
conceder	concordar/acordar
fundir	aquecer
comboiar	defender/proteger
desembaraçar	separar/partir/dividir
sentar	sentar-se/assentar-se
pospor	cancelar
desperdiçar	consumir/gastar
sentar-se	sentar/assentar-se
usar	arrumar-se/vestir-se
acordar	capotar
vacilar	duvidar
amputar	dividir
enfileirar	esperar/aguardar
apodrecer	cheirar/recender
amadurecer	envelhecer
criticar	balizar/julgar/avaliar
vender	entregar
pedir	adquirir/atingir
laçar	prender
emigrar	partir/retirar-se/sair
queixar-se	magoar/afligir-se/sofrer
transferir	deslocar/mover
subscrever	sancionar/deferir
selar	prender
libar	engolir/deglutir/ingurgitar
assinar	endossar
ouvir	sentir/escutar
mortificar	privar/abster/abster-se/privar-se
furtar	invadir
pairar	subir
eleger	apresentar/encenar/filmar/executar/desempenhar
perjurar	depor
arrombar	afrouxar
divorciar	esposar/casar/casar-se
farejar	cheirar/recender
deixar	morrer/perecer/falecer
esgotar	gastar/consumir
metabolizar	digerir
adiar	cancelar/reunir
matar	dividir
descasar	esposar/casar/casar-se
ensurdecer	ressoar/soar
chegar	andar/caminhar/viajar
corresponder	redigir/escrever
ziguezaguear	virar-se/virar
forçar	prensar/mexer/mover/deslocar
mexer	segurar
esmaltar	assar
liderar	competir/concorrer
dizer	verbalizar/falar/conversar/proferir
adquirir	pagar/selecionar/escolher
castigar	chutar/estimar
ratificar	endossar
disputar	perguntar
atingir	direcionar/mirar/apontar/pagar/selecionar/escolher
atrasar	cancelar
