país	timor-leste/acre/cabo-verde/malta/haiti/israel/maurício/indonésia/domingos/granada/cuba/sabá
presidente	jackson/bush/reagan
tempo	califado/mesolítico/neolítico/paleolítico
cidade	huambo/charleston/genebra/hamburg/gante/buffalo/chester/leitura/split/astracã/argos/goma/veneza/fez/limeira/rosário/perm/milão/sucre/lyon/limerick/lobito/sarajevo/cremona/tiro/indiana/califórnia/nice/braga/cantão/zurique/setúbal/ufa/porto/bordeaux/luxor/tanger/toyota/recife/colónia/tróia/rio/pisa/granada/vaticano/toledo/barcelona/sevilha/saragoça/bari/medina/valência/manchester/córdoba/winchester/beira
homem	sem/caim/sete
região	arcádia/gália/trácia/caribe/norte/suméria/tule/noroeste/bengala/boémia/labrador/levante/sul/sérvia/sudeste/caxemira/fenícia/médio-oriente/macedónia/sudoeste/lusitânia/extremo-oriente
capital	camelot
capital	camelot
mulher	rebeca
livro	utopia
forte	bastilha
período	califado/barroco/jurássico/terror/iluminismo/cretáceo/terciário/carbonífero/quaternário/cenozóico/paleozóico/mesozóico/renascimento/mesolítico/neolítico/paleolítico
estado	cabo/bósnia/goa/bornéu/guzerate/tabasco
autor	marisma/saki/ourives
palavra	messias/cristo
época	califado/barroco/terror/iluminismo/renascimento
século	califado
comunidade	zulu/xhosa
comunidade	zulu/xhosa
terra	timor-leste/acre/cabo-verde/malta/haiti/israel/maurício/indonésia/domingos/granada/cuba/sabá/américa
território	acre/sabá
parlamentar	robert
município	huambo/charleston/genebra/hamburg/gante/buffalo/chester/leitura/split/astracã/argos/goma/veneza/fez/limeira/rosário/perm/milão/sucre/lyon/limerick/lobito/sarajevo/cremona/tiro/indiana/califórnia/nice/braga/cantão/zurique/setúbal/ufa/porto/bordeaux/luxor/tanger/toyota/recife/colónia/tróia/rio/pisa/granada/vaticano/toledo/barcelona/sevilha/saragoça/bari/medina/valência/manchester/córdoba/winchester/beira
idade	califado/barroco/terror/iluminismo/renascimento
personagem	fausto/drácula/pateta/iago/cinderela/pierrot/genebra/protagonista
personagem	fausto/drácula/pateta/iago/cinderela/pierrot/genebra/protagonista
adversário	anticristo
rio	madeira/congo/jordão/sena/tigre/amarelo/escalda
mar	índico/atlântico/pacífico/egeu/caribe/báltico/mediterrâneo
acontecimento	outono
senhor	jeová/todo-poderoso
ilha	timor/madeira/java/ilhota/grã-bretanha/bornéu/cuba/haiti/malta
domínio	acre/sabá
general	césar/franco/jackson
manifestação	advento
distrito	acre/sabá
escritor	marisma/saki/ourives
etapa	mesolítico/neolítico/paleolítico
estrela	sol
porto	lobito/limerick/assunção/hamburg/tiro/barcelona/sevilha/bordeaux/charleston/cairo/setúbal/recife/gante/mascate/acre/cantão/beira
porto	lobito/limerick/assunção/hamburg/tiro/barcelona/sevilha/bordeaux/charleston/cairo/setúbal/recife/gante/mascate/acre/cantão/beira
aldeia	jericó/belém/salina/frederico/acre/eureka/bath
cimeira	olimpo
província	cabo/bósnia/goa/bornéu/guzerate/tabasco
rei	átila/pepino
solo	américa
continente	antárctica/áfrica/europa
continente	antárctica/áfrica/europa
nação	timor-leste/cabo-verde/malta/haiti/israel/maurício/indonésia/domingos/granada/cuba
poeta	marcial/pope
judeu	lot/cristo
vila	jericó/belém/salina/frederico/acre/eureka/bath
satélite	tritão/titã/lua
inimigo	anticristo
príncipe	dido
era	califado/barroco/terror/iluminismo/cenozóico/paleozóico/mesozóico/renascimento
monumento	pirâmide
evento	outono
chão	américa
cantor	madonna/king
montanha	palatino/gólgota/calvário/areópago
planeta	vénus/vênus
guitarra	king
nazi	hitler
monte	palatino/gólgota/calvário/areópago
serra	himalaia
milagre	ascensão
oceano	índico/atlântico/pacífico/egeu/caribe/báltico/mediterrâneo
cantora	madonna/king
santo	peter/simão/tiago/paulo/mateus
reino	israel/grã-bretanha
opositor	anticristo
lua	tritão
fato	outono
arquipélago	japão/shetland
relevo	américa
deus	jeová/senhor/todo-poderoso
esposa	rebeca
guitarrista	king
guitarrista	king
ditador	franco/hitler
península	catar/coréia/coreia/arábia
filósofo	epiteto
oração	ave-maria/litania
vocalista	madonna/king
santuário	caaba
navegador	mosaic/cinza
navegador	mosaic
dramaturgo	vega
dramaturgo	vega
genocídio	holocausto
vulcão	vesúvio/pasto
patriarca	josé/benjamim
signo	sagitário/aquário/virgem/balança/leão/capricórnio/escorpião/libra/câncer/gêmeos/touro
bastião	kremlin
soprano	normando
colina	palatino/gólgota/calvário/areópago
profeta	cristo/mórmon
fortaleza	bastilha
missionário	xavier/paulo
constelação	hidra/musca/norma/pavão/triângulo/dragão/vela/dorado/capricórnio/escorpião/libra/balança/carneiro/gêmeos/virgem/virgo/sagitário/leão/câncer/cancer/crux/ânfora/touro
comarca	acre/sabá
metrópole	huambo/charleston/genebra/hamburg/gante/buffalo/chester/leitura/split/astracã/argos/goma/veneza/fez/limeira/rosário/perm/milão/sucre/lyon/limerick/lobito/sarajevo/cremona/tiro/indiana/califórnia/nice/braga/cantão/zurique/setúbal/ufa/porto/bordeaux/luxor/tanger/toyota/recife/colónia/tróia/rio/pisa/granada/vaticano/toledo/barcelona/sevilha/saragoça/bari/medina/valência/manchester/córdoba/winchester/beira
arraial	belém/salina/frederico/acre/eureka/bath
hebraico	lot/cristo
teólogo	tertuliano/ário
aeronave	zepelim
cimo	olimpo
inventor	zeppelin/sino
inventor	zeppelin/sino
barranco	palatino/gólgota/calvário/areópago
macho	sem/caim/sete
estadista	césar/augusto
judia	lot/cristo
burgo	belém/salina/frederico/acre/eureka/bath
cume	olimpo
apóstolo	paulo/simão/tiago/mateus/judas/peter
urbe	huambo/charleston/genebra/hamburg/gante/buffalo/chester/leitura/split/astracã/argos/goma/veneza/fez/limeira/rosário/perm/milão/sucre/lyon/limerick/lobito/sarajevo/cremona/tiro/indiana/califórnia/nice/braga/cantão/zurique/setúbal/ufa/porto/bordeaux/luxor/tanger/toyota/recife/colónia/tróia/rio/pisa/granada/vaticano/toledo/barcelona/sevilha/saragoça/bari/medina/valência/manchester/córdoba/winchester/beira
circunscrição	acre/sabá
américa	união/norte
condado	acre/sabá
poetisa	safo/marcial/pope
povoado	belém/salina/frederico/acre/eureka/bath
morro	palatino/gólgota/calvário/areópago
carpinteiro	josé
artífice	zeppelin/sino
descobridor	zeppelin/sino
bíblia	vulgata
baluarte	kremlin
prece	ave-maria/litania
oratório	messias
oratório	messias
hebreu	lot/cristo
possessão	macau
cidadela	kremlin
varão	sem/caim/sete
cordilheira	himalaia
titã	oceano/atlas
antagonista	anticristo
evangelista	mateus
ladeira	palatino/gólgota/calvário/areópago
marceneiro	josé
bioquímico	funk/jaime
cantador	madonna/king
relicário	caaba
autocrata	franco/hitler
dirigível	zepelim
europa	flandres/vaticano/suíça/frança/holanda/croácia/portugal/eslovénia/bósnia
sátiro	sileno
nazista	hitler
violonista	king
vilarejo	jericó
zigurate	babel
bioquimico	funk/jaime
