sem	varão/macho/homem
sete	varão/macho/homem
norte	região
norte	américa
rio	urbe/município/metrópole/cidade
senhor	deus
leitura	urbe/município/metrópole/cidade
cabo	província/estado
sul	região
porto	urbe/município/metrópole/cidade
união	américa
sol	estrela
sol	estrela
tiro	urbe/município/metrópole/cidade/porto
norma	constelação
pacífico	oceano/mar
protagonista	personagem
franco	general/autocrata/ditador
madeira	rio/ilha
amarelo	rio
libra	constelação/signo
beira	urbe/município/metrópole/cidade/porto
oceano	titã
domingos	terra/nação/país
vela	constelação
colónia	urbe/município/metrópole/cidade
leão	signo/constelação
lua	satélite
lua	satélite
outono	evento/acontecimento/fato
terror	idade/época/era/período
ascensão	milagre
balança	constelação/signo
áfrica	continente
utopia	livro
barroco	idade/época/era/período
cinza	navegador
cinza	navegador
touro	signo
touro	constelação
sudoeste	região
noroeste	região
virgem	constelação/signo
granada	urbe/terra/município/metrópole/cidade/nação/país
triângulo	constelação
holocausto	genocídio
renascimento	idade/época/era/período
xavier	missionário
sudeste	região
sudeste	região
dragão	constelação
dragão	constelação
sino	artífice/inventor/descobridor
báltico	mar/oceano
tigre	rio
atlântico	oceano/mar
pirâmide	monumento
zulu	comunidade
marcial	poeta/poetisa
assunção	porto
valência	urbe/município/metrópole/cidade
gêmeos	signo/constelação
gêmeos	signo
malta	ilha/terra/nação/país
terciário	período
funk	bioquimico/bioquímico
aquário	signo
advento	manifestação
cantão	urbe/município/metrópole/cidade/porto
rosário	urbe/município/metrópole/cidade
paleolítico	período/etapa/tempo
paleolítico	período/etapa/tempo
américa	terra/chão/solo/relevo
suíça	europa
salina	vila/aldeia/povoado/arraial/burgo
todo-poderoso	deus/senhor
índico	mar/oceano
pasto	vulcão
carneiro	constelação
indonésia	terra/nação/país
calvário	colina/barranco/monte/morro/montanha/ladeira
bengala	região
sérvia	região
drácula	personagem
fausto	personagem
messias	palavra/oratório
coréia	península
boémia	região
escorpião	constelação/signo
escorpião	signo
jurássico	período
ourives	autor/escritor
recife	urbe/município/metrópole/cidade/porto
titã	satélite
indiana	urbe/município/metrópole/cidade
neolítico	período/etapa/tempo
neolítico	período/etapa/tempo
pateta	personagem
atlas	titã
levante	região
bastilha	fortaleza/forte
iluminismo	idade/época/era/período
fez	urbe/município/metrópole/cidade
mórmon	profeta
mórmon	profeta
bósnia	europa/província/estado
olimpo	cume/cimeira/cimo
ânfora	constelação
pavão	constelação
cinderela	personagem
ilhota	ilha
goma	urbe/município/metrópole/cidade
pepino	rei
caxemira	região
córdoba	urbe/município/metrópole/cidade
mediterrâneo	mar/oceano
normando	soprano
vesúvio	vulcão
acre	vila/terra/domínio/território/circunscrição/país/distrito/condado/comarca/aldeia/povoado/arraial/burgo/porto
benjamim	patriarca
frança	europa
césar	general/estadista
xhosa	comunidade
xhosa	comunidade
jericó	vila/aldeia/vilarejo
hidra	constelação
cuba	ilha/terra/nação/país
japão	arquipélago
vaticano	europa/urbe/município/metrópole/cidade
cristo	profeta/judia/hebreu/judeu/hebraico/palavra
pisa	urbe/município/metrópole/cidade
bornéu	província/ilha/estado
barcelona	urbe/município/metrópole/cidade/porto
carbonífero	período
bordeaux	urbe/município/metrópole/cidade/porto
sagitário	constelação/signo
tule	região
litania	prece/oração
areópago	colina/barranco/monte/morro/montanha/ladeira
tanger	urbe/município/metrópole/cidade
vulgata	bíblia
gália	região
braga	urbe/município/metrópole/cidade
jeová	senhor/deus
tritão	satélite/lua
capricórnio	constelação/signo
zeppelin	artífice/inventor/descobridor
king	cantador/cantor/cantora/vocalista/guitarra/guitarrista/violonista
arcádia	região
babel	zigurate
augusto	estadista
catar	península
safo	poetisa
antárctica	continente
arábia	península
extremo-oriente	região
califado	época/tempo/século/período/era/idade
medina	urbe/município/metrópole/cidade
portugal	europa
congo	rio
quaternário	período
palatino	colina/barranco/monte/morro/montanha/ladeira
europa	continente
setúbal	urbe/município/metrópole/cidade/porto
timor	ilha
flandres	europa
nice	urbe/município/metrópole/cidade
labrador	região
argos	urbe/município/metrópole/cidade
sena	rio
rebeca	esposa/mulher
charleston	urbe/município/metrópole/cidade/porto
caim	varão/macho/homem
mascate	porto
pope	poeta/poetisa
lot	judia/hebreu/judeu/hebraico
anticristo	antagonista/adversário/inimigo/opositor
ave-maria	prece/oração
holanda	europa
fenícia	região
ufa	urbe/município/metrópole/cidade
ufa	urbe/município/metrópole/cidade
macedónia	região
judas	apóstolo
marisma	autor/escritor
winchester	urbe/município/metrópole/cidade
sucre	urbe/município/metrópole/cidade
genebra	urbe/personagem/município/metrópole/cidade
iago	personagem
iago	personagem
milão	urbe/município/metrópole/cidade
gólgota	colina/barranco/monte/morro/montanha/ladeira
split	urbe/município/metrópole/cidade
cabo-verde	terra/nação/país
paulo	apóstolo/missionário/santo
belém	vila/aldeia/povoado/arraial/burgo
lobito	cidade/metrópole/município/urbe/porto
zepelim	aeronave/dirigível
limeira	urbe/município/metrópole/cidade
mesozóico	era/período
caribe	mar/região/oceano
paleozóico	era/período
cremona	urbe/município/metrópole/cidade
paleozóico	era/período
himalaia	serra/cordilheira
astracã	urbe/município/metrópole/cidade
chester	urbe/município/metrópole/cidade
israel	terra/nação/país/reino
macau	possessão
sileno	sátiro
vénus	planeta
pierrot	personagem
grã-bretanha	reino/ilha
dorado	constelação
sabá	terra/domínio/território/circunscrição/país/distrito/condado/comarca
mesolítico	período/etapa/tempo
veneza	urbe/município/metrópole/cidade
simão	apóstolo/santo
jordão	rio
josé	patriarca/carpinteiro/marceneiro
câncer	signo
câncer	constelação/signo
huambo	urbe/município/metrópole/cidade
saragoça	urbe/município/metrópole/cidade
frederico	vila/aldeia/povoado/arraial/burgo
manchester	urbe/município/metrópole/cidade
jaime	bioquimico/bioquímico
egeu	mar/oceano
hitler	nazista/nazi/autocrata/ditador
cairo	porto
croácia	europa
buffalo	urbe/município/metrópole/cidade
virgo	constelação
cretáceo	período
cancer	constelação
kremlin	bastião/baluarte/cidadela
guzerate	província/estado
maurício	terra/nação/país
dies_irae	hino
dies_irae	hino
sevilha	urbe/município/metrópole/cidade/porto
eslovénia	europa
califórnia	urbe/município/metrópole/cidade
trácia	região
bath	vila/aldeia/povoado/arraial/burgo
suméria	região
madonna	cantador/cantor/cantora/vocalista
java	ilha
bush	presidente
toledo	urbe/município/metrópole/cidade
crux	constelação
tabasco	província/estado
toyota	urbe/município/metrópole/cidade
goa	província/estado
coreia	península
limerick	urbe/município/metrópole/cidade/porto
lusitânia	região
tertuliano	teólogo
escalda	rio
peter	santo/apóstolo
átila	rei
cenozóico	período/era
caaba	relicário/santuário
saki	autor/escritor
zurique	urbe/município/metrópole/cidade
musca	constelação
eureka	vila/aldeia/povoado/arraial/burgo
mosaic	navegador
jackson	presidente/general
vega	dramaturgo
hamburg	urbe/município/metrópole/cidade/porto
robert	parlamentar
lyon	urbe/município/metrópole/cidade
camelot	capital
vênus	planeta
perm	urbe/município/metrópole/cidade
dido	príncipe
bari	urbe/município/metrópole/cidade
ário	teólogo
reagan	presidente
tiago	santo/apóstolo
gante	urbe/município/metrópole/cidade/porto
timor-leste	terra/nação/país
tróia	urbe/município/metrópole/cidade
médio-oriente	região
epiteto	filósofo
caaba	relicário/santuário
sarajevo	urbe/município/metrópole/cidade
shetland	arquipélago
luxor	urbe/município/metrópole/cidade
mateus	evangelista/santo/apóstolo
haiti	terra/ilha/nação/país
