Eugène_Ionesco	dramaturgo
Medford	vila/aldeia/povoado/arraial/burgo
Maomé	profeta
Tom_Sawyer	personagem
François_Villon	poeta/poetisa/Poetas
Hamburgo	urbe/município/metrópole/cidade/Porto/porto
Capadócia	região
Comenius	pedagogo/educador
Samoa_Americana	terra/domínio/território/circunscrição/país/distrito/condado/comarca
São_Sebastião	urbe/município/metrópole/cidade
Davy_Crockett	político
Galveston	vila/aldeia/povoado/arraial/burgo
Jordão	rio
Lusitania	região
Leontyne_Price	soprano
Bram_Stoker	autor/escritor
Ischia	ilha
Santo_André	Santos/santo/apóstolo
Brno	urbe/município/metrópole/cidade
Cabo_Cod	península
Yokohama	urbe/município/metrópole/cidade/Porto/porto
Sri_Lanca	terra/nação/país
Elias	profeta
Tony_Blair	estadista
Ali_Babá	lenhador/personagem
Jibuti	Países_de_África/Porto/porto
Durban	urbe/município/metrópole/cidade/Porto/porto
Tiago	Santos/santo/apóstolo
Guiné-Bissau	Países_de_África
Paul_McCartney	compositor
Norman_Mailer	autor/escritor
Jean_de_La_Fontaine	autor/escritor
San_Juan	urbe/município/metrópole/cidade
Willard	pedagogo/educador
Almaty	urbe/município/metrópole/cidade
Béla_Bartók	pianista/compositor
Che_Guevara	revolucionário/subversivo/Revolucionário
Atlanta	cerco/assédio/sítio
Beira	urbe/município/metrópole/cidade/Porto/porto
Emiliano_Zapata	revolucionário/subversivo/Revolucionário
Aconcágua	cume/cimeira/cimo
Martin_Heidegger	existencialista
Kyushu	ilha
Essen	urbe/município/metrópole/cidade
São_Pedro	Santos/santo/apóstolo
Ática	terra/domínio/território/circunscrição/país/distrito/condado/comarca
Universidade_de_Michigan	universidade
Bach	organista/compositor
Charles_Darwin	naturalista
Fredericksburg	vila/aldeia/povoado/arraial/burgo
Maciço_Central	planalto/patamar/Planalto
Mar_Vermelho	mar/oceano
República_do_Haiti	terra/ilha/nação/país
Guiné_Bissau	Países_de_África
Lille	urbe/município/metrópole/cidade
Papeete	urbe/município/metrópole/cidade
Angelus	oração/prece
Kandahar	urbe/município/metrópole/cidade
Kwazulu-Natal	terra/domínio/território/circunscrição/país/distrito/condado/comarca
Hugo_Wolf	compositor
Universidade_de_Chicago	universidade
Pólo_Sul	pólo/extremidade
Laurence_Sterne	autor/escritor
Thomas_de_Quincey	autor/escritor
Senhor	Deus
Ann_Arbor	urbe/município/metrópole/cidade
Alexandre_Magno	conquistador
Hindu_Kush	serra/cordilheira
Mar_Mediterrâneo	mar/oceano
Barbanegra	pirata/corsário
Gemini	constelação
Luanda	Porto/porto
Wiesbaden	urbe/município/metrópole/cidade
Stephen_Spender	poeta/poetisa/Poetas
Tanger	urbe/município/metrópole/cidade
John_Milton	poeta/poetisa/Poetas
Upton_Sinclair	autor/escritor
Alemanha_Oriental	Europa
Gene_Kelly	bailarino/bailarina/dançarino/dançarina/coreógrafo/intérprete/artista/actor/ator
Harlem	vizinhança/bairro
Robert_Redford	intérprete/artista/actor/ator/cineasta
Thomas_More	autor/escritor/estadista
Volga	rio
Serra_Nevada	serra/cordilheira
Taiwan	ilha
Edgar_Allan_Pöe	poeta/poetisa/Poetas/autor/escritor
Willem_de_Kooning	pintora/pintor
San_Antonio	urbe/município/metrópole/cidade
William_Byrd	organista/compositor
Namíbia	Países_de_África
Andrew_Carnegie	altruísta/industrialista/industrial
Walter_Lippmann	jornalista/periodista
Congo-Brazzaville	Países_de_África
Micronésia	arquipélago/terra/nação/país
Leonide_Massine	bailarino/bailarina/dançarino/dançarina/coreógrafo
Makalu	cume/cimeira/cimo
William_Shakespeare	poeta/poetisa/Poetas/dramaturgo
Capuchinho_Vermelho	personagem
John_Lennon	compositor
Anibal	cartaginês/general
Xenofonte	historiador/cronista/general
Hosni_Mubarak	estadista
Xiraz	urbe/município/metrópole/cidade
Santiago_de_Cuba	urbe/município/metrópole/cidade/Porto/porto
K2	cume/cimeira/cimo
Vincent_Van_Gogh	pintora/pintor
Thomas_Malthus	economista
Lyndon_Johnson	presidente
Jesse_Jackson	político
Gasherbrum	cume/cimeira/cimo
Maui	ilha
Plotino	filósofo
Lagos	urbe/município/metrópole/cidade/Porto/porto
Lillian_Gish	atriz/actriz
Karl_Jaspers	psiquiatra/encolhimento
Saqqara	vila/aldeia/povoado/arraial/burgo
Pleven	cerco/assédio/sítio
Dachau	campo_de_concentração
Samatra	ilha
Pete_Seeger	trovador/jogral/poeta-cantor
Spokane	urbe/município/metrópole/cidade
São_Vicente	ilha
Ascensão	milagre
Times_Square	vizinhança/bairro
Hernán_Cortés	conquistador
Tunísia	Países_de_África
Servia	região
San_Diego	urbe/município/metrópole/cidade
Franz_Lehar	compositor
Cancún	urbe/município/metrópole/cidade
Chiang_Kai-shek	general/estadista
Ben_Jonson	poeta/poetisa/Poetas/dramaturgo
Woody_Allen	intérprete/artista/actor/ator/cineasta
Mar_de_Bering	mar/oceano
Mauritânia	Países_de_África
Dom_Quixote	personagem
Rio_Loire	rio
Cetus	constelação
América_Central	istmo
Irlanda	Europa/ilha
Galaaz	personagem
sol	estrela
Selma	vila/aldeia/povoado/arraial/burgo
Guerra_do_Peloponeso	guerra
Jasper_Johns	artista
Bizâncio	urbe/município/metrópole/cidade
Émile_Zola	escritor
Petersburgo	urbe/município/metrópole/cidade
Mel_Gibson	intérprete/artista/actor/ator
Albert_Speer	designer/arquitecto
Carlo_Goldoni	dramaturgo
Teresa	missionário/monja/madre/religiosa/freira
África_Oriental	região
Düsseldorf	urbe/município/metrópole/cidade
Simão	apóstolo/Santos/santo
Magrebe	região
Bolívia	América_do_Sul
Pompeia	urbe/município/metrópole/cidade
Império_Romano	império
Ernst_Ludwig_Kirchner	pintor/pintora
Bertrand_Russell	filósofo/lógico
Grand_Rapids	urbe/município/metrópole/cidade
Colombia	América_do_Sul
Ásia_Menor	península
São_Tomé_e_Príncipe	terra/nação/país
Varna	urbe/município/metrópole/cidade/Porto/porto
Universidade_de_Paris	universidade
Worcester	urbe/município/metrópole/cidade
Laramie	vila/aldeia/povoado/arraial/burgo
Serra_Leoa	Países_de_África
Robinson_Crusoé	personagem
Genova	urbe/município/metrópole/cidade
Blackpool	vila/aldeia/povoado/arraial/burgo
Egipto	Países_de_África
Wilkie_Collins	autor/escritor
John_Maynard_Keynes	economista
Vanuatu	terra/nação/país
Hamburg	urbe/município/metrópole/cidade/Porto/porto
Andaluzia	região
Mar_dos_Sargaços	mar/oceano
Richard_Wagner	compositor
Terceira_Cruzada	cruzada
Maiorca	ilha
Península_Balcânica	península
John_Irving	autor/escritor
Titão	satélite
Arnold_Schonberg	compositor
Clarence_Darrow	advogado/jurista
Gotemburgo	urbe/município/metrópole/cidade/Porto/porto
Califórnia	urbe/município/metrópole/cidade
Orinoco	rio
República_Democrática_Alemã	Europa
Henrique	físico
Elias_Canetti	autor/escritor
François_Couperin	organista/compositor
Richard_Strauss	compositor
Odessa	urbe/Porto/porto/município/metrópole/cidade
República_da_Indonésia	terra/nação/país
Dakar	Porto/porto
Dvorak	compositor
Cancun	urbe/município/metrópole/cidade
Cipião_Africano	general
Winston-Salem	urbe/município/metrópole/cidade
Argélia	Países_de_África
James_Clark_Ross	explorador/exploradora
Nanga_Parbat	cume/cimeira/cimo
cinza	navegador
Maria_Antonieta	rainha
Galápagos	ilha
Salzburgo	urbe/município/metrópole/cidade
Eva	mulher
Rio_Pó	rio
Serguei_Eisenstein	cineasta
Karen_Blixen	autor/escritor
Zimbabué	Países_de_África
Cesar_Franck	compositor
Nova_Iorque	urbe/município/metrópole/cidade
Rio_de_Janeiro	urbe/município/metrópole/cidade
Universidade_Harvard	universidade
Baleares	arquipélago
Bioko	ilha
Robert	parlamentar
Olga_Korbut	ginasta/atleta
Abissínia	Países_de_África
Abraão	patriarca
Chablis	vila/aldeia/povoado/arraial/burgo
Hans_Arp	poeta/poetisa/Poetas/artista
Alfredo	rei
Netscape_Navigator	Navegador/navegador
Golfo_de_Bengala	baía
URSS	terra/nação/país
Kursk	urbe/município/metrópole/cidade
Noel_Coward	dramaturgo/compositor/intérprete/artista/actor/ator
Fred_Astaire	bailarino/bailarina/dançarino/dançarina/coreógrafo/intérprete/artista/actor/ator
Calgary	urbe/município/metrópole/cidade
George_Balanchine	bailarino/bailarina/dançarino/dançarina/coreógrafo
Genghis_Khan	imperador
Corno_de_África	península
Argel	Porto/porto
Escócia	Europa
Laurence_Olivier	intérprete/artista/actor/ator
Henrik_Ibsen	poeta/poetisa/Poetas/dramaturgo
Antártica	Continente/continente
Carélia	região
El_Cid	personagem
James_Fenimore_Cooper	autor/escritor
Damocles	cortesão
Malawi	Países_de_África
Hideki_Tojo	autocrata/ditador
Rive_Droite	bairro/cercania/proximidade/vizinhança/vizinho/anexo
Ryukyu	arquipélago
Jacques_Monod	bioquímico
São_Francisco	urbe/município/metrópole/cidade
Goma	urbe/município/metrópole/cidade
Carl_Sandburg	autor/escritor
Nanquim	urbe/município/metrópole/cidade
Diógenes	filósofo
Polo_Norte	extremidade/pólo
Vela	constelação
Abraham_Lincoln	presidente/advogado/jurista
Karl_Barth	teólogo
Kumasi	urbe/município/metrópole/cidade
Golfo_do_México	golfo
Antilhas	arquipélago
Dwight_D._Eisenhower	presidente/general
André_Gide	dramaturgo/autor/escritor
Interlaken	vila/aldeia/povoado/arraial/burgo
John_Dryden	poeta/poetisa/Poetas/dramaturgo
Joyce_Carol_Oates	autor/escritor
Eurásia	Continente/continente
Peter_Sellers	intérprete/artista/actor/ator
James_Dean	intérprete/artista/actor/ator
Tanzânia	Países_de_África
Ararat	cume/cimeira/cimo
Maimónides	filósofo
Toyota_Motor	urbe/município/metrópole/cidade
Cabo_da_Boa_Esperança	cabo
Al_Capone	bandido
Darius_Milhaud	compositor
Kremlin	bastião/baluarte/cidadela
Banguecoque	Porto/porto
Ilha_de_Man	ilha
Ufa	urbe/município/metrópole/cidade
Nathaniel_Hawthorne	autor/escritor
Chartres	vila/aldeia/povoado/arraial/burgo
Tamale	urbe/município/metrópole/cidade
Erle_Stanley_Gardner	autor/escritor
Boémia	região
Bursa	urbe/município/metrópole/cidade
Hamlet	personagem
Suíça	Europa
São_José	vila/aldeia/povoado/arraial/burgo
Ella_Fitzgerald	cantador/cantor/cantora/vocalista
Norte_de_África	região
Nimegue	urbe/município/metrópole/cidade
Banjul	Porto/porto
Auckland	urbe/município/metrópole/cidade/Porto/porto
Nagano	urbe/município/metrópole/cidade
Edimburgo	capital/Capital
Herman_Melville	autor/escritor
Eduardo	rei/Santos/santo
Arcansas	rio
Golfo_da_Finlândia	golfo
Bermudas	ilha
Dublin	Porto/porto
Calé	vila/aldeia/povoado/arraial/burgo/Porto/porto
Ruanda	Países_de_África
Gamal_Abdel_Nasser	estadista
Lincoln_Memorial	monumento
Johann_Strauss	compositor
Franz_Kline	pintora/pintor
Ray_Bradbury	autor/escritor
Francis_Ford_Coppola	cineasta
Oliver_Hardy	cômico/cómico/comediante
Ambrose_Bierce	autor/escritor
Eamon_de_Valera	estadista
Joseph_Goebbels	propagandista/nazista/nazi
Toulouse	urbe/município/metrópole/cidade
Bush	presidente
Erica_Jong	autor/escritor
Carlos_Fuentes	autor/escritor
Konrad_Lorenz	zoologista/zoólogo
Melina_Mercouri	atriz/actriz
Max_Perutz	bioquímico
Messina	urbe/município/metrópole/cidade/Porto/porto
O_Messias	oratório
Taiyuan	urbe/município/metrópole/cidade
Amós	profeta
Huambo	urbe/município/metrópole/cidade
Torre_de_Pisa	campanário
Ralph_Vaughan_Williams	compositor
Edmund_Hillary	alpinista/montanhismo/Montanhismo
California	vila/aldeia/povoado/arraial/burgo
Blaise_Pascal	filósofo/matemático
Gilbert_Stuart	pintora/pintor
Watertown	vila/aldeia/povoado/arraial/burgo
León	constelação
Tratado_do_Atlântico_Norte	convênio/convenção/tratado/acordo/pacto
Seiji_Ozawa	maestro
Idade-Média	idade/época/era/período
Virgem_Maria	judia/judeu/progenitora/mãe
Carcóvia	urbe/município/metrópole/cidade
Michelangelo	designer/arquitecto/escultor
Salvador_Dalí	pintora/pintor
Guadalajara	urbe/município/metrópole/cidade
George_W._Bush	presidente
Gunnar_Myrdal	economista
Chris_Evert	tenista
Hirohito	imperador
Bolivia	América_do_Sul
Edmund_Husserl	filósofo
Revolução_de_Outubro	golpe
Somerset	vila/aldeia/povoado/arraial/burgo/condado
Thomas_Jefferson	presidente
Vaclav_Havel	dramaturgo/estadista
Aristófanes	dramaturgo
Martinica	ilha
Jimi_Hendrix	guitarra/guitarrista/violonista
Harold_Pinter	dramaturgo
Dietrich_Bonhoeffer	teólogo
Molokai	ilha
Amur	rio
Valencia	urbe/município/metrópole/cidade
Samuel_Goldwyn	cineasta
América	terra/chão/solo/relevo
Franco	general/autocrata/ditador
Dale_Carnegie	pedagogo/educador
Algéria	Países_de_África
Walter_Scott	autor/escritor
Barcelona	urbe/município/metrópole/cidade/Porto/porto
Vincent_van_Gogh	pintora/pintor
Le_Corbusier	designer/arquitecto
Stephen_Foster	compositor
Leopold_Stokowski	maestro
Bela_Bartok	pianista/compositor
Mahalia_Jackson	vocalista/cantora/cantor/cantador
Paraguai	América_do_Sul
Porto_Rico	ilha
Daniel_Ortega	estadista
David_Ricardo	economista
Allen_Ginsberg	poeta/poetisa/Poetas
John_Huston	cineasta
Helsínquia	Porto/porto
Jidá	urbe/município/metrópole/cidade/Porto/porto
Revolução_Industrial	idade/época/era/período
Lahore	urbe/município/metrópole/cidade
Yukon	terra/domínio/território/circunscrição/país/distrito/condado/comarca
Ialta	urbe/município/metrópole/cidade
Gloucestershire	condado
Hans_Christian_Andersen	autor/escritor
Monte_Everest	cume/cimeira/cimo
Judas_Iscariotes	apóstolo
Punta_Arenas	urbe/município/metrópole/cidade
John_Quincy_Adams	presidente
Djibuti	Países_de_África/Porto/porto
Ilhas_Virgens	ilha
Celebes	ilha
John_James_Audubon	artista
Sussex	condado
Marquês_de_Sade	autor/escritor
Grozni	urbe/município/metrópole/cidade
Pepino	rei
Donetsk	urbe/município/metrópole/cidade
Galícia	região
San_Francisco	urbe/município/metrópole/cidade
Chihuahua	província/estado
Jules_Massenet	compositor
Quénia	Países_de_África
Tombuctu	urbe/município/metrópole/cidade
Aruba	ilha
Raquel	esposa/mulher
Açores	ilha
Ernest_Hemingway	autor/escritor
Falstaff	personagem
Checoslovaquia	região
William_Morris	artífice/artesão/poeta/poetisa/Poetas
Aarão	sacerdote/pastor/presbítero/clérigo/padre
Arnhem	urbe/município/metrópole/cidade
Mar_de_Timor	mar/oceano
Ethel_Barrymore	atriz/actriz
Lago_Vitória	lago
Robert_Walpole	estadista
Bridgetown	capital/Capital/Porto/porto
San_Martin	ilha
William_Harvey	doutor/médico/cientista
Thomas_Tallis	organista/compositor
Alvar_Aalto	designer/arquitecto
Annapurna	cume/cimeira/cimo
Hamurabi	rei
Friedrich_Hayek	economista
Greenpeace	ONG
Pearl_Bailey	cantador/cantor/cantora/vocalista
Trópico_de_Capricórnio	trópico
Ernst_Chain	bioquímico
Nazaré	vila/aldeia/povoado/arraial/burgo
Adão	varão/macho/homem
Natchez	vila/aldeia/povoado/arraial/burgo
Emily_Brontë	autor/escritor
Lapónia	região
Suazilândia	Países_de_África
Mar_Arábico	mar/oceano
Isaac	patriarca
Etrúria	terra/nação/país
Ana_Bolena	rainha
Joan_Miró	pintora/pintor
Peshawar	urbe/município/metrópole/cidade
Rainer_Maria_Rilke	poeta/poetisa/Poetas
Rosa_Ponselle	soprano
Idade_do_Ferro	período/etapa/tempo
Moravia	região
Taif	urbe/município/metrópole/cidade
Giotto_di_Bondone	designer/arquitecto
Tom_Hanks	intérprete/artista/actor/ator
Eufrates	rio
Orson_Welles	intérprete/artista/actor/ator/cineasta
Ethel_Waters	cantador/cantor/cantora/vocalista/atriz/actriz
Empédocles	filósofo
Simon_Bolivar	general/estadista
Mack_Sennett	cineasta
República_Federal_da_Alemanha	Europa
Rebecca_West	autor/escritor
Rudolf_Hess	nazista/nazi
Honshu	ilha
Hamelin	vila/aldeia/povoado/arraial/burgo
Áustria	Europa
Bornéu	província/ilha/estado
Austria	Europa
Corpus_Christi	urbe/município/metrópole/cidade
Philip_Marlowe	personagem
Saipan	ilha
Golfo_Pérsico	golfo
Fausto	personagem
Monte_Carmelo	serra/cordilheira
Universidade_de_Pittsburgh	universidade
Tunes	Porto/porto
Albion	Inglaterra/Grã-Bretanha/Grã_Bretanha
Confúcio	filósofo
Montenegro	região
Cuba	ilha/terra/nação/país
Rússia_Europeia	região
Otava	rio
Henry_Luce	editor/editora
Tales_de_Mileto	astrónomo/Astrónomos/astrônomo/filósofo
Salonica	urbe/município/metrópole/cidade/Porto/porto
Domingos_de_Gusmão	padre/clérigo/presbítero/pastor/sacerdote/Santos/santo
Zambia	Países_de_África
Cali	urbe/município/metrópole/cidade
King	cantador/cantor/cantora/vocalista/guitarra/guitarrista/violonista
Mandalay	urbe/município/metrópole/cidade
Jean_Anouilh	dramaturgo
Jezebel	judeu/judia/rainha
Edmond_Rostand	poeta/poetisa/Poetas/dramaturgo
Auguste_Rodin	escultor
Witold_Gombrowicz	autor/escritor
Adana	urbe/município/metrópole/cidade
Catulo	poeta/poetisa/Poetas
John_Barrymore	intérprete/artista/actor/ator
Jane_Austen	autor/escritor
Monte_Sinai	cume/cimeira/cimo
Daniel_Defoe	autor/escritor
Sardenha	ilha
Marcial	poeta/poetisa/Poetas
Mestre_Eckhart	teólogo
Robert_Lowell	poeta/poetisa/Poetas
Durango	urbe/município/metrópole/cidade
nascente	Ásia/Asia
Tenzing_Norgay	Montanhismo/montanhismo/alpinista
ave-maria	prece/oração
John_Cage	compositor
Torre_Eiffel	Torres/torre/roque
Guam	ilha
Gujarat	província/estado
Jean_Genet	dramaturgo/escritor
neolítico	período/etapa/tempo
Giancarlo_Menotti	compositor
Champs-Élysées	rua
Eleanor_Roosevelt	diplomata/embaixador/autor/escritor
Trimurti	tríade
Central_Park	parque
Iris_Murdoch	autor/escritor
Chade	Países_de_África/lago
Timor	ilha
Ian_Smith	estadista
Theodore_Roosevelt	presidente
Tenerife	ilha
Svengali	personagem
John_Wesley	clérigo/sacerdote/pároco/pastor
País_de_Gales	principado
Rachel_Carson	ambientalista/biólogo/biologista
Pablo_Neruda	poeta/poetisa/Poetas
Juan_Ramón_Jiménez	poeta/poetisa/Poetas
Dorothea_Lange	fotógrafa/fotógrafo
Karbala	urbe/município/metrópole/cidade
Plzen	vila/aldeia/povoado/arraial/burgo
Jane_Fonda	atriz/actriz
Mao_Tsé_Tung	revolucionário/subversivo/Revolucionário/Comunistas/comunista
Veneza	urbe/município/metrópole/cidade
Giuseppe_Verdi	compositor
Internet_Explorer	Navegador/navegador
Mombaça	urbe/município/metrópole/cidade/Porto/porto
Gaetano_Donizetti	compositor
Pablo_Picasso	pintora/pintor/escultor
Johnson_City	vila/aldeia/povoado/arraial/burgo
Hannah_Arendt	historiador/cronista/filósofo
Pensacola	vila/aldeia/povoado/arraial/burgo
Heinrich_Böll	autor/escritor
Ostrava	urbe/município/metrópole/cidade
Islandia	ilha
Capela_Sistina	Capelas/igreja/ermida/capela
Samuel_Barber	compositor
Dragão	constelação
Oahu	ilha
Mauna_Kea	vulcão
Tróia	urbe/município/metrópole/cidade
Leo	constelação
Neil_Armstrong	cosmonauta/astronauta
Moliére	dramaturgo
Abel_Tasman	navegador
Billy_Wilder	cineasta
Estado_de_Israel	terra/nação/país
Meca	Riade
Cardiff	capital/Capital
Glenda_Jackson	atriz/actriz/político
Lucy	Australopithecus_afarensis
Turcomenistão	terra/nação/país
Noël_Coward	dramaturgo/compositor/intérprete/artista/actor/ator
Jan_Hus	cruzado/reformador
Calíope	musa
Togo	Países_de_África
Lago_Nasser	lago
Thomas	Santos/santo/apóstolo
Irlanda_do_Norte	Europa
Simone_Weil	filósofo
Cárpatos	serra/cordilheira
Sagitário	constelação/signo
James_Cook	navegador
Rússia	terra/nação/país
S._S._Van_Dine	autor/escritor
Thomas_Carlyle	historiador/cronista
Alice_Walker	autor/escritor
Norman_Rockwell	desenhista/ilustrador
Vladivostok	urbe/município/metrópole/cidade
Dhaulagiri	cume/cimeira/cimo
Zelândia	ilha
RDA	Europa
Cecil_B._de_Mille	cineasta
Ronald_Reagan	presidente
Bielorrussia	Europa
Ilhas_Salomão	arquipélago
Georg_Philipp_Telemann	compositor
Mansfield	vila/aldeia/povoado/arraial/burgo
Cheliabinsk	urbe/município/metrópole/cidade
Rio_Madeira	rio
Soweto	urbe/município/metrópole/cidade
Aqaba	urbe/município/metrópole/cidade
Rebeca	esposa/mulher
Santa_Ana	urbe/município/metrópole/cidade
Benjamin_Britten	maestro/compositor
Kalamazoo	vila/aldeia/povoado/arraial/burgo
Virgem	constelação/signo
Ordem_de_Orange	organização
Epicuro	filósofo
Dudley_Moore	intérprete/artista/actor/ator/cômico/cómico/comediante
Daomé	Países_de_África
Günter_Grass	autor/escritor
Margaret_Mead	antropólogo/antropóloga/antropologista
Ucránia	terra/nação/país
Anzio	vila/aldeia/povoado/arraial/burgo
Saladino	sultão
Alcibíades	general/ateniense/estadista
Monica_Seles	tenista
Região_Autónoma_dos_Açores	ilha
Roterdão	urbe/município/metrópole/cidade
Meryl_Streep	atriz/actriz
Sol	estrela
Manuscritos_do_Mar_Morto	rolo/pergaminho
Claudio_Monteverdi	compositor
Braga	urbe/município/metrópole/cidade
Pentateuco	Livro_Sagrado
Big_Ben	relógio
Tours	urbe/município/metrópole/cidade
Tirso_de_Molina	dramaturgo
Mikhail_Baryshnikov	bailarino/bailarina/dançarino/dançarina/coreógrafo
Porto	urbe/município/metrópole/cidade/porto
Pacífico	oceano/mar
Península_Itálica	península
Faroé	possessão
lua	satélite
Australásia	arquipélago
Hays	vila/aldeia/povoado/arraial/burgo
Mindoro	ilha
Montmartre	bairro/cercania/proximidade/vizinhança/vizinho/anexo
Rio_Amarelo	rio
Lee_Strasberg	intérprete/artista/actor/ator
Anaheim	urbe/município/metrópole/cidade
Nicolau_Maquiavel	filósofo/estadista
Timor_Leste	terra/nação/país
Taklamakan	deserto
Papai_Noel	padroeiro/patrono/orago
Honolulu	porto/Porto
Deng_Xiaoping	estadista
Todo-Poderoso	Deus/Senhor
Trípoli	urbe/município/metrópole/cidade/Porto/porto
Giovanni_Battista_Tiepolo	pintora/pintor
Melanie_Klein	psicanalista
Pegasus	constelação
Rudolf_Serkin	pianista
Isadora_Duncan	bailarino/bailarina/dançarino/dançarina
leitura	urbe/município/metrópole/cidade
Tejo	rio
Spencer_Tracy	intérprete/artista/actor/ator
Qatar	península
Mikhail_Gorbachev	estadista
Rawalpindi	urbe/município/metrópole/cidade
Oceania	arquipélago
Eddy_Merckx	ciclista
Leipzig	urbe/município/metrópole/cidade
Teilhard_de_Chardin	filósofo/paleontólogo/paleontologista
Henri_Rousseau	pintora/pintor
Joseph_Haydn	compositor
Medan	urbe/município/metrópole/cidade
Mar_Adriático	mar/oceano
Palas	asteróide
Córdova	urbe/município/metrópole/cidade
Logroño	urbe/município/metrópole/cidade
Rio_Eufrates	rio
Ilhas_Malvinas	ilha
Sudoeste_Asiático	região
Nadine_Gordimer	autor/escritor
Hugo	poeta/poetisa/Poetas/dramaturgo/escritor
Jean_Piaget	psicólogo
Jugoslávia	Europa
Botsuana	Países_de_África
Guantánamo	urbe/município/metrópole/cidade
Beowulf	personagem
Balança	constelação/signo
Lesoto	Países_de_África
Cotopaxi	vulcão
Ebro	rio
Stephen_Crane	autor/escritor
Astracã	urbe/município/metrópole/cidade
América_do_Sul	Continente/continente
Cidade_do_Vaticano	Europa/urbe/município/metrópole/cidade
Livro_de_Mórmon	Livro_Sagrado
Sarah_Vaughan	cantador/cantor/cantora/vocalista
Ian_Fleming	autor/escritor
Orígenes	filósofo/teólogo
Joseph_Paxton	designer/arquitecto
Irving_Berlin	compositor
Virgo	constelação
Tennessee_Williams	dramaturgo
Gérard_Depardieu	intérprete/artista/actor/ator
San_Bernardino	urbe/município/metrópole/cidade
Aquarius	constelação
Krishna	encarnação
Tel_Aviv	urbe/município/metrópole/cidade
Isère	rio
Pinatubo	vulcão
Burlington	urbe/município/metrópole/cidade
Monterey	vila/aldeia/povoado/arraial/burgo
Kuala_Lumpur	urbe/município/metrópole/cidade
Norbert_Wiener	matemático
Lídia	região
Svalbard	ilha/arquipélago
Moisés	profeta
Pierrot	personagem
San_Pablo	vila/aldeia/povoado/arraial/burgo
Jalalabad	vila/aldeia/povoado/arraial/burgo
Hong_Kong	urbe/município/metrópole/cidade/Porto/porto
Montreal	urbe/município/metrópole/cidade
Boulder	vila/aldeia/povoado/arraial/burgo
Jim_Thorpe	atleta
Sri-Lanka	terra/nação/país
Levante	região
Lincolnshire	condado
Baamas	terra/nação/país
Voltaire	autor/escritor
Vladimir_Putin	estadista
Nagoya	urbe/município/metrópole/cidade
Dardanelos	estreito
Sahara_Ocidental	região
República_de_São_Marino	Europa
Nova_Escócia	península
Carina	constelação
Jacques_Ibert	compositor
Ohio	rio
Bréscia	urbe/município/metrópole/cidade
Mar_Cáspio	lago
Sebastopol	urbe/município/metrópole/cidade
Albuquerque	urbe/município/metrópole/cidade
Isaque	patriarca
Pérgamo	urbe/município/metrópole/cidade
Saratoga_Springs	vila/aldeia/povoado/arraial/burgo
Andrei_Gromiko	embaixadora/embaixador
Tabasco	província/estado
H._G._Wells	autor/escritor
Jan_Tinbergen	economista
Barbados	terra/ilha/nação/país
Dylan_Thomas	poeta/poetisa/Poetas
Euterpe	musa
Rio_das_Pérolas	rio
Edirne	urbe/município/metrópole/cidade
Sermão_da_Montanha	pregação/prédica/sermão
Itália	Europa
Karel_Capek	dramaturgo/autor/escritor
Lancelote	personagem
Mar_Amarelo	mar/oceano
Solent	estreito
Antuérpia	urbe/município/metrópole/cidade/Porto/porto
Fobos	satélite
Champaign	vila/aldeia/povoado/arraial/burgo
Johann_Sebastian_Bach	organista/compositor
Khabarovsk	urbe/município/metrópole/cidade
Marraquexe	urbe/município/metrópole/cidade
Atlântico	oceano/mar
Cleópatra	egípcio/rainha
Dar-es-Salaam	Porto/porto
Lobito	cidade/metrópole/município/urbe/Porto/porto
Bath	vila/aldeia/povoado/arraial/burgo
Otto_Hahn	químico/boticário
Manchester	urbe/município/metrópole/cidade
Omdurman	urbe/município/metrópole/cidade
Eslovenia	Europa
Walt_Disney	cineasta
Muhammad	profeta
Frederick_Delius	compositor
Devon	condado
Dustin_Hoffman	intérprete/artista/actor/ator
Georges_Cuvier	naturalista
Somália	Países_de_África
Siemens_AG	engenheiro
Matthew_Arnold	poeta/poetisa/Poetas
Chernobil	urbe/município/metrópole/cidade
Rostock	urbe/município/metrópole/cidade
François_Jacob	bioquímico
Shiraz	urbe/município/metrópole/cidade
Newark	urbe/município/metrópole/cidade
Idade_da_Pedra	período/etapa/tempo
Distrito_do_Porto	urbe/município/metrópole/cidade/Porto/porto
Vale_de_São_Fernando	vale/baixada
Tristão	personagem
Rio_Grande	rio
Belo_Horizonte	urbe/município/metrópole/cidade
Benvenuto_Cellini	escultor
Omsk	urbe/município/metrópole/cidade
Partenon	templo
São_Petersburgo	urbe/município/metrópole/cidade
Ibadan	urbe/município/metrópole/cidade
Sergei_Rachmaninoff	pianista/compositor
Trópico_de_Câncer	trópico
Paleolítico_Inferior	período/etapa/tempo
Berlim_Ocidental	vizinhança/bairro
Italia	Europa
Hesse	autor/escritor
Leningrado	urbe/município/metrópole/cidade
zulu	comunidade/Comunidade
Dublim	Porto/porto
Bonaire	ilha
Chester	urbe/município/metrópole/cidade
John_Cheever	autor/escritor
Nelson_Mandela	estadista
Guadalupe	ilha
Lancashire	região
República_Federativa_do_Brasil	América_do_Sul
Cleveland	urbe/município/metrópole/cidade
João_Baptista	eremita/recluso/ermitão/Santos/santo
Verona	urbe/município/metrópole/cidade
Zenão_de_Eleia	filósofo
Hanôver	urbe/município/metrópole/cidade/Porto/porto
Caim	varão/macho/homem
John_Ronald_Reuel_Tolkien	autor/escritor/filólogo
Carl_Maria_von_Weber	maestro/compositor
Rei_Lear	personagem
Socrates	ateniense/filósofo
Bacu	Porto/porto
Madre_Teresa_de_Calcutá	missionário/monja/madre/religiosa/freira
Leonid_Brejnev	estadista
Estige	rio
Torre_de_Londres	fortaleza/forte
Plauto	dramaturgo
Golfo_da_Biscaia	baía
Hell's_Kitchen	vizinhança/bairro
Molière	dramaturgo
Mahatma_Gandhi	clérigo
Jerry_Lee_Lewis	pianista
Malta	ilha/terra/nação/país
Hunan	província/estado
Gabão	Países_de_África
Anatolia	península
Wolfgang_Amadeus_Mozart	compositor
Colómbia	América_do_Sul
Fidji	terra/nação/país
Aquila	constelação
Rex_Harrison	intérprete/artista/actor/ator
Neil_Simon	dramaturgo
Nagasaki	urbe/município/metrópole/cidade/Porto/porto
Bing_Crosby	crooner/intérprete/artista/actor/ator
Charles_Baudelaire	poeta/poetisa/Poetas
Howard_Carter	egiptólogo
Congo-Kinshasa	Países_de_África
Universidade_Brown	universidade
Mongólia_Interior	província/estado
James_Thurber	humorista/desenhista
Oslo	Porto/porto
Assur	urbe/município/metrópole/cidade
Empire_State_Building	arranha-céu
Isaac_Bashevis_Singer	autor/escritor
Heinrich_Himmler	nazista/nazi
Baku	Porto/porto
G._K._Chesterton	autor/escritor
Sileno	sátiro
Louis_Aragon	autor/escritor
Mendelssohn	compositor
Jaime	bioquímico
Andrómeda	constelação
Península_Ibérica	península
Polinésia_Francesa	possessão
ufa	urbe/município/metrópole/cidade
Tabriz	urbe/município/metrópole/cidade
Alhambra	Palácio/palácio/fortaleza/forte
Norman_Jewison	cineasta
Kurt_Waldheim	diplomata/embaixador/estadista
Cabo-Verde	terra/nação/país
Walter_Gropius	designer/arquitecto
Jeremias	profeta
Thomas_Malory	autor/escritor
Lublin	urbe/município/metrópole/cidade
Avicena	doutor/médico/filósofo
Rei_Artur	personagem
Golfo_da_Guiné	golfo
América_Latina	região
Jean_Monnet	economista
Menfis	urbe/município/metrópole/cidade
Dick_Fosbury	atleta
Noam_Chomsky	linguista/lingüista
Manuel_de_Falla	pianista/compositor
John_Dowland	compositor
Marcel_Marceau	mímica/mímico
Ilhas_do_Canal	ilha
Baical	lago
Galicia	região
Harold_Lloyd	intérprete/artista/actor/ator
Cremona	urbe/município/metrópole/cidade
Vénus	planeta
marisma	autor/escritor
Rudolf_Nureyev	bailarino/bailarina/dançarino/dançarina
Robert_Schumann	compositor
República_Italiana	península/Europa
Cantuária	vila/aldeia/povoado/arraial/burgo
Guerra_dos_Cem_Anos	guerra
Wuhan	urbe/município/metrópole/cidade
James_Tobin	economista
Lucille_Ball	atriz/actriz
George_Marshall	general/estadista
Costa_do_Ouro	Países_de_África
Toyota	urbe/município/metrópole/cidade
Lena_Horne	cantador/cantor/cantora/vocalista/atriz/actriz
Alá	Senhor/Deus
Esaú	criança/menino/filho
República_Árabe_do_Egipto	Países_de_África
Woody_Guthrie	poeta-cantor/jogral/trovador/compositor
Trácia	região
Idade_Média	idade/época/era/período
Floresta_Negra	selva/arvoredo/floresta/mata/bosque
Friedrich_Engels	socialista
Tomás_de_Kempis	Clérigo/clérigo/eclesiástico/pastor
Golfo_de_Sidra	golfo
Jurássico	período
Tarzan	personagem
Argos	urbe/município/metrópole/cidade
Filadélfia	urbe/município/metrópole/cidade
Efésios	epístola
Colette	autor/escritor
Henry_Kissinger	diplomata/embaixador
Michael_Faraday	físico/químico/boticário
René_Descartes	filósofo/matemático
Tigre	rio
Tomás	Santos/santo/apóstolo
Seicheles	terra/ilha/nação/país
Médio_Oriente	região
Linux	Unix
Bengala_Ocidental	província/estado
Robert_Peel	político
Federação_Russa	terra/nação/país
Vancouver	urbe/vila/município/metrópole/cidade/Porto/porto/aldeia/povoado/arraial/burgo
Georges_Simenon	autor/escritor
Rio_Jordão	rio
Gália	região
iluminismo	idade/época/era/período
Croácia	Europa
Tuvalu	terra/nação/país
Constant_Lambert	maestro/compositor
Wanda_Landowska	cravista
Museu_do_Louvre	museu
Alan_Shepard	cosmonauta/astronauta
Palo_Alto	vila/aldeia/povoado/arraial/burgo
Plymouth	vila/aldeia/povoado/arraial/burgo
Mediterrâneo	mar/oceano
Jessica_Tandy	atriz/actriz
Plovdiv	urbe/município/metrópole/cidade
Cinderela	personagem
Galiza	região
Cumbria	condado
Rock_Springs	vila/aldeia/povoado/arraial/burgo
New_Deal	idade/época/era/período
Ernst_Cassirer	filósofo
Antonio_Vivaldi	violinista/compositor
Akira_Kurosawa	cineasta
Max_Ernst	pintora/pintor
Aachen	urbe/município/metrópole/cidade
Stefan_Zweig	autor/escritor
Dunquerque	vila/aldeia/povoado/arraial/burgo/Porto/porto
Sylvia_Plath	poeta/poetisa/Poetas/autor/escritor
Herat	urbe/município/metrópole/cidade
Maxwell_Anderson	dramaturgo
Fumimaro_Konoe	estadista
Monaco	principado/Europa
Guerras_Púnicas	guerra
Justiniano_I	imperador
Tebas	urbe/município/metrópole/cidade
Indira_Gandhi	estadista
Orly	arrabalde/subúrbio/periferia
Greenville	vila/aldeia/povoado/arraial/burgo
Reino-Unido	reino
Arafat	estadista
Silésia	região
Manipur	província/estado
Berkshire	condado
Culebra	ilha
Lucrécio	poeta/poetisa/Poetas/filósofo
Pleistoceno	período/época
República_Francesa	Europa
Distrito_de_Lisboa	Porto/porto
Kurt_Vonnegut	autor/escritor
Canárias	ilha
Charlotte_Corday	revolucionário/subversivo/Revolucionário
André_Malraux	autor/escritor
Robert_Graves	autor/escritor
Chongqing	urbe/município/metrópole/cidade
Valdosta	vila/aldeia/povoado/arraial/burgo
Thomas_Edison	artífice/inventor/descobridor
Jawaharlal_Nehru	estadista
Pirenéus	serra/cordilheira
Robert_Benchley	humorista/autor/escritor
Catarina	imperatriz
Conferência_de_Ialta	conferência
Smolensk	urbe/município/metrópole/cidade
Mário_Vargas_Llosa	autor/escritor
Transilvânia	região
Opera	Navegador/navegador
Ringo_Starr	baterista/tambor
Ilhas_Marshall	arquipélago/terra/nação/país
gêmeos	signo
André_Weil	matemático
Oceânia	arquipélago
Normandia	região
Ulysses_S._Grant	presidente/general
Luxor	urbe/município/metrópole/cidade
Japão	arquipélago
Ellis_Island	ilha
Brindisi	urbe/município/metrópole/cidade/Porto/porto
protagonista	personagem
Distrito_de_Columbia	Distrito_Federal
Via_Ápia	rodovia/estrada
Eritreia	Países_de_África
Jack_Lemmon	intérprete/artista/actor/ator
Tanzania	Países_de_África
Salomão	rei
Norma	constelação
Erich_von_Stroheim	intérprete/artista/actor/ator
Louisa_May_Alcott	escritor
Paulo	apóstolo/missionário/Santos/santo
Everglades	pântano
Modest_Mussorgsky	compositor
Bona	urbe/município/metrópole/cidade
Johns_Hopkins	altruísta
Átila	rei
Beverly_Sills	soprano
Horacio	poeta/poetisa/Poetas
Mênfis	urbe/município/metrópole/cidade
Gunter_Grass	autor/escritor
Nunavut	terra/domínio/território/circunscrição/país/distrito/condado/comarca
Alban_Berg	compositor
Nostradamus	astrólogo
Alexander_Calder	escultor
Felix_Mendelssohn	compositor
Jane_Goodall	zoologista/zoólogo
Jack_Kerouac	autor/escritor
Saul_Bellow	autor/escritor
Joana_d'Arc	mártir
Ilha_do_Sul	ilha
Muro_das_Lamentações	muro/parede/muralha
Pártenon	templo
Utopia	livro
Benny_Goodman	clarinetista
Heródoto	historiador/cronista
Dizzy_Gillespie	trompetista/trombeteiro/trombeta
Turíngia	região
Estado_livre	província/estado
Avinhão	vila/aldeia/povoado/arraial/burgo
Cracóvia	urbe/município/metrópole/cidade
Noroeste	região
Denis_Diderot	filósofo
George_Bernard_Shaw	dramaturgo/autor/escritor
Negev	deserto
Maria_Madalena	pecador/Santos/santo
Benjamin_Harrison	presidente
Daytona_Beach	vila/aldeia/povoado/arraial/burgo
Leicester	urbe/município/metrópole/cidade
Tonga	terra/nação/país
Lusitânia	região
Booker_T._Washington	pedagogo/educador
Lago_Kivu	lago
Stratford-upon-Avon	vila/aldeia/povoado/arraial/burgo
Reis	tenista
Tertuliano	teólogo
Eugene_O'Neill	dramaturgo
norte	região
Leeds	urbe/município/metrópole/cidade
Bernard_Hinault	ciclista
Córdoba	urbe/município/metrópole/cidade
Giuseppe_Mazzini	patriota
Monte_Parnaso	cume/cimeira/cimo
Dâmocles	cortesão
Belgica	Europa
Pierre_Corneille	poeta/poetisa/Poetas/dramaturgo
Sapporo	urbe/município/metrópole/cidade
Martha's_Vineyard	ilha
Fleet_Street	rua
Edith_Wharton	autor/escritor
Aries	constelação
Eleonora_Duse	atriz/actriz
Papua_Nova_Guiné	terra/nação/país
Arthur_Rimbaud	poeta/poetisa/Poetas
Spitsbergen	ilha
Mongólia	região
Vaticano	Europa/urbe/município/metrópole/cidade
Baixo_Saxe	província/estado
Guerra_dos_Boers	guerra
Peter_Pan	personagem
Éfeso	urbe/município/metrópole/cidade
Cidade_de_Ho_Chi_Minh	urbe/município/metrópole/cidade
Carl_Gustav_Jung	psicólogo
Gruta_de_Fingal	caverna/furna/gruta
Talcott_Parsons	sociólogo
Helmut_Schmidt	estadista
Nicolau	bispo/Santos/santo
Sam_Houston	general/político
Georges_Bizet	compositor
Shikoku	ilha
Guerra_dos_Sete_Anos	guerra
Stonehenge	monumento
Xangai	urbe/município/metrópole/cidade/Porto/porto
Gustav_Klimt	pintora/pintor
Mayflower	navio/embarcação/barco
William_Saroyan	autor/escritor
Machu_Picchu	fortaleza/forte
Sidney_Poitier	intérprete/artista/actor/ator
Paleolítico_Médio	período/etapa/tempo
Macedónia	região
Arquimedes	físico/matemático
Espoo	urbe/município/metrópole/cidade
Equador	América_do_Sul
John_Donne	poeta/poetisa/Poetas/clérigo/sacerdote/pároco/pastor
Max_Bruch	compositor
Arhus	urbe/município/metrópole/cidade/Porto/porto
Percival_Lowell	astrónomo/Astrónomos/astrônomo
Split	urbe/município/metrópole/cidade
Essex	condado
Alessandro_Manzoni	autor/escritor
Morfeu	Deus/deus/divindade/deusa
Polonia	Europa
Polímnia	musa
Midland	vila/aldeia/povoado/arraial/burgo
Acapulco	urbe/município/metrópole/cidade/Porto/porto
levante	Ásia/Asia
Fídias	escultor
Ibéria	região
Barba_Azul	personagem
Tallulah_Bankhead	atriz/actriz
Nefertiti	rainha
Blida	urbe/município/metrópole/cidade
Oceano	Titã
Lady_Godiva	Lady
Saxónia	região
Edward_Jenner	doutor/médico
Nikola_Tesla	artífice/inventor/descobridor
Benim	Países_de_África
Maurícias	terra/nação/país
Thomas_Gainsborough	pintora/pintor
Angola	Países_de_África
Charles_Fourier	sociólogo
Lytton_Strachey	biografista/biógrafo
Curitiba	urbe/município/metrópole/cidade
França	Europa
Stefan_Wyszynski	primaz/prelado
Áden	urbe/município/metrópole/cidade/Porto/porto
Jean_Lafitte	pirata/corsário
Henry_Fonda	intérprete/artista/actor/ator
Constantinopla	urbe/município/metrópole/cidade
Theodor_Seuss_Geisel	autor/escritor
Yakima	vila/aldeia/povoado/arraial/burgo
Tiro	urbe/município/metrópole/cidade/Porto/porto
Montréal	urbe/município/metrópole/cidade
David_Hilbert	matemático
Helen_Hayes	atriz/actriz
Orã	urbe/município/metrópole/cidade/Porto/porto
Shenyang	urbe/município/metrópole/cidade
John_Kenneth_Galbraith	economista/diplomata/embaixador
Pitágoras	filósofo/matemático
Edvard_Grieg	compositor
Washington_Irving	autor/escritor
Henry_Fielding	autor/escritor
Sudoeste	região
Henri_Matisse	pintora/pintor
Orissa	província/estado
Jacques_Tati	cineasta
Bruges	urbe/município/metrópole/cidade
Danúbio	rio
Thomas_Merton	religioso/autor/escritor
Suriname	rio/América_do_Sul
Stanley_Baldwin	estadista
Oriente_Médio	região
Yoko_Ono	Músico/músico
T._E._Lawrence	autor/escritor/soldado/militar
Natalie_Wood	atriz/actriz
Edmond_Halley	astrónomo/Astrónomos/astrônomo
Belisário	general
Toulon	urbe/município/metrópole/cidade/Porto/porto
Monróvia	Porto/porto
Portugal	Europa
Sicília	ilha
Peter_Lorre	intérprete/artista/actor/ator
Karnataka	província/estado
Linz	urbe/município/metrópole/cidade
Jimmy_Durante	cômico/cómico/comediante
Guantanamo	urbe/município/metrópole/cidade
Monroe	vila/aldeia/povoado/arraial/burgo
Samaria	urbe/município/metrópole/cidade
John_F._Kennedy	presidente
Paul_Robeson	cantador/cantor/cantora/vocalista
Gioachino_Rossini	compositor
Nova_Caledónia	ilha
Luxemburgo	Europa
West_Yorkshire	condado
Francisco_Pizarro	conquistador
Luzon	ilha
Universidade_de_Princeton	universidade
Palácio_de_Versalhes	palácio/Palácio
Deli	urbe/município/metrópole/cidade
Gerard_Depardieu	intérprete/artista/actor/ator
O._Henry	autor/escritor
Pope	poeta/poetisa/Poetas
Grã-Bretanha	reino/ilha
Pisces	constelação/signo
Enid	vila/aldeia/povoado/arraial/burgo
Santa_Lúcia	terra/ilha/nação/país
Iuri_Gagarin	cosmonauta/astronauta
Vaslav_Nijinski	bailarino/bailarina/dançarino/dançarina
Checoslováquia	região
oriente	Ásia/Asia
Xinjiang	província/estado
Oscar_Wilde	dramaturgo/autor/escritor
Galway	urbe/município/metrópole/cidade/Porto/porto
escorpião	signo
Ragusa	urbe/município/metrópole/cidade/Porto/porto
Hector_Berlioz	compositor
Hitler	nazista/nazi/autocrata/ditador
Cartagena_das_Índias	urbe/município/metrópole/cidade/Porto/porto
Iliria	região
Petrogrado	urbe/município/metrópole/cidade
Louis_Armstrong	trompetista/trombeteiro/trombeta
Alfred_Nobel	altruísta/químico/boticário
Adem	urbe/município/metrópole/cidade/Porto/porto
Prússia	região
Nice	urbe/município/metrópole/cidade
Daniel	profeta
Universidade_de_Washington	universidade
Charleroi	urbe/município/metrópole/cidade
Ford_Madox_Ford	autor/escritor
Corsega	ilha
Elia_Kazan	encenador
Mar_da_Tasmânia	mar/oceano
Ceres	asteróide
D._W._Griffith	cineasta
Cary_Grant	intérprete/artista/actor/ator
Alicia_Alonso	bailarino/bailarina/dançarino/dançarina/coreógrafo
Egeu	mar/oceano
Creso	rei
Aldous_Huxley	autor/escritor
Jesse_James	criminoso
Howard_Florey	patologista
Lisboa	Porto/porto
Bielorrússia	Europa
Vale_da_Morte	deserto
Brasil	América_do_Sul
Christopher_Marlowe	poeta/poetisa/Poetas/dramaturgo
Julio_Iglesias	cantador/cantor/cantora/vocalista
Omega_Centauri	punhado
Lester_Young	saxofonista/saxofone
Funk	bioquímico
Singapura	ilha
Harlow_Shapley	astrónomo/Astrónomos/astrônomo
Inácio_de_Loyola	Santos/santo/teólogo
Rio_Yellowstone	rio
Zâmbia	Países_de_África
Mark_Rothko	pintora/pintor
Tallinn	Porto/porto
Sabá	terra/domínio/território/circunscrição/país/distrito/condado/comarca
Marquette	vila/aldeia/povoado/arraial/burgo
Irmãos_Marx	família
Marilyn_Monroe	atriz/actriz
Namibia	Países_de_África
Iwo_Jima	ilha
Guillaume_Apollinaire	poeta/poetisa/Poetas
Cáspio	lago
Katharine_Hepburn	atriz/actriz
William_Hogarth	entalhador
Guiné_Equatorial	Países_de_África
Anwar_Sadat	estadista
Cusco	vila/aldeia/povoado/arraial/burgo
Mar_do_Labrador	mar/oceano
Golda_Meir	estadista
Pirinéus	serra/cordilheira
Arthur_Conan_Doyle	autor/escritor
Capri	ilha
Charles_de_Gaulle	general/estadista
Washington	urbe/município/metrópole/cidade/presidente/general
Cristo	profeta/judia/hebreu/judeu/hebraico
Andhra_Pradesh	província/urbe/estado/município/metrópole/cidade
Edward_Lear	humorista/artista
Lago_Ontário	lago
Mérida	urbe/município/metrópole/cidade
Polónia	Europa
Oliver_Cromwell	general/estadista
José	patriarca/carpinteiro/marceneiro
John_Bardeen	físico
Max_Planck	físico
Dante_Alighieri	poeta/poetisa/Poetas
Cesareia	cais/porto
Heinrich_Schliemann	arqueólogo
Lyon	urbe/município/metrópole/cidade
Alabama	rio/urbe/município/metrópole/cidade/Porto/porto
Assíria	região
Munique	urbe/município/metrópole/cidade
Universidade_Duke	universidade
Oviedo	urbe/município/metrópole/cidade
Nova_Guiné	ilha
Sukarno	estadista
Ken_Russell	cineasta
Richard_Roberts	químico/boticário
Kobe	urbe/município/metrópole/cidade/Porto/porto
James_Cagney	intérprete/artista/actor/ator
Clark_Gable	intérprete/artista/actor/ator
Celsius	astrónomo/Astrónomos/astrônomo
Rabindranath_Tagore	filósofo/autor/escritor
Akhenaton	rei
Galileia	região
Montego_Bay	urbe/município/metrópole/cidade/Porto/porto
Frank_Stella	pintora/pintor
Lubumbashi	urbe/município/metrópole/cidade
Lawrence	vila/aldeia/povoado/arraial/burgo
Revolução_Mexicana	revolução/Revolução
Sófocles	dramaturgo
Hohhot	urbe/município/metrópole/cidade
Helen_Hunt_Jackson	autor/escritor
George_Walker_Bush	presidente
Ganges	rio
Siracusa	cerco/assédio/sítio
Universidade_Stanford	universidade
Costa_do_Marfim	Países_de_África
Lenin	bolchevique/bolchevista
Mogadíscio	Porto/porto
Stephane_Grappelli	violinista
Hargeisa	urbe/município/metrópole/cidade
Himalaia	serra/cordilheira
Guerra_da_Crimeia	guerra
Medina	urbe/município/metrópole/cidade
Labrador	região
São_Jorge	mártir/padroeiro/patrono/orago
Jean_Philippe_Rameau	compositor
Grã_Bretanha	ilha
Charles_Dickens	autor/escritor
Maurice_Wilkins	bioquímico
Lituânia	Países_Bálticos
Brasov	urbe/município/metrópole/cidade
George_Sand	autor/escritor
L._Ron_Hubbard	autor/escritor
Vittorio_de_Sica	cineasta
República_Romana	república/República/Republica
Bremerhaven	urbe/município/metrópole/cidade/Porto/porto
Guiana	América_do_Sul
Jean_Harlow	atriz/actriz
Yang-Tsé	rio
Antioquia	vila/aldeia/povoado/arraial/burgo
Robert_Southey	poeta/poetisa/Poetas
Herbert_Marcuse	filósofo
Genebra	urbe/personagem/município/metrópole/cidade
François_Truffaut	cineasta
André_Maurois	autor/escritor
Hungria	Europa
Robert_Owen	cruzado/reformador/industrialista/industrial
Saul	rei
Camarões	vulcão/Países_de_África
Wembley	vizinhança/bairro
Sinai	península
Persépolis	urbe/município/metrópole/cidade
Assam	província/estado
James_Bond	personagem
Mosaic	Navegador/navegador
Canal_da_Mancha	canal
Guangdong	província/estado
Paracelso	doutor/médico
Edvard_Munch	pintora/pintor
Long_Island	ilha
Saddam_Hussein	líder/chefe
Fats_Domino	compositor
Utica	urbe/município/metrópole/cidade
Elie_Wiesel	historiador/cronista/autor/escritor
Peter_Behrens	designer/arquitecto
Hongkong	urbe/município/metrópole/cidade/Porto/porto
Baiona	urbe/município/metrópole/cidade
Ed_Sullivan	mediador
Omar_Khayyam	astrónomo/Astrónomos/astrônomo/poeta/poetisa/Poetas/matemático
Cincinnati	urbe/município/metrópole/cidade
Gustav_Mahler	maestro/compositor
Stéphane_Mallarmé	poeta/poetisa/Poetas
Mallorca	ilha
Tio_Sam	personagem
Boris_Karloff	intérprete/artista/actor/ator
Richard_Nixon	presidente
Canaã	região
Walter_Raleigh	colonizador/cortesão
Pancho_Villa	revolucionário/subversivo/Revolucionário
Tália	musa
Indiana	urbe/município/metrópole/cidade
Sikkim	região
Guiné	Países_de_África
Júlio_Verne	autor/escritor
Mossul	urbe/município/metrópole/cidade
Pártia	região
Bahamas	terra/nação/país
Iago	personagem
Bandung	urbe/município/metrópole/cidade
Croacia	Europa
Patrick_White	autor/escritor
Turquestão	região
Hugo_Grócio	jurisconsulto/jurista/diplomata/embaixador
Dubai	urbe/município/metrópole/cidade/Porto/porto
Mar_Tirreno	mar/oceano
Cabo_Verde	terra/nação/país
Excalibur	gládio/espada
Lua	satélite
África	Continente/continente
Tangshan	urbe/município/metrópole/cidade
Swansea	urbe/município/metrópole/cidade/Porto/porto
Fort_Myers	vila/aldeia/povoado/arraial/burgo
Basílica_de_Santa_Sofia	museu
Gary_Cooper	intérprete/artista/actor/ator
Barroco	idade/época/era/período
Edward_Weston	fotógrafa/fotógrafo
Comores	país/nação/terra
Drácula	personagem
Luigi_Pirandello	dramaturgo/escritor
Monte_Rushmore	cume/cimeira/cimo
Prometeu	Titã
Cólquida	região
Henry_Moore	escultor
Hobart	Porto/porto
Hershey	vila/aldeia/povoado/arraial/burgo
John_Constable	pintora/pintor
Newport	urbe/município/metrópole/cidade/Porto/porto
câncer	signo
Madonna	cantador/cantor/cantora/vocalista
Paul_Newman	intérprete/artista/actor/ator
Hangzhou	urbe/município/metrópole/cidade
Neerlândia	Europa
Esparta	urbe/município/metrópole/cidade
Terciário	período
Venezuela	América_do_Sul
Bertolt_Brecht	poeta/poetisa/Poetas/dramaturgo
Havaí	ilha
Touro	signo
Manhattan	ilha
Filipinas	arquipélago/terra/nação/país
Jackson_Pollock	pintora/pintor
Martin_Scorsese	cineasta
Eureka	vila/aldeia/povoado/arraial/burgo
Fort_Lauderdale	urbe/município/metrópole/cidade
Klaus_Fuchs	físico
Gustave_Flaubert	autor/escritor
Andrés_Segovia	violonista/guitarrista/guitarra/compositor
Pamir	serra/cordilheira
Nablus	urbe/município/metrópole/cidade
Turquemenistão	terra/nação/país
Buffalo	urbe/município/metrópole/cidade
zepelim	aeronave/dirigível
Canal_de_Moçambique	canal
Huntington	urbe/município/metrópole/cidade
Kosovo	província/estado
Monte_Fuji	vulcão
Max_Weber	sociólogo
Pateta	personagem
José_Ortega_y_Gasset	filósofo
Níger	rio/Países_de_África
Hispaniola	ilha
Gian_Carlo_Menotti	compositor
Immanuel_Kant	filósofo
Balcãs	península
Hiroshima	urbe/município/metrópole/cidade/Porto/porto
William_Butler_Yeats	poeta/poetisa/Poetas/dramaturgo
César_Franck	compositor
Holanda	Europa
Nestor	conselheiro
Zanzibar	ilha
São_Marino	Europa
Samuel_Beckett	dramaturgo/autor/escritor
Universidade_da_Pensilvânia	universidade
Etiópia	Países_de_África
Bruno_Walter	maestro
Richard_Burton	ator/actor/artista/intérprete
Corregidor	cerco/assédio/sítio
litania	prece/oração
Alepo	urbe/município/metrópole/cidade
Suez	urbe/município/metrópole/cidade
Dubrovnik	urbe/município/metrópole/cidade/Porto/porto
Madeira	rio/ilha
Fátima	muçulmano/Muçulmanos
Caxemira	região
T._S._Eliot	poeta/poetisa/Poetas/dramaturgo
Simone_de_Beauvoir	existencialista/autor/escritor/feminista
Henri_Bergson	filósofo
Rio_Orange	rio
Paul_Cézanne	pintora/pintor
Francisco_Franco	general/autocrata/ditador
Andes	serra/cordilheira
Madagascar	Países_de_África/ilha
República_do_Quénia	Países_de_África
Sérvia	região
Puebla	urbe/município/metrópole/cidade
Frankfurt	urbe/município/metrópole/cidade
Zimbabwe	Países_de_África
Robert_Frost	poeta/poetisa/Poetas
Moçambique	Países_de_África
Lituania	Países_Bálticos
Buenos_Aires	Porto/porto
Taiti	ilha
Bali	ilha
São_Gonçalo	urbe/município/metrópole/cidade
Báltico	mar/oceano
Ted_Hughes	poeta/poetisa/Poetas
Setúbal	urbe/município/metrópole/cidade/Porto/porto
Victor_Hugo	poeta/poetisa/Poetas/dramaturgo/escritor
Annaba	urbe/município/metrópole/cidade/Porto/porto
Monte_Carlo	vila/aldeia/povoado/arraial/burgo
Gibraltar	assentamento/Cabo/promontório
Sherlock_Holmes	personagem
Andrzej_Wajda	cineasta
Bengala	região
Quioto	urbe/município/metrópole/cidade
Medellín	urbe/município/metrópole/cidade
Colunas_de_Hércules	formação
Tebaldi	soprano
Péricles	estadista
Fidel_Castro	socialista
Zimbabwé	Países_de_África
Timor-Leste	terra/nação/país
John_Reed	Comunistas/comunista/jornalista/periodista
Seneca	dramaturgo/filósofo/estadista
Rute	esposa/mulher
Conacri	Porto/porto
Yellowknife	vila/aldeia/povoado/arraial/burgo
Plutarco	biografista/biógrafo
Israel	terra/nação/país/reino
Victoria	Porto/porto
Alberto_Giacometti	pintora/pintor/escultor
Fukuoka	urbe/município/metrópole/cidade
James_Agee	escritor
Cancer	constelação
Arábia	península
Liverpool	urbe/município/metrópole/cidade/Porto/porto
Sophia_Loren	atriz/actriz
Mar_da_China_Oriental	mar/oceano
Seleuco	general
Dominica	terra/nação/país
Oceano_Atlântico	oceano/mar
Edgar_Wallace	autor/escritor
B._B._King	cantador/cantor/cantora/vocalista/guitarra/guitarrista/violonista
Varese	compositor
Coventry	urbe/município/metrópole/cidade
Pinchas_Zukerman	violinista
Marrocos	Países_de_África
Oseias	profeta
Cataluña	terra/domínio/território/circunscrição/país/distrito/condado/comarca
Titã	satélite
Moldávia	Europa
Estêvão	autor/escritor
Safo	poetisa
Otelo	personagem
Mar_Báltico	mar/oceano
Klaipeda	urbe/município/metrópole/cidade
Nanning	urbe/município/metrópole/cidade
Maurice_Chevalier	cantador/cantor/cantora/vocalista/intérprete/artista/actor/ator
Te_Deum	hino
Michael_Ondaatje	autor/escritor
Seychelles	terra/ilha/nação/país
Polinésia	arquipélago
Abel	matemático
Congo	rio
Extremo_Oriente	região
John_Deere	industrialista/industrial
D._H._Lawrence	autor/escritor
Tamerlão	governador/governante
Universidade_Cornell	universidade
Joanesburgo	urbe/município/metrópole/cidade
Roger_Fry	pintora/pintor
Horácio	poeta/poetisa/Poetas
Pine_Bluff	vila/aldeia/povoado/arraial/burgo
Mónaco	principado/Europa
Carlos	terrorista
Guerra_dos_Trinta_Anos	guerra
Esdras	clérigo/padre/sacerdote/escriba
Antofagasta	urbe/município/metrópole/cidade/Porto/porto
Carlota	urbe/município/metrópole/cidade
Agra	urbe/município/metrópole/cidade
Veracruz	urbe/município/metrópole/cidade/Porto/porto
Columbia	vila/aldeia/povoado/arraial/burgo
Samuel_Johnson	autor/escritor
Samarcanda	urbe/município/metrópole/cidade
Betty_Friedan	feminista
Portsmouth	vila/urbe/município/metrópole/cidade/aldeia/povoado/arraial/burgo/Porto/porto
Daphne_du_Maurier	autor/escritor
Estrasburgo	urbe/município/metrópole/cidade
República_da_China	ilha
Alex_Haley	autor/escritor
David_Hume	filósofo
Roosevelt	presidente
Artur	presidente
Sigmund_Romberg	compositor
Incheon	urbe/município/metrópole/cidade/Porto/porto
Bernardo_Bertolucci	cineasta
James_Naismith	pedagogo/educador
Estreito_de_Gibraltar	estreito
Ithaca	vila/aldeia/povoado/arraial/burgo
Benjamim	patriarca
Francis_Bacon	filósofo/estadista
Kaunas	urbe/município/metrópole/cidade
Mórmon	profeta
Shirley_Temple	atriz/actriz
Fort_Worth	urbe/município/metrópole/cidade
Pensilvânia	urbe/município/metrópole/cidade
Ninive	urbe/município/metrópole/cidade
Omaha	urbe/município/metrópole/cidade
Alborg	urbe/município/metrópole/cidade/Porto/porto
Américo_Vespúcio	navegador
Ezra_Pound	poeta/poetisa/Poetas/autor/escritor
Oxford	urbe/município/metrópole/cidade
Florence_Nightingale	aia/ama-seca/enfermeira/enfermeiro
União	América/Estados_Unidos/EUA/E.U.A.
Edith_Cavell	enfermeiro/enfermeira/ama-seca/aia
Mãe_de_Jesus	judia/judeu/progenitora/mãe
Grandes_Planícies	prado/pradaria
Kirkuk	urbe/município/metrópole/cidade
César_Bórgia	cardeal/soldado/militar
George_Eastman	industrialista/industrial/artífice/inventor/descobridor
Peter_Stuyvesant	administrador/executivo
Christopher_Isherwood	autor/escritor
Douglas_Fairbanks	intérprete/artista/actor/ator
Frank_Capra	cineasta
Jean-Luc_Godard	cineasta
Africa	Continente/continente
Crescente_Fértil	região
Apalaches	serra/cordilheira
Quetzalcoatl	Deus/deus/divindade/deusa
Arthur_Evans	arqueólogo
Joaquim	violinista/compositor
República_da_Lituânia	Países_Bálticos
Margaret_Court	tenista
Ginger_Rogers	bailarino/bailarina/dançarino/dançarina/atriz/actriz
Uttar_Pradesh	província/estado
Uganda	Países_de_África
Tânger	urbe/município/metrópole/cidade
Minneapolis	urbe/município/metrópole/cidade
Nilo	rio
Sigmund_Freud	psicanalista/neurologista
Grande_Depressão	recessão/idade/depressão/época/era/período
John_Dalton	físico/químico/boticário
Buffalo_Bill	divulgador/promoter/empresário
Leonor	rainha
Reino_Unido	reino
Nova_Inglaterra	região
Universidade_Carnegie_Mellon	universidade
Micenas	urbe/município/metrópole/cidade
Naum	profeta
Pierre_Boulez	compositor
Virginia_Beach	urbe/município/metrópole/cidade
Golden_Gate	estreito
South_Pacific	parte/tomo/pedaço/porção/secção
Humphrey_Bogart	intérprete/artista/actor/ator
Nord	região
Sudão	Países_de_África
John_Marshall	jurisconsulto/jurista
Raleigh	colonizador/cortesão
Babilónia	região/urbe/município/metrópole/cidade
Medellin	urbe/município/metrópole/cidade
Jr.	intérprete/químico/artista/actor/ator/boticário
Youngstown	urbe/município/metrópole/cidade
Helen_Keller	autor/escritor/conferencista
Kieslowski	cineasta
America	terra/chão/solo/relevo
Dnipropetrovsk	urbe/município/metrópole/cidade
Mosa	rio
Kilimanjaro	cume/cimeira/cimo
Guy_de_Maupassant	autor/escritor
Doris_Lessing	autor/escritor
Bloemfontein	urbe/município/metrópole/cidade
Auschwitz-Birkenau	campo_de_concentração
Sarasota	vila/aldeia/povoado/arraial/burgo
Agatha_Christie	autor/escritor
James	autor/filósofo/escritor/psicólogo
Revolução_Francesa	revolução/Revolução
Winchester	urbe/município/metrópole/cidade
Ucrânia	terra/nação/país
W._H._Auden	poeta/poetisa/Poetas
William_S._Burroughs	autor/escritor
Roy_Lichtenstein	pintora/pintor
Marlene_Dietrich	cantador/cantor/cantora/vocalista/atriz/actriz
Frederico	vila/aldeia/povoado/arraial/burgo
Hertfordshire	condado
Josef_von_Sternberg	cineasta
Kauai	ilha
Port_Louis	Porto/porto
Emily_Dickinson	poeta/poetisa/Poetas
Pearl_Harbor	cais/porto
Detroit	urbe/município/metrópole/cidade/Porto/porto
Gloria_Steinem	feminista
Friedrich_Nietzsche	filósofo
caaba	relicário/santuário
Sydney_Pollack	cineasta
Ivan_Lendl	tenista
Eslovénia	Europa
touro	constelação
Salina	vila/aldeia/povoado/arraial/burgo
Toni_Morrison	autor/escritor
Ilíria	região
Gémeos	signo
Portland	urbe/município/metrópole/cidade
Monte_Branco	cume/cimeira/cimo
Vichy	vila/aldeia/povoado/arraial/burgo
Lionel_Barrymore	intérprete/artista/actor/ator
Tom_Wolfe	autor/escritor
Bonn	urbe/município/metrópole/cidade
República_Dominicana	terra/nação/país
Nova_Orleães	urbe/município/metrópole/cidade
Richard_Smalley	químico/boticário
Plínio	autor/escritor
Henry	físico
Valentina_Tereshkova	astronauta/cosmonauta
Tunisia	Países_de_África
Saara	deserto
Osaka	urbe/município/metrópole/cidade/Porto/porto
Martin_Buber	filósofo
Steve_Reich	compositor
Camden_Town	urbe/município/metrópole/cidade
Jutlândia	península
Papa_Pio_V	papa/pontífice
Elizabeth_Taylor	atriz/actriz
John_Keats	poeta/poetisa/Poetas
Isolda	personagem
Thomas_Hobbes	filósofo
Steven_Spielberg	cineasta
Bydgoszcz	urbe/município/metrópole/cidade
São_José_dos_Campos	urbe/município/metrópole/cidade
Ilhas_Britânicas	ilha
Zurique	urbe/município/metrópole/cidade
Ardenas	Planalto/patamar/planalto
Maurice_Ravel	compositor
David_Ben_Gurion	estadista
Osman_I	emir
Yehudi_Menuhin	violinista
Arturo_Toscanini	maestro
Henry_Ford	industrialista/industrial
Albert_Camus	existencialista/autor/escritor
Ferdinand_de_Saussure	linguista/lingüista
Indonesia	terra/nação/país
Grace_Kelly	atriz/actriz
Janis_Joplin	cantador/cantor/cantora/vocalista
Jacob_Epstein	escultor
Eugene_Ormandy	maestro
Harry_Truman	presidente
Sidon	urbe/município/metrópole/cidade
Henry_David_Thoreau	autor/escritor
Robert_Browning	poeta/poetisa/Poetas
Miguel_de_Cervantes	dramaturgo/autor/escritor
William_Faulkner	escritor
Sri_Lanka	terra/nação/país
Sarajevo	urbe/município/metrópole/cidade
George_Armstrong_Custer	general
Percy_Bysshe_Shelley	poeta/poetisa/Poetas
Carneiro	constelação
Antilhas_Holandesas	ilha
Benedito	Santos/santo/frade/monge/frei
Tratado_de_Versalhes	pacificação/paz
Colima	vulcão
Herculano	urbe/município/metrópole/cidade
Carl_Rogers	psicólogo
Roman_Jakobson	linguista/lingüista
Morávia	região
Erato	musa
Hejaz	região
Escocia	Europa
Thomas_Pynchon	autor/escritor
W._C._Fields	cômico/cómico/comediante
Leonard_Bernstein	maestro/compositor
Ester	judeu/judia/rainha
República_Democrática_do_Congo	Países_de_África
Lot	judia/hebreu/judeu/hebraico
Langston_Hughes	autor/escritor
Malaui	Países_de_África
Luoyang	urbe/município/metrópole/cidade
Alexander_Hamilton	estadista
Gengis_Khan	imperador
Gianni_Versace	costureiro/designer/desenhador
Campeche	província/estado
Northumberland	condado
Sigrid_Undset	autor/escritor
Leonardo_da_Vinci	designer/arquitecto/escultor/engenheiro
União_das_Repúblicas_Socialistas_Soviéticas	terra/nação/país
Coreia	península
Maurício	terra/nação/país
Vesúvio	vulcão
Suharto	estadista
Marco_António	general
Adolphe_Sax	fazedor
Apus	constelação
Georges_Braque	pintora/pintor
Charles_Lindbergh	piloto-aviador/aeronauta/piloto/aviadora/aviador
Clifford_Odets	dramaturgo
Belarus	Europa
dragão	constelação
Nantucket	ilha
Peru	América_do_Sul
Carl_Orff	Músico/músico/pedagogo/educador
República_Centro-Africana	Países_de_África
paleozóico	era/período
Lisandro	general
Asdrúbal	cartaginês/general
Knoxville	urbe/município/metrópole/cidade
Anna_Pavlova	bailarino/bailarina/dançarino/dançarina
Austrália	terra/nação/país/Continente/continente
Palau	terra/nação/país
Gâmbia	Países_de_África
Manchúria	região
Flávio_Josefo	historiador/cronista/general
Império_Bizantino	região
Bette_Davis	atriz/actriz
Cumaná	urbe/município/metrópole/cidade/Porto/porto
Lago_Tanganica	lago
James_Buchanan	presidente
John_Dewey	filósofo/pedagogo/educador
James_Mason	intérprete/artista/actor/ator
Tampere	urbe/município/metrópole/cidade
Arequipa	urbe/município/metrópole/cidade
Menandro	dramaturgo
Tessália	região
Gloria_Swanson	atriz/actriz
Snoopy	personagem
Norte	América/Estados_Unidos/EUA/E.U.A.
Surrey	condado
François_Mitterrand	estadista
Abelardo	filósofo/teólogo
Camelot	capital/Capital
Franz_Schubert	compositor
William_Carlos_Williams	poeta/poetisa/Poetas
Edward_G._Robinson	intérprete/artista/actor/ator
Colin_Powell	general/estadista
Zabrze	urbe/município/metrópole/cidade
Renânia	região
Trafalgar_Square	praça
Wilhelm_Reich	psicanalista
Aristóteles	filósofo
Sueste_Asiático	região
Paleolítico_Superior	período/etapa/tempo
Turim	urbe/município/metrópole/cidade
Alpes	serra/cordilheira
Hiparco	astrónomo/Astrónomos/astrônomo/matemático
Honoré_Daumier	pintora/pintor
Dortmund	urbe/município/metrópole/cidade
Etna	vulcão
Moira_Shearer	bailarino/bailarina/dançarino/dançarina/atriz/actriz
Georg_Friedrich_Händel	compositor
Parténon	templo
Rupert_Murdoch	editor/editora
Bósnia-Herzegóvina	Europa
Pittsburgh	urbe/município/metrópole/cidade
Thornton_Wilder	dramaturgo/autor/escritor
Le_Havre	urbe/município/metrópole/cidade/Porto/porto
Bahrein	ilha
Xian	urbe/município/metrópole/cidade
Gólgota	colina/barranco/monte/morro/montanha/ladeira
George_Town	capital/Capital
Bruce_Lee	intérprete/artista/actor/ator
Claude_Debussy	compositor
Tycho_Brahe	astrónomo/Astrónomos/astrônomo
Peter	Santos/santo/apóstolo
Waco	urbe/município/metrópole/cidade
Tâmil_Nadu	província/estado
Letónia	Países_Bálticos
James_Joyce	autor/escritor
Roy_Orbison	cantador/cantor/cantora/vocalista/compositor
Al_Jolson	cantador/cantor/cantora/vocalista/intérprete/artista/actor/ator
Louis_B._Mayer	cineasta
Scott_Joplin	compositor
Tomé	Santos/santo/apóstolo
Fritz_Haber	químico/boticário
Caribe	mar/região/oceano
Cáli	urbe/município/metrópole/cidade
Ilhas_Shetland	arquipélago
Tucídides	historiador/cronista
Dalton_Trumbo	roteirista
Mocambique	Países_de_África
Tennessee	rio
Milton_Friedman	economista
Sena	rio
Brighton	urbe/município/metrópole/cidade
Glasgow	urbe/município/metrópole/cidade/Porto/porto
Milwaukee	urbe/município/metrópole/cidade
Bordéus	urbe/município/metrópole/cidade/Porto/porto
Sichuan	província/estado
Niger	Países_de_África
Maria	judia/judeu/progenitora/mãe
Caaba	relicário/santuário
Vístula	rio
Outono	evento/acontecimento/fato
Eindhoven	urbe/município/metrópole/cidade
Edgar_Rice_Burroughs	autor/escritor
Fez	urbe/município/metrópole/cidade
Steven_Weinberg	físico
Sino_da_Liberdade	sino
Bangor	vila/aldeia/povoado/arraial/burgo
Aragão	autor/terra/domínio/território/circunscrição/país/distrito/condado/comarca/escritor
Rio_da_Prata	estuário
Ilhas_Cayman	colónia
John	Santos/santo/apóstolo/evangelista
Yunnan	província/estado
Chemnitz	urbe/município/metrópole/cidade
Iucatã	província/península/estado
Ilha_do_Norte	ilha
Judy_Garland	cantador/cantor/cantora/vocalista/atriz/actriz
Mesolítico	período/etapa/tempo
Lupus	constelação
Barranquilla	urbe/município/metrópole/cidade/Porto/porto
Oceano_Índico	mar/oceano
Paul_Simon	compositor/cantador/cantor/cantora/vocalista
Guerra_da_Coreia	guerra
Trygve_Lie	diplomata/embaixador
Winston_Churchill	autor/escritor/estadista
Benoît_Mandelbrot	matemático
Hermosillo	urbe/município/metrópole/cidade
James_Matthew_Barrie	dramaturgo
Donatello	escultor
Maryland	urbe/município/metrópole/cidade/Porto/porto
Extremo-Oriente	região
Aníbal	cartaginês/general
Antlia	constelação
Cristovão_Colombo	navegador
Brunei	sultanato
Anthony_Hopkins	intérprete/artista/actor/ator
Cordell_Hull	diplomata/embaixador
Ken_Kesey	autor/escritor
Sibéria	região
Guadalcanal	ilha
Benjamin_Disraeli	estadista
Annie_Oakley	atirador
Estátua_da_Liberdade	monumento/estátua
Joseph_Joachim	violinista/compositor
John_Addington_Symonds	autor/escritor
Vidas_Paralelas	biografia
Tibre	rio
Lund	urbe/município/metrópole/cidade
Argentina	América_do_Sul
Recife	urbe/município/metrópole/cidade/Porto/porto
Baçorá	urbe/município/metrópole/cidade/Porto/porto
Tampico	urbe/município/metrópole/cidade/Porto/porto
Cassiopeia	constelação
Macau	possessão
Aleutas	arquipélago
Pedro	Santos/santo/apóstolo
Biblos	escavação
Presidente_Bush	presidente
Lausana	urbe/município/metrópole/cidade
Barbra_Streisand	cantador/cantor/cantora/vocalista/atriz/actriz
Revolução_Gloriosa	revolução/Revolução
Bihar	província/estado
Lhotse	cume/cimeira/cimo
Montserrat	ilha
Virginia_Woolf	autor/escritor
Patagónia	região
África_Central	Países_de_África
Terra_do_Fogo	arquipélago
Jesus	profeta/judia/hebreu/judeu/hebraico
Centaurus	constelação
Barém	ilha
Ciro	príncipe/Príncipe
Erin	Irlanda
Gettysburg	vila/aldeia/povoado/arraial/burgo
Guerra_de_Tróia	guerra
Kansas	vila/rio/aldeia/povoado/arraial/burgo
Menachem_Begin	estadista
Andrew_Jackson	presidente/general
Nauru	ilha/terra/nação/país
Bitínia	região
Ásia	continente/Continente
Ítaca	ilha
Junkers	engenheiro
Igor_Stravinski	compositor
Renascimento	idade/época/era/período
Instituto_de_Tecnologia_de_Massachusetts	universidade
John_Updike	autor/escritor
Federico_Fellini	cineasta
Isócrates	retor/discursante/interveniente/orador
Tchaikovsky	compositor
Flavio_Josefo	historiador/cronista/general
Theodore_Dreiser	autor/escritor
Lascaux	caverna/furna/gruta
Lucas	roteirista/cineasta
Taichung	urbe/município/metrópole/cidade
Texas	urbe/Porto/porto/município/metrópole/cidade
Guilherme_Tell	arqueiro
Amazonas	rio
Mohammed_Omar	político
Judeia	região
Rod_Laver	tenista
Escorpião	constelação/signo
Heinrich_von_Kleist	dramaturgo
Edward_Albee	dramaturgo
Países_Baixos	região/Europa
Brandemburgo	região
Caucaso	região
Auriga	constelação
crux	constelação
Génova	urbe/município/metrópole/cidade
Cádis	urbe/município/metrópole/cidade/Porto/porto
Bombaim	urbe/município/metrópole/cidade
Jean_Sibelius	compositor
Conferência_de_Potsdam	conferência
Grand_Canyon	garganta
Osasco	urbe/município/metrópole/cidade
Joseph_Schumpeter	economista
Marcel_Duchamp	artista
Gary	urbe/município/metrópole/cidade
Rosario	urbe/município/metrópole/cidade
República_das_Ilhas_Marshall	terra/nação/país
Springfield	urbe/município/metrópole/cidade
Mar_Egeu	mar/oceano
José_de_Arimateia	carpinteiro/marceneiro
Samuel	profeta
Bristol	urbe/município/metrópole/cidade/Porto/porto
Triângulo_das_Bermudas	ambiente/região/território
Nova_Zelândia	ilha/terra/nação/país
Benedict_Arnold	traidor/general
Sousse	urbe/município/metrópole/cidade/Porto/porto
Mar_do_Norte	mar/oceano
Salman_Rushdie	autor/escritor
Hastings	vila/aldeia/povoado/arraial/burgo
Viña_del_Mar	urbe/município/metrópole/cidade
Eurípedes	dramaturgo
Sunderland	vila/aldeia/povoado/arraial/burgo/Porto/porto
Líbia	Países_de_África
Numídia	reino
Chernobyl	urbe/município/metrópole/cidade
Malavi	Países_de_África
Mar_de_Kara	mar/oceano
Guerra_dos_Seis_Dias	guerra
Cambridge	urbe/município/metrópole/cidade
Robert_Louis_Stevenson	autor/escritor
África_Ocidental	região
Wallace_Stevens	poeta/poetisa/Poetas
Las_Vegas	urbe/município/metrópole/cidade
Novosibirsk	urbe/município/metrópole/cidade
Saki	autor/escritor
Kenneth_Kaunda	estadista
Mindanau	ilha
Robert_Venturi	designer/arquitecto
San_Pedro_Sula	urbe/município/metrópole/cidade
Vittorio_De_Sica	cineasta
Kalahari	deserto
Marselha	urbe/município/metrópole/cidade/Porto/porto
Píndaro	poeta/poetisa/Poetas
Babel	zigurate
Cícero	retor/discursante/interveniente/orador/estadista
Santa_Sé	Europa/urbe/município/metrópole/cidade
Ródano	rio
Bela_Bartók	pianista/compositor
Grandes_Antilhas	arquipélago
Herbert_Hoover	presidente
Whitehall	rua
Escandinávia	península/região
Boris_Pasternak	autor/escritor
Nínive	urbe/município/metrópole/cidade
Bélgica	Europa
Gertrude_Lawrence	atriz/actriz
Matusalém	patriarca
Paris	vila/aldeia/povoado/arraial/burgo
República_da_Guiné	Países_de_África
Krzysztof_Kieslowski	cineasta
William_Wyler	cineasta
Arlington	urbe/município/metrópole/cidade
Hank_Williams	compositor/cantador/cantor/cantora/vocalista
Bangalore	urbe/município/metrópole/cidade
Robert_Curl	químico/boticário
Sudeste	região
Áustria-Hungria	região
Bombaím	urbe/município/metrópole/cidade
Loire	rio
Haia	urbe/município/metrópole/cidade
Saragoça	urbe/município/metrópole/cidade
Rio_Congo	rio
Clio	musa
Herbert_Spencer	sociólogo/filósofo
Apeninos	serra/cordilheira
Anguilla	ilha
Miami	urbe/município/metrópole/cidade
Região_Autónoma_da_Madeira	arquipélago
Saara_Ocidental	região
São_Bernardo_do_Campo	urbe/município/metrópole/cidade
Ludwig_van_Beethoven	compositor
Hipócrates	médico
Lanzhou	urbe/município/metrópole/cidade
Pasto	vulcão
Gustave_Courbet	pintora/pintor
Grande_Muralha_da_China	baluarte/trincheira/muralha
Émile_Durkheim	sociólogo
Claude_Monet	pintora/pintor
Oceano_Ártico	oceano/mar
Universidade_da_Carolina_do_Norte	universidade
Billie_Jean_King	tenista
Augusto	estadista
Moshe_Dayan	general/estadista
Havai	ilha
Alfred_Eisenstaedt	fotógrafa/fotógrafo
Ilhas_Samoa	ilha
Bolonha	urbe/município/metrópole/cidade
Freetown	Porto/porto
Pall_Mall	rua
Lago_Chade	lago
Eva_Braun	chefa/amante/directoria
Antígua	ilha
Botswana	Países_de_África
Greensboro	urbe/município/metrópole/cidade
Evelyn_Waugh	autor/escritor
Fort_Wayne	urbe/município/metrópole/cidade
Edmund_Burke	retor/discursante/interveniente/orador/estadista
Granada	urbe/terra/município/metrópole/cidade/nação/país
Istambul	urbe/município/metrópole/cidade
Assurbanipal	rei
Sídon	urbe/município/metrópole/cidade
Nantes	urbe/município/metrópole/cidade/Porto/porto
Stéphane_Grappelli	violinista
Universidade_Yale	universidade
Louis_Pasteur	biólogo/biologista/químico/boticário
Sarah_Bernhardt	atriz/actriz
Islândia	ilha/Europa
Meuse	rio
George_Szell	maestro
Skagerrak	estreito
Bergen	urbe/município/metrópole/cidade/Porto/porto
Arcádia	região
William_Styron	autor/escritor
República_dos_Camarões	Países_de_África
Johannes_Kepler	astrónomo/Astrónomos/astrônomo
Sião	colina/barranco/monte/morro/montanha/ladeira
Lafayette	vila/aldeia/povoado/arraial/burgo
Cabo	província/estado
Castela	terra/domínio/território/circunscrição/país/distrito/condado/comarca
Wassily_Kandinsky	pintora/pintor
Goethe	Poetas/escritor/dramaturgo/poetisa/poeta
Grandes_Lagos	conjunto/grupo
Sfax	urbe/município/metrópole/cidade
Ford	industrialista/industrial
Barbara_Hepworth	escultor
Frísia	região
João_Batista	eremita/recluso/ermitão/Santos/santo
Ludwig_Wittgenstein	filósofo
Reagan	presidente
Delphinus	constelação
Robert_Peary	exploradora/explorador
Spike_Lee	cineasta
República_do_Congo	Países_de_África
Homero	poeta/poetisa/Poetas
Buster_Keaton	intérprete/artista/actor/ator/cômico/cómico/comediante
Monte_Ararat	cume/cimeira/cimo
Felipe	príncipe/Príncipe
Bremen	urbe/município/metrópole/cidade
Joe_Clark	político
Ilhas_Feroé	possessão
César	general/estadista
Finlândia	Europa
Adam_Smith	economista
Virgílio	poeta/poetisa/Poetas
Viatcheslav_Molotov	estadista
Senegal	Países_de_África
René_Magritte	pintora/pintor
Loretta_Young	actriz/atriz
Paraná	rio
Victor_Horta	designer/arquitecto
Hollywood	vizinhança/bairro
Bari	urbe/município/metrópole/cidade
Maharashtra	região
Neville_Chamberlain	estadista
Arthur_Schopenhauer	filósofo
Benito_Mussolini	autocrata/ditador
Benin	Países_de_África
Terpsícore	musa
Reno	rio
Fred_Zinnemann	cineasta
Abrão	patriarca
O_Capital	livro
Palácio_de_Buckingham	castelo/palácio
Houston	urbe/município/metrópole/cidade/Porto/porto
Cairo	Porto/porto
Cnossos	vila/aldeia/povoado/arraial/burgo
Ceilão	terra/nação/país
Paleolítico	período/etapa/tempo
Rapid_City	vila/aldeia/povoado/arraial/burgo
Pérsia	império
Rudyard_Kipling	autor/escritor
Sara	esposa/mulher
Redonda	ilha
Livónia	região
Valparaíso	urbe/município/metrópole/cidade/Porto/porto
Dalila	directoria/amante/chefa
Haiti	terra/ilha/nação/país
Java	ilha
Calderón_de_la_Barca	poeta/poetisa/Poetas/dramaturgo
Santa_Maria_de_Belém	urbe/município/metrópole/cidade/Porto/porto
Jackson	presidente/general
Mali	Países_de_África
Montanhas_Rochosas	serra/cordilheira
Sean_O'Casey	dramaturgo
Pai_Nosso	prece/oração
Key_West	vila/aldeia/povoado/arraial/burgo
Catalunha	terra/domínio/território/circunscrição/país/distrito/condado/comarca
Filipe	príncipe/Príncipe
Malmö	urbe/município/metrópole/cidade/Porto/porto
Sodoma	urbe/município/metrópole/cidade
Arca_da_Aliança	arca/mala/baú
Léonide_Massine	bailarino/bailarina/dançarino/dançarina/coreógrafo
Andrew_Lloyd_Webber	compositor
Europa	Continente/continente
Port_Sudan	urbe/município/metrópole/cidade/Porto/porto
World_Trade_Center	arranha-céu
Pompeu	general/estadista
Ingrid_Bergman	atriz/actriz
Demóstenes	retor/discursante/interveniente/orador/ateniense/estadista
August_Strindberg	dramaturgo
Atlas	Titã
Tasmânia	ilha
New_Haven	urbe/município/metrópole/cidade
Lubeck	urbe/município/metrópole/cidade
Herbert_Simon	economista/psicólogo
Gloucester	urbe/município/metrópole/cidade
Egito	império/Países_de_África
Hull	urbe/município/metrópole/cidade/Porto/porto
Innsbruck	urbe/município/metrópole/cidade
Witwatersrand	região
Lübeck	urbe/município/metrópole/cidade
Salto_Angel	cachoeira/catarata/cascata
Edward_Tatum	bioquímico
Calais	vila/aldeia/povoado/arraial/burgo/Porto/porto
Humphry_Davy	químico/boticário
Sumatra	ilha
John_Wayne	intérprete/artista/actor/ator
Madagáscar	Países_de_África/ilha
Francisco_de_Goya	pintora/pintor
Assuão	urbe/município/metrópole/cidade
Platão	filósofo
Ottorino_Respighi	compositor
Rio	urbe/município/metrópole/cidade
Benny_Hill	cômico/cómico/comediante
Dijon	urbe/município/metrópole/cidade
Cronos	Titã
Gana	Países_de_África
Waterloo	vila/aldeia/povoado/arraial/burgo
Dusseldorf	urbe/município/metrópole/cidade
Liège	urbe/município/metrópole/cidade
Marrakech	urbe/município/metrópole/cidade
Gerald_Ford	presidente
Dashiell_Hammett	autor/escritor
Opel	industrialista/industrial
Chipre	ilha/terra/nação/país
sudeste	região
Bob_Marley	cantador/cantor/cantora/vocalista
Estados_Pontifícios	terra/domínio/território/circunscrição/país/distrito/condado/comarca
Bill_Clinton	presidente
Thomas_Nast	desenhista
Kent	pintora/pintor
Colorado	rio
A_Morte	Morte
Louisville	urbe/município/metrópole/cidade
Alexandre_Dumas	autor/escritor
Túnis	Porto/porto
Taurus	signo/constelação
Albert_Einstein	físico
Vitus_Bering	navegador
Henry_Morgan	pirata/corsário
Herodes	rei
Edgar_Degas	pintora/pintor
Bósforo	estreito
Dalmácia	região
Apeldoorn	urbe/município/metrópole/cidade
Robinson_Crusoe	personagem
Marcel_Proust	escritor
P._G._Wodehouse	autor/escritor
Basileia	urbe/município/metrópole/cidade
Desmond_Tutu	primaz/prelado
Richard_Rodgers	compositor
Lago_Eduardo	lago
Tolkien	autor/escritor/filólogo
Edwin_Powell_Hubble	astrofísico
Václav_Havel	dramaturgo/estadista
Jimmy_Carter	presidente
Dresden	urbe/município/metrópole/cidade
Otto_von_Bismarck	estadista
Galileu_Galilei	astrónomo/Astrónomos/astrônomo
Revolução_Cubana	revolução/Revolução
Mar_Morto	lago
Adolf_Eichmann	nazista/nazi
John_Glenn	senadora/senador/cosmonauta/astronauta
ilhota	ilha
Paul_Hindemith	maestro/compositor
Villa-Lobos	compositor
Trento	urbe/município/metrópole/cidade
Anatole_France	autor/escritor
Isaías	profeta
North_Yorkshire	condado
François_Mauriac	autor/escritor
sino	artífice/inventor/descobridor
Sierra_Nevada	serra/cordilheira
Douglas_Fairbanks_Jr.	intérprete/artista/actor/ator
Golfo_da_Tailândia	golfo
W._C._Handy	compositor
Arcangelo_Corelli	violinista/compositor
Engelbert_Humperdinck	compositor
Cork	urbe/município/metrópole/cidade/Porto/porto
Jean_Giraudoux	dramaturgo/escritor
André_Derain	pintora/pintor
Pai_Natal	padroeiro/patrono/orago
Volgogrado	urbe/município/metrópole/cidade
Cole_Porter	compositor
Galáxia_de_Andrómeda	constelação
Mar_da_Irlanda	mar/oceano
São_Paulo	urbe/apóstolo/missionário/Santos/santo/município/metrópole/cidade
Pierrô	personagem
Jabalpur	urbe/município/metrópole/cidade
Arthur_Ashe	tenista
areópago	colina/barranco/monte/morro/montanha/ladeira
Semarang	urbe/município/metrópole/cidade/Porto/porto
Louvre	museu
Cartago	cidade-Estado/cidade-estado
Seattle	urbe/município/metrópole/cidade
Flannery_O'Connor	autor/escritor
Dorado	constelação
Aden	urbe/município/metrópole/cidade/Porto/porto
Rhode_Island	urbe/município/metrópole/cidade
Hesíodo	poeta/poetisa/Poetas
Jerez_de_la_Frontera	urbe/município/metrópole/cidade
Guerra_do_Vietnam	guerra
Henry_Purcell	organista/compositor
pirâmide	monumento
Garona	rio
Santiago_de_Compostela	Santos/santo/apóstolo
Jamaica	terra/nação/país/ilha
Ucrania	terra/nação/país
David	rei/padroeiro/patrono/orago
Anton_Bruckner	organista/compositor
Bob_Hope	cômico/cómico/comediante
Maurice_de_Vlaminck	pintora/pintor
Américas	terra/chão/solo/relevo
Eugène_Sue	autor/escritor
George_Bush	presidente
Grozny	urbe/município/metrópole/cidade
Isaac_Stern	violinista
Turquia	terra/nação/país
Calvin_Coolidge	presidente
Jericó	vila/aldeia/vilarejo
Séneca	dramaturgo/filósofo/estadista
Estonia	Países_Bálticos
Rio_Tejo	rio
Taj_Mahal	mausoléu
Gold_Coast	Países_de_África
Uppsala	urbe/município/metrópole/cidade
Zaratustra	profeta
Cabo_Canaveral	Cabo/promontório
Potsdam	urbe/município/metrópole/cidade
Paulo_de_Tarso	apóstolo/missionário/Santos/santo
La_Spezia	urbe/município/metrópole/cidade/Porto/porto
Bósnia	Europa/província/estado
Ésquilo	dramaturgo
Reims	urbe/município/metrópole/cidade
Wilmington	vila/aldeia/povoado/arraial/burgo
Nebulosa_do_Caranguejo	supernova
Transvaal	província/estado
Espanha	urbe/Europa/município/metrópole/cidade
Orleães	cerco/assédio/sítio
Oliver_Stone	cineasta
Grover_Cleveland	presidente
Carolinas	região
xhosa	Comunidade/comunidade
João_Pessoa	urbe/município/metrópole/cidade
Albert_Schweitzer	organista/doutor/médico/missionário/filósofo
Mary_Shelley	autor/escritor
Mysore	urbe/município/metrópole/cidade
Charles_Goodyear	artífice/inventor/descobridor
Jean_Cocteau	autor/escritor/cineasta
Soho	vizinhança/bairro
Idade_do_Bronze	período/etapa/tempo
Solingen	urbe/município/metrópole/cidade
África_do_Sul	Países_de_África
Guine	Países_de_África
Djibouti	Países_de_África/Porto/porto
Pádua	urbe/município/metrópole/cidade
Império_Persa	império
Letonia	Países_Bálticos
Cáucaso	serra/região/cordilheira
Sam_Shepard	dramaturgo
Ieoh_Ming_Pei	designer/arquitecto
Princeton	vila/aldeia/povoado/arraial/burgo
Golfo_da_Califórnia	golfo
Jim_Bowie	pioneiro
Knut_Hamsun	autor/escritor
Ernst_Lubitsch	cineasta
Iucatão	península
Dido	príncipe/Princesa
Leão	signo/constelação
Tomás_de_Aquino	doutor/Doutor_da_Igreja/Santos/santo/teólogo
Firenze	urbe/município/metrópole/cidade
Stavanger	urbe/município/metrópole/cidade/Porto/porto
James_Madison	presidente
Setubal	urbe/município/metrópole/cidade/Porto/porto
Burkina_Faso	terra/nação/país
Louis_Sullivan	designer/arquitecto
Mar_da_China_Meridional	mar/oceano
Abidjan	urbe/município/metrópole/cidade
Calvário	colina/barranco/monte/morro/montanha/ladeira
Barbuda	ilha
James_Clerk_Maxwell	físico
hagiógrafo	Livro_Sagrado
Holocausto	genocídio
Eratóstenes	astrónomo/Astrónomos/astrônomo/matemático
Napoleão_Bonaparte	imperador/general
Nanchang	urbe/município/metrópole/cidade
Katowice	urbe/município/metrópole/cidade
Ilhas_Faroe	possessão
Christoph_Willibald_Gluck	compositor
Paul_Verlaine	poeta/poetisa/Poetas
Mateus	evangelista/Santos/santo/apóstolo
Mar_Branco	desfiladeiro/enseada/fiorde/baía
Stephen_Sondheim	compositor
Oceano_Antárctico	oceano/mar
Mannheim	urbe/município/metrópole/cidade
Cotonou	urbe/município/metrópole/cidade/Porto/porto
Cecil_Rhodes	colonizador
Alexandre_Pushkin	poeta/poetisa/Poetas
Jeová	Senhor/Deus
Santos	urbe/município/metrópole/cidade/Porto/porto
Savannah	urbe/município/metrópole/cidade/Porto/porto
Petrónio	autor/escritor
Pólux	estrela
Estreito_de_Bering	estreito
Jack,_o_Estripador	homicida/assassino
Jesus_Cristo	profeta/judia/hebreu/judeu/hebraico
Isfahan	urbe/município/metrópole/cidade
Formosa	ilha
Bob_Dylan	compositor/cantador/cantor/cantora/vocalista
Governador_Valadares	urbe/município/metrópole/cidade
Martin_Luther_King_Jr.	clérigo/sacerdote/pároco/pastor
Hércules	constelação
Cidade_do_Cabo	urbe/município/metrópole/cidade/Porto/porto
Hindukush	serra/cordilheira
Judas	apóstolo
Assunção	Porto/porto
Édouard_Manet	pintora/pintor
Oceano_Árctico	oceano/mar
Mar_da_Noruega	mar/oceano
Adolf_Loos	designer/arquitecto
Mar_Jónico	mar/oceano
James_Watt	engenheiro/artífice/inventor/descobridor
Antuerpia	urbe/município/metrópole/cidade/Porto/porto
Quentin_Tarantino	cineasta
Pinsk	urbe/município/metrópole/cidade
Haiphong	urbe/município/metrópole/cidade/Porto/porto
Toledo	urbe/município/metrópole/cidade
Isaias	profeta
Simbad	personagem
Triássico	período
Tel-Aviv	urbe/município/metrópole/cidade
Monserrate	ilha
William_Walton	compositor
Catedral_de_Chartres	catedral
Pólo_Norte	extremidade/pólo
Perm	urbe/município/metrópole/cidade
Hong-Kong	urbe/município/metrópole/cidade/Porto/porto
Vincenzo_Bellini	compositor
Tristan_Tzara	poeta/poetisa/Poetas
Leicestershire	condado
Peter_O'Toole	intérprete/artista/actor/ator
Stanley_Kubrick	cineasta
Nápoles	urbe/município/metrópole/cidade/Porto/porto
Lawrence_Durrell	autor/escritor
Eslováquia	Europa
Rutland	vila/aldeia/povoado/arraial/burgo
Francis_Drake	almirante/navegador
Juramento_de_Hipócrates	juramento/promessa
Great_Falls	vila/aldeia/povoado/arraial/burgo
Agrigento	vila/aldeia/povoado/arraial/burgo
Gilberto	libretista/poeta/poetisa/Poetas
Sadat	estadista
Hokkaido	ilha
Roger_Bacon	frade/monge/frei/cientista
Tianjin	urbe/município/metrópole/cidade
Lewis_Carroll	autor/escritor
William_James	filósofo/psicólogo
Polo_Sul	pólo/extremidade
Cincinato	estadista
Lake_District	terra/domínio/território/circunscrição/país/distrito/condado/comarca
Jonathan_Edwards	teólogo
Corinto	urbe/município/metrópole/cidade/Porto/porto
Graham_Greene	autor/escritor
Serguei_Prokofiev	compositor
Edouard_Vuillard	pintora/pintor
Sarawak	terra/domínio/território/circunscrição/país/distrito/condado/comarca
New_York_Stock_Exchange	bolsa_de_valores/bolsa
George_Stevens	cineasta
John_Philip_Sousa	compositor
Málaga	urbe/município/metrópole/cidade/Porto/porto
Bill_Gates	empresário/empreendedor
África_Subsariana	região
John_Foster_Dulles	diplomata/embaixador
São_Judas_Tadeu	Santos/santo/apóstolo
Médio-Oriente	região
Lee_Oswald	assassino/sicário
George_Eliot	autor/escritor
John_Steinbeck	autor/escritor
Malcolm_X	militante/activista
Mogadiscio	Porto/porto
C._S._Forester	autor/escritor
Bolzano	urbe/município/metrópole/cidade
Faisalabad	urbe/município/metrópole/cidade
Baviera	província/estado
Will_Rogers	humorista
Villahermosa	urbe/município/metrópole/cidade
Acre	vila/terra/domínio/território/circunscrição/país/distrito/condado/comarca/aldeia/povoado/arraial/burgo/Porto/porto
Honoré_de_Balzac	escritor
Isaac_Newton	físico/matemático
Giordano_Bruno	filósofo
Império_Otomano	império
Nancy	urbe/município/metrópole/cidade
Mark_Twain	humorista/autor/escritor
Martinho_Lutero	teólogo
Timothy_Leary	psicólogo
Groenlândia	ilha
Ovídio	poeta/poetisa/Poetas
Alec_Guinness	intérprete/artista/actor/ator
Joliot-Curie	físico
Tarquínio	rei
Gansu	província/estado
Joseph_Heller	autor/escritor
Ferrara	urbe/município/metrópole/cidade
Pangeia	Continente/continente
Nicolau_Copérnico	astrónomo/Astrónomos/astrônomo
Patras	urbe/município/metrópole/cidade/Porto/porto
São_Patrício	apóstolo/padroeiro/patrono/orago
John_Ford	cineasta
Fernão_de_Magalhães	navegador
Alexandria	urbe/município/metrópole/cidade/Porto/porto
Clement_Attlee	estadista
Robert_de_Niro	intérprete/artista/actor/ator
Maracaibo	urbe/município/metrópole/cidade/Porto/porto
David_Mamet	dramaturgo
Ilhas_Virgens_Britânicas	possessão
Dez_Mandamentos	ordem/mandamento
Vivien_Leigh	atriz/actriz
Sherwood	selva/arvoredo/floresta/mata/bosque
Chechénia	região
Howard_Hughes	piloto-aviador/aeronauta/piloto/aviadora/aviador/industrialista/industrial/cineasta
Mahabharata	Livro_Sagrado
Nuvens_de_Magalhães	nebulosa/galáxia/Via_Láctea
Antonin_Dvorak	compositor
Andy_Warhol	pintora/pintor
John_dos_Passos	autor/escritor
Cisjordânia	região
Alexis_de_Tocqueville	autor/escritor
Cartagena	urbe/município/metrópole/cidade/Porto/porto
James_Monroe	presidente
Birmingham	urbe/município/metrópole/cidade
Konrad_Adenauer	estadista
Fridtjof_Nansen	explorador/exploradora/estadista
Jesse_Owens	atleta
Thomas_Mann	autor/escritor
Ralph_Richardson	intérprete/artista/actor/ator
Buddy_Holly	compositor
Arthur_Honegger	compositor
John_Galsworthy	autor/escritor
Álbion	Inglaterra/Grã-Bretanha/Grã_Bretanha
John_von_Neumann	matemático
Demócrito	filósofo
Palermo	urbe/município/metrópole/cidade/Porto/porto
Lola_Montez	bailarino/bailarina/dançarino/dançarina
Leonardo	autor/escritor
Latrão	locação/lugar/sítio
Península_de_Kola	península
Rutherford_B._Hayes	presidente
Cornualha	condado
Béla_Bartok	pianista/compositor
Guerra_das_Rosas	guerra
George_Lucas	roteirista/cineasta
Indochina	península
Pau_Casals	violoncelista
Paul_Dukas	compositor
Benjamin_Franklin	autor/escritor/gráfico/cientista
Troia	urbe/município/metrópole/cidade
Haifa	urbe/município/metrópole/cidade/Porto/porto
Dien_Bien_Phu	cerco/assédio/sítio
Advento	manifestação
Valência	urbe/município/metrópole/cidade
Sheffield	urbe/município/metrópole/cidade
Tamil_Nadu	província/estado
Dies_Irae	hino
Maurícia	terra/nação/país
Nanjing	urbe/município/metrópole/cidade
François_Duvalier	autocrata/ditador
Salónica	urbe/município/metrópole/cidade/Porto/porto
Gilgamesh	rei
Northampton	urbe/município/metrópole/cidade
Território_do_Norte	terra/domínio/território/circunscrição/país/distrito/condado/comarca
Dalian	urbe/município/metrópole/cidade/Porto/porto
Claes_Oldenburg	escultor
Stendhal	autor/escritor
Malaga	urbe/município/metrópole/cidade/Porto/porto
califado	época/tempo/século/período/era/idade
John_Locke	filósofo
Tartu	urbe/município/metrópole/cidade
Othello	personagem
Isoroku_Yamamoto	almirante
Shreveport	urbe/município/metrópole/cidade
República_da_Estónia	Países_Bálticos
Paramaribo	Porto/porto
Waterford	urbe/município/metrópole/cidade/Porto/porto
Vladimir_Horowitz	pianista
Estado_Livre	província/estado
Paul_Klee	pintora/pintor
Nova_York	urbe/município/metrópole/cidade
Frank_Lloyd_Wright	designer/arquitecto
São_Cristóvão	orago/ilha/patrono/padroeiro
Arthur_Rubinstein	pianista
Torre_de_Babel	zigurate
Creta	ilha
Alfred_de_Musset	poeta/poetisa/Poetas/autor/escritor
Zambeze	rio
Walter_Mitty	personagem
Chile	América_do_Sul
Colónia	urbe/município/metrópole/cidade
Jack_London	autor/escritor
Estónia	Países_Bálticos
Jerome_Robbins	coreógrafo
Lago_Léman	lago
Guerra_do_Golfo	guerra
Guerra_Fria	inimizade/hostilidade
Robinson_Jeffers	poeta/poetisa/Poetas
Frígia	região
Hume_Cronyn	intérprete/artista/actor/ator
Saratov	urbe/município/metrópole/cidade
Aberdeen	urbe/município/metrópole/cidade
Artie_Shaw	clarinetista
Delfos	urbe/município/metrópole/cidade
Deneb	estrela
George_Beadle	biólogo/biologista
Giuseppe_Garibaldi	general/patriota
Kissinger	diplomata/embaixador
Charles_Laughton	intérprete/artista/actor/ator
Jacques_Cartier	navegador
Erasmo_de_Roterdão	humanista/teólogo
Jessye_Norman	soprano
paleolítico	período/etapa/tempo
MS-DOS	DOS
Pireneus	serra/cordilheira
Kurt_Weill	compositor
Carachi	urbe/município/metrópole/cidade
Falha_de_Santo_André	falha
Jesus_de_Nazaré	profeta/judia/hebreu/judeu/hebraico
Câncer	constelação/signo
Alexandre	conquistador
Chittagong	urbe/município/metrópole/cidade/Porto/porto
Anglesey	ilha
Belfast	capital/Capital
Clyde_Tombaugh	astrónomo/Astrónomos/astrônomo
Mae_West	atriz/actriz
Albrecht_Dürer	entalhador
Henry_James	autor/escritor
Milão	urbe/município/metrópole/cidade
Hebei	província/estado
Phoenix	constelação
Cabo_Horn	cabo/Cabo/promontório
Franz_Kafka	autor/escritor
Bordeaux	urbe/município/metrópole/cidade/Porto/porto
Leadbelly	cantador/cantor/cantora/vocalista/compositor/guitarra/guitarrista/violonista
Golias	guerreiro/guerreira
Braunschweig	urbe/município/metrópole/cidade
Monrovia	Porto/porto
Tito_Lívio	historiador/cronista
Cecil_B._DeMille	cineasta
Nova_Zembla	ilha
Hermann_Göring	nazista/nazi
Peloponeso	península
Kenzo_Tange	designer/arquitecto
Sem	varão/macho/homem
Império_Britânico	região
William_Jennings_Bryan	advogado/jurista/político
Nigéria	Países_de_África
Rubicão	limite/fronteira
Era_Cristã	época/tempo/século/período/era/idade
Murmansk	urbe/município/metrópole/cidade/Porto/porto
Indonésia	terra/nação/país
Aral	lago
Quai_d'Orsay	rua
Louis_Braille	pedagogo/educador
William_Blake	poeta/poetisa/Poetas/pintora/pintor
William_Howard_Taft	presidente
Greta_Garbo	atriz/actriz
Willa_Cather	autor/escritor
Territórios_do_Noroeste	terra/domínio/território/circunscrição/país/distrito/condado/comarca
El_Paso	urbe/município/metrópole/cidade
Hillary_Clinton	senadora/senador
Maracaíbo	urbe/município/metrópole/cidade/Porto/porto
Belém	vila/aldeia/povoado/arraial/burgo
Charleston	urbe/município/metrópole/cidade/Porto/porto
América_do_Norte	Continente/continente
Estugarda	urbe/município/metrópole/cidade
Katherine_Mansfield	autor/escritor
Franklin_Delano_Roosevelt	presidente
Pluto	personagem
Calcutá	urbe/município/metrópole/cidade
República_da_Turquia	terra/nação/país
Giorgio_de_Chirico	pintora/pintor
Reykjavik	Porto/porto
Wall_Street	rua
Samuel_Morse	pintora/pintor/artífice/inventor/descobridor
Casablanca	urbe/município/metrópole/cidade/Porto/porto
Grenoble	urbe/município/metrópole/cidade
Escalda	rio
Don_Juan	Lorde/nobre
Martha_Graham	bailarino/bailarina/dançarino/dançarina/coreógrafo
Crimeia	península
Baixa_Saxónia	província/estado
Eugène_Delacroix	pintora/pintor
Fornax	constelação
Miami_Beach	urbe/município/metrópole/cidade
Joan_Didion	autor/escritor
Córsega	ilha
Mormon	profeta
Shetland	arquipélago
Dean_Martin	cantador/cantor/cantora/vocalista
Vega	dramaturgo
Andrew_Johnson	presidente
Burquina_Faso	terra/nação/país
Wimbledon	arrabalde/subúrbio/periferia
Robert_Mitchum	intérprete/artista/actor/ator
George_Gershwin	compositor
Entebbe	vila/aldeia/povoado/arraial/burgo
Mar_da_Gronelândia	mar/oceano
Pierre_de_Fermat	matemático
Oceano_Pacífico	oceano/mar
Mar_de_Coral	mar/oceano
Saba	ilha
Benjamin_Spock	pediatra
Tobago	ilha
Carl_Nielsen	compositor
Elizabeth_Barrett_Browning	poeta/poetisa/Poetas
Delaware	rio
Los_Angeles	urbe/município/metrópole/cidade
Barba_Negra	pirata/corsário
Cordilheira_dos_Andes	serra/cordilheira
Liége	urbe/município/metrópole/cidade
Sevilha	urbe/município/metrópole/cidade/Porto/porto
Susan_Sontag	autor/escritor
Terêncio	dramaturgo
Kazan	urbe/município/metrópole/cidade
Charlie_Parker	saxofonista/saxofone
Noé	patriarca
F._Scott_Fitzgerald	autor/escritor
Kaaba	relicário/santuário
Charles_Gounod	compositor
Marianas_do_Norte	terra/domínio/território/circunscrição/país/distrito/condado/comarca
Sherwood_Anderson	autor/escritor
Frank_Sinatra	crooner/intérprete/artista/actor/ator
Riga	Porto/porto
Sete	varão/macho/homem
West_Palm_Beach	vila/aldeia/povoado/arraial/burgo
Maldivas	terra/nação/país
Anatólia	península
Ilha_de_Wight	ilhota/ilha
George_C._Scott	intérprete/artista/actor/ator
Giacomo_Meyerbeer	compositor
Cannes	urbe/município/metrópole/cidade/Porto/porto
Steffi_Graf	tenista
James_Boswell	autor/escritor
Big_Sur	região
Rudolf_Steiner	filósofo
Linus_Pauling	químico/boticário
Columbo	vila/aldeia/povoado/arraial/burgo
Chicago	urbe/município/metrópole/cidade/Porto/porto
Johnny_Cash	cantador/cantor/cantora/vocalista
Takla_Makan	deserto
Zeppelin	artífice/inventor/descobridor
Amarelo	rio
Rio_Azul	rio
Giacomo_Puccini	compositor
Sul	região
Alfred_Tennyson	poeta/poetisa/Poetas
Michael_Jackson	cantador/cantor/cantora/vocalista
Yasser_Arafat	estadista
Aaron_Copland	compositor
Universidade_Columbia	universidade
Inácio	bispo/Santos/santo
Temuco	urbe/município/metrópole/cidade
Jorge_Luís_Borges	autor/escritor
Brünnhild	valquíria
triângulo	constelação
Walter_Reed	cirurgião
Isaac_Asimov	autor/escritor
Pavão	constelação
Continente_Americano	terra/chão/solo/relevo
Erskine_Caldwell	autor/escritor
Merce_Cunningham	bailarino/bailarina/dançarino/dançarina/coreógrafo
Bulawayo	urbe/município/metrópole/cidade
George_Washington	presidente/general
Stan_Laurel	cômico/cómico/comediante
Antártida	Continente/continente
Caledónia	região
Ulster	região
Catarina_de_Aragão	esposa/mulher
Ho_Chi_Minh	estadista
Yorkshire	região
Stephen_Hawking	físico
Núbia	região/deserto
Estados_Federados_da_Micronésia	terra/nação/país
Garland	urbe/município/metrópole/cidade
Liechtenstein	Europa
Franz_Liszt	pianista/compositor
Rive_Gauche	bairro/cercania/proximidade/vizinhança/vizinho/anexo
Joseph_Conrad	autor/escritor
Trondheim	urbe/município/metrópole/cidade/Porto/porto
Cebu	urbe/ilha/município/metrópole/cidade
mórmon	profeta
Marie_Curie	químico/boticário
Hyderabad	urbe/município/metrópole/cidade
Erwin_Rommel	marechal_de_campo
Pequenas_Antilhas	arquipélago
Coney_Island	vizinhança/bairro
Victor_Vasarely	pintora/pintor
Kiribati	terra/nação/país
Limerick	urbe/município/metrópole/cidade/Porto/porto
Blair	estadista
Goa	província/estado
Lucknow	urbe/município/metrópole/cidade
Jacques_Offenbach	compositor
Macbeth	rei
Terror	idade/época/era/período
Oriente	Ásia/Asia
Burkina-Faso	terra/nação/país
Fahrenheit	físico
Adolf_Hitler	nazista/nazi/autocrata/ditador
Gerard_Kuiper	astrónomo/Astrónomos/astrônomo
Marian_Anderson	contralto
Messias	oratório
Kananga	urbe/município/metrópole/cidade
Marc_Chagall	pintora/pintor
Bloomsbury	vizinhança/bairro
Jaffa	urbe/município/metrópole/cidade/Porto/porto
Flint	urbe/município/metrópole/cidade
Fiji	terra/nação/país
Shah_Jahan	imperador
Torquato_Tasso	poeta/poetisa/Poetas
Kitakyushu	urbe/município/metrópole/cidade
Bósnia-Herzegovina	Europa
Revolução_de_Fevereiro	revolução/Revolução
SoHo	vizinhança/bairro
Katherine_Anne_Porter	autor/escritor
Uruguai	América_do_Sul
Ilha_do_Príncipe	ilha
Bessie_Smith	cantador/cantor/cantora/vocalista
New_Orleans	urbe/município/metrópole/cidade
Ilhas_Faroé	ilha/possessão
Mar_do_Japão	mar/oceano
Charlie_Chaplin	cômico/cómico/comediante/cineasta
Kandy	urbe/município/metrópole/cidade
Alan_Turing	matemático
Mar_de_Aral	lago
Capricórnio	constelação/signo
Inglaterra	Europa
Nuremberga	urbe/município/metrópole/cidade
Livonia	região
Weimar	urbe/município/metrópole/cidade
Tanganica	região
Dhahran	vila/aldeia/povoado/arraial/burgo
Christchurch	urbe/município/metrópole/cidade
Trinidad	ilha
Bologna	urbe/município/metrópole/cidade
Hampshire	condado
Raymond_Chandler	autor/escritor
Burundi	Países_de_África
Dallas	urbe/município/metrópole/cidade
Mesopotâmia	região
Santo_Graal	cálice/copo/taça
Florença	urbe/município/metrópole/cidade
Francis_Poulenc	pianista/compositor
Paul_Gauguin	pintora/pintor
Arnold_Schönberg	compositor
Utrecht	urbe/município/metrópole/cidade
Coliseu_de_Roma	anfiteatro/Anfiteatro
Pisa	urbe/município/metrópole/cidade
Henry_Cavendish	físico/químico/boticário
Rodésia	Países_de_África
Tijuana	urbe/município/metrópole/cidade
Christiaan_Huygens	físico
George_Orwell	autor/escritor
Iowa	urbe/município/metrópole/cidade
Guzerate	província/estado
Curaçao	ilha
Edward_O._Wilson	entomologista/entomólogo
Johannes_Brahms	compositor
Flandres	Europa
Roménia	Europa
Robin_Hood	personagem
Francisco_de_Assis	Santos/santo
República_da_Hungria	Europa
Tirol	província/estado
Cantão	urbe/município/metrópole/cidade/Porto/porto
Versalhes	urbe/palácio/Palácio/município/metrópole/cidade
William_Herschel	astrónomo/Astrónomos/astrônomo
Mar_Negro	mar/oceano
Quinta_Avenida	alameda/rua/avenida/bulevar
Hébridas	arquipélago
Omar_Bradley	general
Lyra	constelação
Philip_Roth	autor/escritor
Andorra	Europa
Terra_Nova	ilha
Mobile	urbe/município/metrópole/cidade/Porto/porto
American_Stock_Exchange	bolsa_de_valores/bolsa
Zhou_Enlai	comunista/Comunistas/revolucionário/subversivo/Revolucionário
Erik_Satie	compositor
África_do_Norte	região
Universidade_do_Michigan	universidade
Coleman_Hawkins	saxofonista/saxofone
Walt_Whitman	poeta/poetisa/Poetas
Colômbia	América_do_Sul
Rosário	urbe/município/metrópole/cidade
Baltimore	urbe/município/metrópole/cidade/Porto/porto
Tolosa	urbe/município/metrópole/cidade
Libéria	Países_de_África
Fernand_Léger	pintora/pintor
Willy_Brandt	estadista
Guiana_Francesa	América_do_Sul
Doha	Porto/porto
Amelia_Earhart	piloto-aviador/aeronauta/piloto/aviadora/aviador
Marco_Pólo	turista/viajante
Jerome_Kern	compositor
Otto_Wagner	designer/arquitecto
Thomas_Becket	mártir/arcebispo/Santos/santo
República_de_Djibuti	Países_de_África/Porto/porto
Severo_Ochoa	bioquímico
Louis_Blériot	aviador/aviadora/piloto/aeronauta/piloto-aviador
Graz	urbe/município/metrópole/cidade
John_Wilkes_Booth	intérprete/artista/actor/ator/assassino/sicário
Oswald_Spengler	filósofo
Hamilton	urbe/Porto/porto/município/metrópole/cidade
Sócrates	ateniense/filósofo
Tritão	satélite/lua
Chennai	urbe/município/metrópole/cidade
Laurásia	Continente/continente
Mata_Hari	espião
Averróis	doutor/médico/filósofo/advogado/jurista
Alemanha	Europa
Jacques_Derrida	filósofo
