baobá	Baobá
Países_Baixos	OTAN/Organização_do_tratado_do_atlântico_norte/NATO/Organização_do_Tratado_do_Atlântico_Norte/Benelux/BENELUX/UE
crux	Via_Láctea
taitiano	Taiti
Escandinavo	Escandinávia
bezerro	vacum/bovinos
Nova_Zelândia	Império_britânico/Império_Britânico/Comunidade_das_Nações
Líbia	Organização_dos_Países_Exportadores_de_Petróleo/Organização_dos_países_exportadores_de_petróleo/Liga_árabe/Liga_Árabe
pelotão	companhia
uruguaio	Uruguai
azevinho	Ilex
Jamaica	Organização_dos_Estados_Americanos/Organização_dos_estados_americanos
tribo	classe/família
siciliano	Sicília/Sicilia
normando	Normandia
Bélgica	OTAN/Organização_do_tratado_do_atlântico_norte/NATO/Organização_do_Tratado_do_Atlântico_Norte/Benelux/BENELUX/UE
francês	República_Francesa/França
automóvel	trem/comboio/caminhos-de-ferro
felino	Felino
progenitor	família
Tailândia	Associação_de_Nações_do_Sudeste_Asiático/ASEAN
mamute	Mamute
laico	Laico
grifo	Gyps
Hirundo	Andorinha
polícia	lei
árvore	bosque
cidadão	povo
Granada	Organização_dos_Estados_Americanos/Organização_dos_estados_americanos
Secretariado_das_nações_unidas	Nações_Unidas/Organização_das_Nações_Unidas/ONU
inseto	turma/enxame
Islândia	Organização_do_Tratado_do_Atlântico_Norte/NATO/Organização_do_tratado_do_atlântico_norte/OTAN
Bergen	Liga_Hanseática
bandido	gangue
Sião	Associação_de_Nações_do_Sudeste_Asiático/ASEAN
esposo	casamento
Bremen	Liga_Hanseática
airão	Ardeidae
aeronave	frota
acadêmico	academia
Alcachofra	Cynara
eslovena	Eslovenia
corujão	Strigiformes/coruja
estrela	nebulosa/galáxia/Via_Láctea/constelação
Pérsia	Organização_dos_Países_Exportadores_de_Petróleo/Organização_dos_países_exportadores_de_petróleo
caractér	alfabeto
vacum	manada/rebanho
Casaquistão	Comunidade_dos_Estados_Independentes/Comunidade_de_Estados_Independentes
mulo	Equus
Haiti	Organização_dos_Estados_Americanos/Organização_dos_estados_americanos
amendoeira	Prunus
vieira	Vieira
patrício	aristocracia
til	Tília
Lubeck	Liga_Hanseática
Egito	Organização_dos_Países_Exportadores_de_Petróleo/Organização_dos_países_exportadores_de_petróleo/Liga_árabe/Liga_Árabe
Lübeck	Liga_Hanseática
Azerbaijão	Comunidade_dos_Estados_Independentes/Comunidade_de_Estados_Independentes
Reino_do_Camboja	Associação_de_Nações_do_Sudeste_Asiático/ASEAN
cavalo	Equus
Platão	Atenas
protista	Protista
samoano	Ilhas_Samoa
gringo	Nord/norte
família	ordem
urso-pardo	Ursus
fénix	palmeira
República_da_Arménia	Comunidade_dos_Estados_Independentes/Comunidade_de_Estados_Independentes
eleitor	eleitorado
égua	Equus
Gênero	classe/família
congolês	República_Democrática_do_Congo/Congo-Kinshasa
gambiano	Gâmbia
Tartu	Liga_Hanseática
cão	matilha
Ucrania	Comunidade_dos_Estados_Independentes/Comunidade_de_Estados_Independentes
criança	família
Turquia	OTAN/Organização_do_tratado_do_atlântico_norte/NATO/Organização_do_Tratado_do_Atlântico_Norte
Mianmar	Associação_de_Nações_do_Sudeste_Asiático/ASEAN
irmão	fraternidade/ordem/irmandade/família
aeronaves	frota
garça	Ardeidae
militar	forças_armadas
vitelo	vacum/bovinos
Espanha	UE/OTAN/Organização_do_tratado_do_atlântico_norte/NATO/Organização_do_Tratado_do_Atlântico_Norte
molusco	Molusco
ovelha	manada/rebanho
África_do_Sul	Comunidade_das_Nações
Djibouti	Liga_árabe/Liga_Árabe
loureiro	Laurus
Erva-cidreira	Melissa
República_Islâmica_do_Irão	Organização_dos_Países_Exportadores_de_Petróleo/Organização_dos_países_exportadores_de_petróleo
mestre	instituto/colégio
checoslovaco	Checoslováquia/Checoslovaquia
mocho	Strigiformes/coruja
letão	Letonia/Letónia
Honduras	Organização_dos_Estados_Americanos/Organização_dos_estados_americanos
jegue	Equus
Pólux	Gêmeos
dama	baralho
peneireiro-vulgar	Falco
danês	Reino_da_Dinamarca/Dinamarca
Persa	República_Islâmica_do_Irão/Pérsia/Irã/Irão
boliviano	Bolívia/Bolivia
Morangueiro	Rosaceae
Riga	Liga_Hanseática
milhafre	Buteo
conselho_de_administração	administração
Reino_da_Dinamarca	OTAN/Organização_do_tratado_do_atlântico_norte/NATO/Organização_do_Tratado_do_Atlântico_Norte/Escandinávia/UE
suíno	seu
Libano	Liga_árabe/Liga_Árabe
partida	mão-de-obra
Grécia	OTAN/Organização_do_tratado_do_atlântico_norte/NATO/Organização_do_Tratado_do_Atlântico_Norte/UE
sacerdote	clero
zebra	Equus
planeta	sistema_solar
filo	reino
uruguaia	Uruguai
jasmim	Jasmim
damasqueiro	Prunus
divisão	empresas/governo/regime
somali	Somália
porquinho	seu
táxi	frota
Chile	Organização_dos_Estados_Americanos/Organização_dos_estados_americanos
Colónia	Liga_Hanseática
diretor	conselho/comitê/comité
nespereira	Eriobotrya
Holandês	Países_baixos/Países_Baixos/Holanda/Neerlândia
naipe	baralho
insecto	turma/enxame
búfalo	bovídeos
Zebra	Equus
Indonésia	Organização_dos_Países_Exportadores_de_Petróleo/Organização_dos_países_exportadores_de_petróleo/Associação_de_Nações_do_Sudeste_Asiático/ASEAN
El_Salvador	Organização_dos_Estados_Americanos/Organização_dos_estados_americanos
Insectos	turma/enxame
República_da_Turquia	OTAN/Organização_do_tratado_do_atlântico_norte/NATO/Organização_do_Tratado_do_Atlântico_Norte
húngara	Hungria/República_da_Hungria
abeto	Abies
Irão	Organização_dos_Países_Exportadores_de_Petróleo/Organização_dos_países_exportadores_de_petróleo
Vega	Lyra
bizantino	Bizâncio/Império_Bizantino/Império_bizantino
filha	família
baleia-azul	Balaenoptera
ianque	Nord/norte
olmo	Ulmeiro
mafioso	máfia/Cosa_Nostra/Cosa_nostra
embondeiro	Baobá
Myanmar	Associação_de_Nações_do_Sudeste_Asiático/ASEAN
marido	casamento
filho	família
albanês	Albânia/Albania/República_da_Albânia
operário	proletariado
República_do_Cazaquistão	Comunidade_dos_Estados_Independentes/Comunidade_de_Estados_Independentes
Marte	sistema_solar
aliado	coalizão/aliança
trem	comboio/caminhos-de-ferro
cingalês	Ceilão/Sri-Lanka/Sri_lanka/Sri_Lanca/Sri_Lanka
Mercúrio	sistema_solar
beterraba	Beta
Australopithecus_afarensis	Australopithecus
Sus	seu
Via_Láctea	Universo/criação/natureza/universo/cosmo/mundo
Shiva	Trimurti
brasileiro	Brasil/República_Federativa_do_Brasil
Uruguai	Organização_dos_estados_americanos/Organização_dos_Estados_Americanos
alemão	Alemanha/República_Federal_da_Alemanha
substantivo	declinação
trácio	Trácia
Assembleia_Geral	Nações_Unidas/Organização_das_Nações_Unidas/ONU
cardeal	Colégio_Cardinalício/Colégio_dos_Cardeais/Colégio_dos_cardeais
Leões	Panthera
corpo	forças_armadas
nominal	declinação
ameixoeira	Prunus
Dinamarca	OTAN/Organização_do_tratado_do_atlântico_norte/NATO/Organização_do_Tratado_do_Atlântico_Norte/Escandinávia/UE
iraquiano	Iraque/República_do_Iraque
louro	Laurus
clérigo	clero
queijo	Malva
Colômbia	Organização_dos_Estados_Americanos/Organização_dos_estados_americanos
faia	Faia/Fagaceae
pinheiro	Pinus/abeto/Abies
Iémen	Liga_árabe/Liga_Árabe
jumento	Equus
Bahrain	Liga_árabe/Liga_Árabe
iemenita	Iémen/Iemen
Canadá	OTAN/Organização_do_tratado_do_atlântico_norte/NATO/Organização_do_Tratado_do_Atlântico_Norte/Império_britânico/Império_Britânico/Comunidade_das_Nações
Guiana_Francesa	Império_britânico/Império_Britânico
leitão	seu
República_de_Djibuti	Liga_árabe/Liga_Árabe
Síria	Liga_árabe/Liga_Árabe
Alemanha	OTAN/Organização_do_tratado_do_atlântico_norte/NATO/Organização_do_Tratado_do_Atlântico_Norte/UE
votante	eleitorado
Hamburgo	Liga_Hanseática
avião	frota
mexicano	México/Estados_Unidos_Mexicanos
Jibuti	Liga_árabe/Liga_Árabe
Crime_organizado	submundo
pároco	clero
Mexicano	México/Estados_Unidos_Mexicanos
Quirguistão	Comunidade_dos_Estados_Independentes/Comunidade_de_Estados_Independentes
Divisão	corpo
República_do_Haiti	Organização_dos_Estados_Americanos/Organização_dos_estados_americanos
napolitano	Nápoles
Filo	reino
Algéria	Organização_dos_Países_Exportadores_de_Petróleo/Organização_dos_países_exportadores_de_petróleo/Liga_árabe/Liga_Árabe
Domingos	Organização_dos_Estados_Americanos/Organização_dos_estados_americanos
Paraguai	Organização_dos_Estados_Americanos/Organização_dos_estados_americanos
paraguaio	Paraguai
venezuelano	Venezuela
carro	trem/comboio/caminhos-de-ferro
Cintura_de_Kuiper	sistema_solar
Tunísia	Liga_árabe/Liga_Árabe
forças_armadas	corpo/serviço_militar
Iraque	Organização_dos_Países_Exportadores_de_Petróleo/Organização_dos_países_exportadores_de_petróleo/Liga_árabe/Liga_Árabe
laosiano	Laos/República_Popular_Democrática
Kuwait	Organização_dos_Países_Exportadores_de_Petróleo/Organização_dos_países_exportadores_de_petróleo/Liga_árabe/Liga_Árabe
administração	governo/regime
Mauritânia	Liga_árabe/Liga_Árabe
Irlanda	Comunidade_das_Nações/UE
sol	sistema_solar
Bolívia	Organização_dos_Estados_Americanos/Organização_dos_estados_americanos
Colombia	Organização_dos_Estados_Americanos/Organização_dos_estados_americanos
Egipto	Organização_dos_Países_Exportadores_de_Petróleo/Organização_dos_países_exportadores_de_petróleo/Liga_árabe/Liga_Árabe
plebeu	pessoal/povo/vulgo
ameixa	Prunus/Eriobotrya
carioca	Rio
Hamburg	Liga_Hanseática
Prunus	Rosaceae
República_da_Indonésia	Organização_dos_Países_Exportadores_de_Petróleo/Organização_dos_países_exportadores_de_petróleo/Associação_de_Nações_do_Sudeste_Asiático/ASEAN
Malásia	Associação_de_Nações_do_Sudeste_Asiático/ASEAN
Argélia	Organização_dos_Países_Exportadores_de_Petróleo/Organização_dos_países_exportadores_de_petróleo/Liga_árabe/Liga_Árabe
Príncipe	família_real/Família_Real
cachorro	matilha
Líbano	Liga_árabe/Liga_Árabe
Panthera	Felino
quórum	organização
mito	Mitologia/mitologia
sável	Alosa
classe	ordem/filo/Filo
algodão	algodoeiro
legislatura	governo/regime
bonobo	chimpanzé
Carvalho	Fagaceae
tília	Tília
singapurense	Singapura
cônjuge	casamento
Arménios	República_da_Arménia/Arménia/Armenia
Rússia	Comunidade_dos_Estados_Independentes/Comunidade_de_Estados_Independentes
Poder_Executivo	regime/governo
canadense	Canadá/Canada
bretão	Grã-Bretanha/Grã_Bretanha
Rosaceae	Rosales
Arenga	palmeira
esloveno	Eslovenia
namorado	casamento
javardo	seu
pessegueiro	Prunus
coruja	Strigiformes
Canada	OTAN/Organização_do_tratado_do_atlântico_norte/NATO/Organização_do_Tratado_do_Atlântico_Norte/Império_britânico/Império_Britânico/Comunidade_das_Nações
Sol	sistema_solar
crime_organizado	submundo
Bolivia	Organização_dos_Estados_Americanos/Organização_dos_estados_americanos
cabra	Capra
Oman	Liga_árabe/Liga_Árabe
Tadjiquistão	Comunidade_de_Estados_Independentes/Comunidade_dos_Estados_Independentes
El_salvador	Organização_dos_Estados_Americanos/Organização_dos_estados_americanos
Estados_Unidos_Mexicanos	Organização_dos_Estados_Americanos/Organização_dos_estados_americanos
café	cafeeiro
búlgaro	Bulgária/República_da_Bulgária
burocracia	governo/regime
Epsilon_Aurigae	Auriga
Faia	Fagaceae
príncipe	família_real/Família_Real
República_da_Índia	Império_Britânico/Comunidade_das_Nações/Império_britânico/Organização_dos_Países_Exportadores_de_Petróleo/Organização_dos_países_exportadores_de_petróleo
batalhão	regimento
mundo	sistema_solar
Djibuti	Liga_árabe/Liga_Árabe
chileno	Chile
Azerbeijão	Comunidade_dos_Estados_Independentes/Comunidade_de_Estados_Independentes
angolano	Angola
neozelandês	Nova_Zelândia
truta	Salmo
khmer	Camboja/Reino_do_Camboja
ônibus	frota
guatemalteco	Guatemala
Salvador	Organização_dos_Estados_Americanos/Organização_dos_estados_americanos
irmã	família
cidadã	povo
russo	Rússia
comboio	trem/caminhos-de-ferro
gato	Felino
baleia-piloto	Baleia-piloto
República_Federal_da_Alemanha	OTAN/Organização_do_tratado_do_atlântico_norte/NATO/Organização_do_Tratado_do_Atlântico_Norte/UE
Áustria	UE
barrão	seu
proletário	proletariado
Austria	UE
abetarda	Abetarda
agente	polícia/lei
Quirguizistão	Comunidade_dos_Estados_Independentes/Comunidade_de_Estados_Independentes
filipino	Filipinas
Saturno	sistema_solar
mu	Equus
Morcego-anão	Pipistrellus
Lucy	Australopithecus
Turcomenistão	Comunidade_dos_Estados_Independentes/Comunidade_de_Estados_Independentes
paquistanês	Paquistão/República_Islâmica_do_Paquistão
estado-unidense	Estados_Unidos/EUA/E.U.A.
Cintura_de_kuiper	sistema_solar
Armenia	Comunidade_dos_Estados_Independentes/Comunidade_de_Estados_Independentes
Bielorrussia	Comunidade_dos_Estados_Independentes/Comunidade_de_Estados_Independentes
rei	família_real/Família_Real
autocarro	frota
embarcação	frota
açucena	Lírio
fitoplâncton	Plancton/plâncton
Ucránia	Comunidade_dos_Estados_Independentes/Comunidade_de_Estados_Independentes
jamaicano	Jamaica
Delichon	Andorinha
Gastrópodes	Molusco
aeroplano	frota
afegão	Afeganistão
italiano	Itália/Italia/República_Italiana
menino	família
República_Francesa	OTAN/Organização_do_tratado_do_atlântico_norte/NATO/Organização_do_Tratado_do_Atlântico_Norte/UE
Vixnu	Trimurti
jesuíta	Companhia_de_Jesus/Companhia_de_jesus
instituto	faculdade/universidade
Arménia	Comunidade_dos_Estados_Independentes/Comunidade_de_Estados_Independentes
feminista	feminismo/Feminismo
tropas	corpo
guaxinim	Procyon
sueca	Suécia
gendarme	Gendarmaria/gendarmaria
Baamas	Organização_dos_Estados_Americanos/Organização_dos_estados_americanos
cipreste	Cupressus
verbo	conjugação
mosca	Musca
República_Popular_Democrática	Associação_de_Nações_do_Sudeste_Asiático/ASEAN
carácter	alfabeto
Barbados	Organização_dos_Estados_Americanos/Organização_dos_estados_americanos
Itália	OTAN/Organização_do_tratado_do_atlântico_norte/NATO/Organização_do_Tratado_do_Atlântico_Norte/UE
cerejeira	Prunus
tarrafa	Falco
poder_executivo	regime/governo
Saccharomyces_cerevisiae	Saccharomyces
Somália	Liga_árabe/Liga_Árabe
grega	Grécia
Rostock	Liga_Hanseática
plâncton	agregado/agregação/aglomeração
brasileira	Brasil/República_Federativa_do_Brasil
asno	Equus
Italia	OTAN/Organização_do_tratado_do_atlântico_norte/NATO/Organização_do_Tratado_do_Atlântico_Norte/UE
Laos	Associação_de_Nações_do_Sudeste_Asiático/ASEAN
República_Federativa_do_Brasil	Organização_dos_Estados_Americanos/Organização_dos_estados_americanos
Hanôver	Liga_Hanseática
Colómbia	Organização_dos_Estados_Americanos/Organização_dos_estados_americanos
princesa	família_real/Família_Real
IES	faculdade/universidade/instituto
toupeira	Toupeira
alguém	povo
Catar	Organização_dos_Países_Exportadores_de_Petróleo/Organização_dos_países_exportadores_de_petróleo/Liga_árabe/Liga_Árabe
panamenho	Panamá
povo	homem/mundo
Vénus	sistema_solar
República_Italiana	OTAN/Organização_do_tratado_do_atlântico_norte/NATO/Organização_do_Tratado_do_Atlântico_Norte/UE
nectarina	Prunus
núbio	Núbia
javanês	Java
Santa_Lúcia	Organização_dos_Estados_Americanos/Organização_dos_estados_americanos
islandês	Islândia
República_Árabe_do_Egipto	Organização_dos_Países_Exportadores_de_Petróleo/Organização_dos_países_exportadores_de_petróleo/Liga_árabe/Liga_Árabe
galáxia	Universo/criação/natureza/universo/cosmo/mundo
Plancton	agregado/agregação/aglomeração
Federação_Russa	Comunidade_dos_Estados_Independentes/Comunidade_de_Estados_Independentes
argentino	Argentina
alcachofra	Cynara
faculdade	colégio/universidade/instituto
bovinos	bovídeos/manada/rebanho
coralista	coro/Coros
ilha	arquipélago
homem	casamento
Reino-Unido	OTAN/Organização_do_tratado_do_atlântico_norte/NATO/Organização_do_Tratado_do_Atlântico_Norte/UE
director	conselho/comitê/comité
castor	Rodízio
heleno	Grécia
tulipa	Tulipa
Irã	Organização_dos_Países_Exportadores_de_Petróleo/Organização_dos_países_exportadores_de_petróleo
colombiano	Colômbia/Colombia/Colómbia
companhia	batalhão
Guatemala	Organização_dos_Estados_Americanos/Organização_dos_estados_americanos
Strigiformes	coruja
mãe	família
Eriobotrya	Rosaceae
Belgica	OTAN/Organização_do_tratado_do_atlântico_norte/NATO/Organização_do_Tratado_do_Atlântico_Norte/Benelux/BENELUX/UE
consorte	casamento
Papua_Nova_Guiné	Comunidade_das_Nações
erva-cidreira	Melissa
Javan	Java
Terra	sistema_solar
burro	Equus
Palanca	bovídeos
professor	faculdade/instituto/colégio
lenda	Mitologia/mitologia
queniano	Quénia/República_do_Quénia
carvalho	Quercus/Carvalho
Estado_do_Kuwait	Organização_dos_Países_Exportadores_de_Petróleo/Organização_dos_países_exportadores_de_petróleo/Liga_árabe/Liga_Árabe
taiwanês	Taiwan/Formosa/República_da_China
México	Organização_dos_Estados_Americanos/Organização_dos_estados_americanos
Vênus	sistema_solar
República_da_Bulgária	OTAN/Organização_do_tratado_do_atlântico_norte/NATO/Organização_do_Tratado_do_Atlântico_Norte
caucasiana	brancos/Branco
França	OTAN/Organização_do_tratado_do_atlântico_norte/NATO/Organização_do_Tratado_do_Atlântico_Norte/UE
Filipinas	Associação_de_Nações_do_Sudeste_Asiático/ASEAN
Quorum	organização
caucasiano	brancos/Branco
associação	organização
Bruges	Liga_Hanseática
Suriname	Organização_dos_Estados_Americanos/Organização_dos_estados_americanos
Tribunal_internacional_de_justiça	Nações_Unidas/Organização_das_Nações_Unidas/ONU
Portugal	OTAN/Organização_do_tratado_do_atlântico_norte/NATO/Organização_do_Tratado_do_Atlântico_Norte/UE
mexicana	México/Estados_Unidos_Mexicanos
Secretariado_das_Nações_Unidas	Nações_Unidas/Organização_das_Nações_Unidas/ONU
rainha	família_real/Família_Real
angolense	Angola
Grã-Bretanha	OTAN/Organização_do_tratado_do_atlântico_norte/NATO/Organização_do_Tratado_do_Atlântico_Norte/UE
Antares	Escorpião
onça	Panthera
escocês	Escocia/Escócia
automotora	trem/comboio/caminhos-de-ferro
itálico	Itália/Italia/República_Italiana
EUA	OTAN/Organização_do_tratado_do_atlântico_norte/NATO/Organização_do_Tratado_do_Atlântico_Norte/Organização_dos_Estados_Americanos/Organização_dos_estados_americanos
pica-pau	Pica-pau/Picapau
guarda	polícia/lei
ulmeiro	Ulmeiro
londrino	Grande_Londres/Londres/londrina/London/Grande_londres
pistache	Pistacia
Bielorrússia	Comunidade_dos_Estados_Independentes/Comunidade_de_Estados_Independentes
Brasil	Organização_dos_Estados_Americanos/Organização_dos_estados_americanos
Pipistrellus_pipistrellus	Pipistrellus
Omega_Centauri	Centaurus
Singapura	ASEAN/Associação_de_Nações_do_Sudeste_Asiático
Marrocos	Liga_árabe/Liga_Árabe
eslovaco	Eslováquia
trabalhador	proletariado
tebano	Tebas
construtivista	construtivismo/Construtivismo
Ilhas_britânicas	Império_britânico/Império_Britânico
banana	bananeira
parente	clã/tribo/família/familia
branco	brancos/Branco
Índia	Império_Britânico/Comunidade_das_Nações/Império_britânico/Organização_dos_Países_Exportadores_de_Petróleo/Organização_dos_países_exportadores_de_petróleo
etrusco	Etrúria
pastor	clero
Estados_Unidos	OTAN/Organização_do_tratado_do_atlântico_norte/NATO/Organização_do_Tratado_do_Atlântico_Norte/Organização_dos_Estados_Americanos/Organização_dos_estados_americanos
polonês	Polónia/Polonia
pardal	Pardal/Passer
Guiana	Império_britânico/Império_Britânico
lírio	Lírio
máquina	trem/comboio/caminhos-de-ferro
Arábia_Saudita	Liga_Árabe/Organização_dos_países_exportadores_de_petróleo/Organização_dos_Países_Exportadores_de_Petróleo/Liga_árabe
túlipa	tulipa/Tulipa
angola	Angola
hindu	Hinduismo/hinduísmo/República_da_Índia/Índia
f	Melissa
português	Portugal
Pessegueiro	Prunus
Júpiter	sistema_solar
Bahamas	Organização_dos_Estados_Americanos/Organização_dos_estados_americanos
morangueiro	Morangueiro/Rosaceae
Capra	bovídeos
Neerlândia	OTAN/Organização_do_tratado_do_atlântico_norte/NATO/Organização_do_Tratado_do_Atlântico_Norte/Benelux/BENELUX/UE
Venezuela	Organização_dos_Países_Exportadores_de_Petróleo/Organização_dos_países_exportadores_de_petróleo/Organização_dos_Estados_Americanos/Organização_dos_estados_americanos
espanhola	Espanha
pega	Pica
Holanda	OTAN/Organização_do_tratado_do_atlântico_norte/NATO/Organização_do_Tratado_do_Atlântico_Norte/Benelux/BENELUX/UE
Morango	morangueiro/Morangueiro
Camboja	Associação_de_Nações_do_Sudeste_Asiático/ASEAN
papa	papado
Iemen	Liga_árabe/Liga_Árabe
Peru	Organização_dos_Estados_Americanos/Organização_dos_estados_americanos
polaca	Polónia/Polonia
morango	morangueiro/Morangueiro
Felino	carnívoros/Carnívoros
center	Clube_de_futebol/Clubes_de_futebol
sicômoro	Ficus/figueira
espanhol	Espanha
Dominica	Organização_dos_Estados_Americanos/Organização_dos_estados_americanos
Canadense	Canadá/Canada
babucha	Equus
universidade	faculdade/instituto
alpaca	lama
milícia	corpo
Moldávia	Comunidade_dos_Estados_Independentes/Comunidade_de_Estados_Independentes
gastrópodes	Molusco/Gastrópodes
barco	frota
Klaipeda	Liga_Hanseática
ser_humano	povo
chinês	República_da_China/Formosa/Taiwan/República_Popular_da_China/China
Mamão	Carica
E.U.A.	OTAN/Organização_do_tratado_do_atlântico_norte/NATO/Organização_do_Tratado_do_Atlântico_Norte/Organização_dos_Estados_Americanos/Organização_dos_estados_americanos
vagão	trem/comboio/caminhos-de-ferro
zooplâncton	Plancton/plâncton
gangue	Crime_organizado/crime_organizado
lituano	Lituânia/República_da_Lituânia/Lituania
locomotiva	trem/comboio/caminhos-de-ferro
maçom	Maçonaria/maçonaria
Costa_Rica	Organização_dos_Estados_Americanos/Organização_dos_estados_americanos
cavalo-marinho	Cavalo-marinho
Reino_Unido	OTAN/Organização_do_tratado_do_atlântico_norte/NATO/Organização_do_Tratado_do_Atlântico_Norte/UE
Noruega	OTAN/Organização_do_tratado_do_atlântico_norte/NATO/Organização_do_Tratado_do_Atlântico_Norte/Escandinávia
Bulgária	OTAN/Organização_do_tratado_do_atlântico_norte/NATO/Organização_do_Tratado_do_Atlântico_Norte
Países_baixos	OTAN/Organização_do_tratado_do_atlântico_norte/NATO/Organização_do_Tratado_do_Atlântico_Norte/Benelux/BENELUX/UE
Emirados_Árabes_Unidos	Organização_dos_Países_Exportadores_de_Petróleo/Organização_dos_países_exportadores_de_petróleo/Liga_árabe/Liga_Árabe
ficante	compromisso
Arábico	Arábia
pai	família
holandês	Países_baixos/Países_Baixos/Holanda/Neerlândia
Ucrânia	Comunidade_dos_Estados_Independentes/Comunidade_de_Estados_Independentes
caixilho	forças_armadas
espruce	Picea
anglicano	Comunhão_anglicana/Comunhão_Anglicana
República_Dominicana	Organização_dos_Estados_Americanos/Organização_dos_estados_americanos
leão	Panthera
Tunisia	Liga_árabe/Liga_Árabe
Ilhas_Britânicas	Império_britânico/Império_Britânico
Indonesia	Organização_dos_Países_Exportadores_de_Petróleo/Organização_dos_países_exportadores_de_petróleo/Associação_de_Nações_do_Sudeste_Asiático/ASEAN
contabilidade	livro-caixa
egípcio	República_Árabe_do_Egipto/Egipto/Egito
maltês	Malta
ateniense	Atenas
quarterback	Clube_de_futebol/Clubes_de_futebol
Altair	Aquila
baleia-anã	Balaenoptera
malaio	Malásia
Quercus	Fagaceae
Nêspera	Eriobotrya
Apus	Andorinhão
veneziano	Veneza
Belarus	Comunidade_dos_Estados_Independentes/Comunidade_de_Estados_Independentes
Austrália	Império_britânico/Império_Britânico/Comunidade_das_Nações
sul-africano	África_do_Sul
cartaginês	Cartago
Emiratos_Árabes_Unidos	Organização_dos_Países_Exportadores_de_Petróleo/Organização_dos_países_exportadores_de_petróleo/Liga_árabe/Liga_Árabe
República_do_Iraque	Organização_dos_Países_Exportadores_de_Petróleo/Organização_dos_países_exportadores_de_petróleo/Liga_árabe/Liga_Árabe
Castor	Gêmeos
jau	Java
troiano	Tróia/Troia
nicaraguense	Nicarágua
Dortmund	Liga_Hanseática
burguês	Classe-média/burguesia
paroquiano	Freguesias/paróquia
ordem	classe
tigre	Panthera
Bahrein	Liga_árabe/Liga_Árabe
guard	Clube_de_futebol/Clubes_de_futebol
jaguar	Panthera
árabe	Arábia
gênero	classe/família
Croata	Croácia/Croacia
Suécia	Escandinávia/UE
luso	Portugal
jerico	Equus
Princesa	família_real/Família_Real
género	classe/família
Tribunal_Internacional_de_Justiça	Nações_Unidas/Organização_das_Nações_Unidas/ONU
estado	terra/país
belga	Bélgica/Belgica
Brunei	Associação_de_Nações_do_Sudeste_Asiático/ASEAN
nebulosa	Universo/criação/natureza/universo/cosmo/mundo
Argentina	Organização_dos_Estados_Americanos/Organização_dos_estados_americanos
frota	armada/forças_navais/marinha/azul-marinho
Muçulmanos	Islão/maometismo
Panamá	Organização_dos_Estados_Americanos/Organização_dos_estados_americanos
leopardo	Panthera
Barém	Liga_árabe/Liga_Árabe
Sua_Alteza	família_real/Família_Real
ameixeira	Prunus
leigo	Laico
neerlandês	Países_baixos/Países_Baixos/Holanda/Neerlândia
