transmitir	revelar/dar/entregar/legar/levar/tirar/transportar/conduzir/trazer/circular/espalhar
precipitar	cair
berrar	urrar/vociferar/mugir/gritar/exclamar/bradar/chamar
reunir	encontrar/ver
aquietar	silenciar
sofrer	aguentar/tolerar/suportar/aturar/ter/padecer
confundir	obnubilar/obscurecer/misturar/enrolar/agitar/incomodar/enervar
vestir	vestir-se/arrumar-se
lidar	englobar/compreender/conter/abarcar/circundar/tratar
divulgar	advogar/agitar/lutar
cavalgar	viajar/andar/ir
admitir	proporcionar/fornecer/permitir/deixar/aceitar
aconchegar	acomodar
forrar	revestir
contar	supor
amassar	cultivar
ressuscitar	acordar
querer	procurar
separar-se	decepar/cortar/dividir/separar
indeferir	recusar/desprezar/rejeitar
estimar	medir/avaliar
dizimar	aniquilar/massacrar/devastar
insular	adiar
apartar-se	decepar/cortar/dividir/separar
lavar	lavar-se
envenenar	intoxicar
confrontar	deparar/defrontar/enfrentar
comprazer	satisfazer
outorgar	deixar/consentir/permitir
xingar	praguejar/blasfemar/maldizer
ser	afetar
alertar	desaconselhar/advertir/admoestar/prevenir/avisar
despir	desnudar-se/despir-se
domesticar	domar
sobreviver	haver/subsistir/resistir/perseverar
aparentar	atuar
cerrar	fechar
combinar	corresponder/harmonizar/concordar/compatibilizar/caber
entender	achar/considerar/obter/adquirir/atingir/figurar/afigurar/visualizar/compreender/ver/saber/conhecer/ler
plantar	semear
tampar	cobrir/enfronhar/encapar
andar	deslocar/mover/cavalgar/caminhar/passear/viajar/ir
falecer	morrer
mijar	urinar/defecar/cagar
raspar	vassourar/varrer/vasculhar
destruir	surrar/arruinar/quebrar
jazer	reclinar/restar/estender-se/acamar/deitar-se
efetuar	executar/realizar
roçar	vassourar/varrer/vasculhar
inscrever-se	pedir
decair	desintegrar
irritar	pegar/tocar/enervar-se/irritar-se
nadar	flutuar
acatar	adoptar
malhar	treinar/exercitar-se/exercitar
assentar-se	sentar/sentar-se
advertir	alertar/desaconselhar/admoestar/prevenir/avisar
mudar	tornar/revoltar-se/revoltar/substituir/converter/trocar
avizinhar	chegar
oxidar	enferrujar
englobar	endereçar/cobrir/falar/tratar/lidar
encontrar	tocar/verificar/descobrir/informar-se/inteirar/reconquistar/recuperar/reganhar/assegurar/achar/determinar/encostar/reunir
afetar	atingir/provocar/propulsar/motivar/estimular/incentivar/atacar/desempenhar/ser
alcançar	vir/chegar
abandonar	desmoronar/partir/ir/retirar-se/sair/olvidar/esquecer/desabar/colapsar/quebrar/ruir
encarar	virar
pingar	gotejar
reportar-se	concernir/relacionar/referir
fincar	martelar
operar	funcionar
concernir	aludir/reportar-se
morrer	quebrar/estragar/partir/perecer/falecer
lucrar	obter/adquirir/render
lacrar	vedar/selar
enfrentar	deparar/confrontar
agir	simular/fingir
resistir	sobreviver/haver/subsistir
perambular	vagar/errar
praticar	utilizar/usar/empregar/treinar
revoltar-se	transformar/virar/transformar-se/mudar/acontecer/tornar-se
brotar	germinar/ramificar-se/ramificar
garantir	afiançar
secundar	aprovar
cultivar	amassar/trabalhar
masturbar	masturbar-se/punheta
reconquistar	encontrar/reganhar/achar
conceder	deixar/consentir/permitir
figurar	visualizar/entender/compreender
arquitetar	criar/desenhar
sentar	pôr/posar/assentar-se/sentar-se
assegurar	afiançar/provar/ver/aprender/encontrar/descobrir/checar/conferir/verificar
desintegrar	dissolver/dividir/decair
esvaziar	remover
centrar	fascinar/interessar
pendurar	dependurar
seguir	observar/guardar/ver/espionar/assistir/olhar/mirar/adoptar/preservar/manter/continuar
vociferar	gritar/exclamar/berrar/bradar/chamar
instituir	construir/criar/produzir/fazer
agredir	assaltar/atacar
sentar-se	pôr/posar/assentar-se/sentar
despejar	remover/desalojar
notificar	introduzir/apresentar
pretextar	atuar
arrumar	acender/fazer
usar	aplicar/utilizar/praticar/empregar/jogar
reclinar	jazer
despir-se	despojar/desnudar/despir
avançar	preservar/manter/continuar
acordar	renascer/reavivar/reanimar/vivificar/animar/ressuscitar/reviver
incorrer	adquirir/receber/obter/comprar/atingir
transportar	carregar/trazer/pegar/transmitir
vexar	enervar-se/irritar-se
enervar-se	atormentar/perturbar/aborrecer/amolar/agastar/vexar/molestar/incomodar/irritar/importunar
importunar	enervar-se/irritar-se
enfileirar	passar/correr
considerar	afirmar/julgar/pensar/deliberar/entender/compreender
afigurar	visualizar/entender/compreender
acrescentar	adicionar
desalojar	despejar/remover
adiar	insular/isolar
golpear	atingir/bater/colidir
engessar	aplicar/passar
molestar	enervar-se/irritar-se
recusar	indeferir/desprezar/rejeitar/declinar
utilizar	aplicar/praticar/usar/empregar/jogar
padecer	ter/contrair/sofrer
rolar	revirar/revolver/rodar
cozinhar	acender/fazer
espionar	traçar/seguir
tratar	englobar/compreender/conter/abarcar/circundar/endereçar/cobrir/falar/lidar
pedir	reservar/inscrever-se/requerer/solicitar
vender	trair/atraiçoar
remover	esvaziar/despejar/limpar/desalojar
detectar	achar/descobrir
registrar	perceber/registrar
abarcar	endereçar/cobrir/falar/tratar/lidar
vadiar	vagar/errar
suplantar	substituir/recolocar/repor
enfeitar	adornar/ornamentar/decorar
promover	advogar/agitar/lutar
ajudar	servir/dar
aprovar	endossar/secundar/apoiar
transformar-se	virar/tornar/revoltar-se/revoltar
selar	vedar/lacrar/chancelar
atuar	aparentar/pretextar/actuar/fazer/brincar/representar/passar/simular/fingir
citar	mencionar
equiparar	competir
desinteressar	retirar-se
avaliar	medir/estimar
rodar	rolar/girar/virar
adornar	ornar/decorar/ornamentar/embelezar/enfeitar
disseminar	circular/espalhar
etiquetar	marcar
melhorar	aperfeiçoar
circular	disseminar/alastrar/espalhar/difundir/transmitir
esposar	casar
sacudir	balançar/embalar
permanecer	preservar/manter/continuar
permitir	proporcionar/outorgar/fornecer/dar/conceder/admitir/deixar/consentir
entornar	verter
errar	perambular/vagabundear/vaguear/transmigrar/vadiar/vagar
verter	entornar/derramar
concentrar	fascinar/interessar
informar-se	encontrar/ver
representar	simular/actuar/fazer/brincar/fingir/atuar/passar
aperfeiçoar	melhorar
compensar	equilibrar-se/equilibrar
endereçar	englobar/compreender/conter/abarcar/circundar/tratar
manter	permanecer/adiantar-se/seguir/progredir/avançar/ir/continuar/prosseguir
pairar	levitar
vestir-se	vestir
reger	conduzir
satisfazer	encantar/aprazer/agradar/gostar/embevecer/comprazer
mugir	gritar/exclamar/berrar/bradar/chamar
vagabundear	vagar/errar
atingir	ter/impressionar/comprender/entender/pegar/receber/obter/incorrer/bater/acertar/golpear/atacar/executar/realizar/comover/afetar
animar	acordar
naufragar	submergir/afundar
deixar	outorgar/permitir/conceder/admitir/partir/ir/retirar-se/sair/legar/entregar/dar
iniciar	principiar/começar
alimentar-se	comer
moldar	trabalhar
proferir	verbalizar
enrolar	confundir
enxergar	assistir/ver
receber	pagar/incorrer/aceitar/adquirir/obter/comprar/atingir
dependurar	pendurar
conduzir	transmitir/reger/fazer
amolar	enervar-se/irritar-se
passar	cobrir/engessar/enfileirar/actuar/atuar/fazer/representar
levar	consumir/gastar/carregar/trazer/pegar/transmitir
chegar	pegar/alcançar/acercar/avizinhar/vir
imputar	atribuir
revirar	rolar/girar/virar
vaguear	vagar/errar
colidir	bater/acertar/golpear
proclamar	ler
deliberar	considerar/julgar/pensar
arruinar	quebrar/destruir
corresponder	combinar/harmonizar/concordar/compatibilizar
cair	terminar/ficar/soltar/largar/precipitar
parecer	simular/fingir
revolver	rolar/girar/virar
forçar	empurrar/tirar/puxar/arredar
silenciar	quietar/aquietar
assaltar	atacar/agredir
afundar	naufragar/soltar/largar
conter	endereçar/cobrir/falar/tratar/lidar/acomodar/possuir/segurar/incluir/aguentar/compreender/ter
casar-se	casar
defecar	urinar/mijar
fazer	conduzir/desenvolver/conquistar/elaborar/trazer/atrair/construir/produzir/funcionar/criar/instituir/atuar/representar/passar/obter/adquirir/organizar/arrumar/cozinhar/preparar
modelar	trabalhar
sintetizar	resumir/sumarizar
desnudar-se	despojar/desnudar/despir
advogar	anunciar/publicitar/promover/divulgar
harmonizar	combinar/concordar/corresponder
emprenhar	engravidar
afluir	tocar/encostar
liderar	capitanear
familiarizar	introduzir/apresentar
trepar	beijar
purificar	distilar/apurar/sublimar/destilar/extrair
comprender	obter/adquirir/atingir
desvanecer	empurrar
dizer	supor/indicar/verbalizar/ler
bradar	gritar/urrar/vociferar/mugir/berrar
traçar	desenhar/observar/guardar/ver/espionar/assistir/olhar/mirar
contrair	ter/padecer
empregar	aplicar/utilizar/praticar/usar
distilar	purificar/apurar/sublimar/destilar/extrair
ramificar	ramificar-se/bifurcar/brotar
medir	estimar/avaliar
conhecer	saber/entender
encantar	satisfazer
cagar	urinar/mijar
construir	fazer/criar/instituir
distinguir	assinalar
separar	apartar-se/separar-se/apartar/terminar/decepar/cortar/dividir/romper/quebrar
rachar	partir/quebrar
adquirir	ter/comprender/entender/pegar/desenvolver/receber/incorrer/conquistar/lucrar/fazer/obter
dissolver	desintegrar/desmoronar
pegar	vir/irritar/trazer/levar/tirar/transportar/obter/adquirir/atingir/chegar/apanhar/pagar/flagrar
perseverar	sobreviver/haver/subsistir
certificar-se	afiançar
limpar	desobstruir/retirar/remover
cumprir	executar/realizar
revelar	dar/transmitir
capturar	segurar/agarrar
significar	querer_dizer/intencionar
mumificar	ressecar
principiar	começar/iniciar
impressionar	atingir/atacar/provocar/propulsar/motivar/estimular/incentivar
virar	encarar/tornar/revoltar-se/revoltar/girar/revirar/revolver/rodar/derrubar/acontecer/transformar/transformar-se/tornar-se
partir	morrer/quebrar/rachar/ir/retirar-se/abandonar/largar/deixar/sair
estragar	morrer
denotar	intencionar
ornamentar	ornar/decorar/adornar/embelezar/enfeitar
travar	frear
recuperar	encontrar/reganhar/achar
encapar	cobrir/tampar
gritar	urrar/vociferar/mugir/exclamar/berrar/bradar/chamar
aprazer	satisfazer
vir	pegar/alcançar/chegar/ficar/começar
reclamar	afirmar/reivindicar
jogar	apostar/brincar/usar/colocar/utilizar
afastar-se	decorrer
insultar	praguejar/blasfemar/maldizer
lactar	sugar/chupar
acercar	chegar
guardar	traçar/seguir
actuar	atuar/representar/passar
sacar	extrair/puxar/tirar
tirar	forçar/extrair/sacar/puxar/trazer/pegar/transmitir
flutuar	boiar/vagar/nadar
esperar	antecipar/aguardar/parir/ter
achar	julgar/pensar/reconquistar/recuperar/declarar/reganhar/encontrar/aprender/entender/compreender/determinar/ver/detectar/descobrir
reservar	pedir
cravar	espetar
atravessar	cortar/vasculhar/varrer/vassourar/voar/pilotar
tornar-se	virar/converter/transformar/transmudar/tornar/revoltar-se/revoltar
ultrapassar	enganar
arder	acender/incinerar/queimar/carburar
extrair	destilar/distilar/purificar/sacar/puxar/tirar
aleitar	sugar/chupar
prover	provocar/dar/causar
colapsar	desmoronar/desabar/quebrar/ruir/desistir/abandonar
entregar	dar/transmitir/deixar
misturar	confundir
esmiuçar	pulverizar
caminhar	deslocar/mover/ir/andar/passear
visualizar	afigurar/figurar/ver/entender/compreender
acender	arder/queimar/organizar/arrumar/cozinhar/preparar
ligar	tocar
escrever	compor/publicar/redigir
indicar	dizer
acontecer	suceder/virar/tornar/revoltar-se/revoltar/calhar/ocorrer
circundar	endereçar/cobrir/falar/tratar/lidar
diminuir	reduzir
destilar	distilar/purificar/apurar/sublimar/extrair/condensar
apostar	jogar
derrubar	virar
transmudar	converter/tornar-se
relacionar	inter-relacionar/aludir/reportar-se
retirar	limpar/desobstruir
interessar	focar/concentrar/centrar
revoltar	transformar/virar/transformar-se/mudar/acontecer/tornar-se
diferenciar	assinalar
mover	andar/ir/caminhar/viajar
afastar	empurrar
descobrir	verificar/encontrar/assegurar/determinar/ver/detectar/achar
mencionar	citar
perecer	morrer
aplicar	utilizar/usar/empregar/cobrir/engessar/dar
acamar	jazer
questionar	indagar/perguntar
fotografar	filmar
estimular	impressionar/comover/afetar
ocorrer	acontecer
sedimentar	assentar
lamuriar	birra
lotar	atochar
esquecer	abandonar
foder	beijar
formular	desenvolver
aludir	concernir/relacionar/referir
aderir	grudar/colar
maldizer	xingar/insultar/desbocar
sair	ir/retirar-se/abandonar/largar/partir/deixar
punheta	masturbar
atrair	fazer
convergir	tocar/encostar
reanimar	acordar
sugar	lactar/amamentar/aleitar
caber	combinar
desbocar	praguejar/blasfemar/maldizer
assegurar-se	afiançar
mirar	traçar/seguir
tomar	beber
aturar	sofrer
conformar	adoptar
escovar	varrer
meter	beijar
demandar	custar
arrumar-se	vestir
apoiar	aprovar
calhar	acontecer
noticiar	introduzir/apresentar
concordar	combinar/corresponder/harmonizar/compatibilizar
devastar	dizimar
frear	travar
pregar	colar/grudar
engravidar	emprenhar
transformar	virar/tornar/revoltar-se/revoltar/converter/tornar-se
barricar	tapar
demonstrar	registrar/perceber
proteger	cobrir
servir	ajudar/funcionar/dar
declarar	achar
requerer	requisitar/pedir/custar/solicitar
obter	ter/comprender/entender/pegar/incorrer/conquistar/fazer/lucrar/adquirir/receber/comprar/atingir
perturbar	enervar-se/irritar-se
comprometer	dar
parir	aguardar/esperar
balançar	embalar/sacudir
agitar	confundir/incomodar/anunciar/publicitar/promover/divulgar/bater
preparar	treinar/instruir/acender/fazer
vedar	lacrar/selar/chancelar
reivindicar	reclamar/afirmar
pilotar	voar/atravessar
beijar	comer/foder/montar/copular/meter/trepar/transar
checar	verificar/assegurar
estender-se	jazer
solicitar	requisitar/pedir/requerer
posar	sentar/sentar-se
conquistar	fazer/obter/adquirir
despojar	desnudar-se/despir-se
afirmar	considerar/reclamar/reivindicar/julgar
vencer	enganar
isolar	adiar
assistir	enxergar/ver/olhar/traçar/seguir
reviver	acordar
trair	vender
urinar	mijar/defecar/cagar
reduzir	diminuir
gelar	congelar
aprender	verificar/assegurar/achar/determinar
agarrar	capturar/apanhar
estender	aumentar
ter	atingir/adquirir/obter/aguardar/esperar/contrair/sofrer/conter/padecer
segurar	capturar/apanhar/conter
convocar	chamar/convidar
mergulhar	focar
calcinar	queimar/incinerar
levitar	pairar
aconchegar-se	acomodar
repor	substituir/sobrepor/suplantar
render	lucrar
beber	tomar
espalhar	circular/disseminar/alastrar/difundir/transmitir
colar	pregar/atar/grudar/aderir
afiançar	assegurar/assegurar-se/garantir/certificar-se
propulsar	impressionar/comover/afetar
começar	principiar/iniciar/vir
apresentar	informar/notificar/noticiar/familiarizar
lutar	anunciar/publicitar/promover/divulgar
julgar	afirmar/achar/deliberar/considerar
fingir	agir/comportar-se/parecer/atuar/representar
gastar	ocupar/levar
aborrecer	enervar-se/irritar-se
consentir	outorgar/permitir/dar/conceder
inter-relacionar	relacionar
tocar	irritar/encontrar/afluir/convergir/retocar/empurrar/executar/ligar
convencionar	estipular
continuar	durar/prolongar-se/preservar/manter/permanecer/adiantar-se/seguir/progredir/avançar/ir/prosseguir
provar	experimentar/verificar/assegurar
sufocar	asfixiar/estrangular
empurrar	forçar/tocar/desvanecer/afastar/afugentar/rechaçar
deparar	confrontar/defrontar/enfrentar
falar	supor/verbalizar/ler/englobar/compreender/conter/abarcar/circundar/tratar
focar	mergulhar/fascinar/interessar
desprezar	indeferir/recusar/rejeitar/declinar
obscurecer	confundir
ampliar	aumentar
formar	trabalhar
dividir	apartar-se/separar-se/apartar/terminar/desintegrar/decepar/cortar/separar/romper/quebrar
incinerar	queimar/calcinar/arder
congelar	gelar
transar	beijar
carregar	levar/transportar
equilibrar	compensar/equilibrar-se
executar	justiçar/atingir/cumprir/efetuar/realizar/tocar
trabalhar	cultivar/modelar/moldar/formar
puxar	forçar/sacar/extrair/tirar/arredar
acomodar	aconchegar-se/conter/acariciar/aconchegar
endossar	aprovar
urrar	gritar/exclamar/berrar/bradar/chamar
transmigrar	vagar/errar
retirar-se	desinteressar/abandonar/largar/partir/deixar/sair
vassourar	atravessar/raspar/roçar
desencaminhar	seduzir
vagar	perambular/vagabundear/vaguear/transmigrar/vadiar/errar/flutuar
marcar	rotular/etiquetar
conversar	verbalizar
sumarizar	sintetizar/resumir
agradar	satisfazer
informar	introduzir/apresentar
apurar	purificar/distilar/destilar
ornar	adornar/ornamentar/decorar
verificar	provar/ver/aprender/encontrar/descobrir/checar/conferir/assegurar
determinar	encontrar/aprender/ver/achar/descobrir
somar	adicionar
soltar	afundar/cair
compreender	entender/achar/considerar/endereçar/cobrir/falar/tratar/lidar/figurar/afigurar/visualizar/ver/conter/ler
aguentar	sofrer/conter
pensar	achar/deliberar/considerar
arredar	forçar/puxar
ler	dizer/falar/proclamar/compreender/entender
supor	dizer/contar/falar
simular	representar/atuar/agir/comportar-se/parecer
fraturar	quebrar
embelezar	adornar/ornamentar/decorar
enervar	confundir/incomodar
trazer	fazer/levar/tirar/transportar/funcionar/pegar/transmitir
filmar	fotografar
ruir	colapsar/desistir/abandonar
publicitar	advogar/agitar/lutar
perguntar	indagar/questionar
elaborar	desenvolver/criar/fazer
tornar	transformar/virar/transformar-se/mudar/acontecer/tornar-se
desaconselhar	alertar/advertir/avisar
reganhar	reconquistar/recuperar/encontrar/achar
passear	ir/caminhar/andar
introduzir	informar/notificar/noticiar/familiarizar
difundir	circular/espalhar
cortar	apartar-se/separar-se/apartar/terminar/decepar/dividir/separar/atravessar
crescer	desenvolver
flagrar	apanhar/pegar
pagar	pegar/receber
desmoronar	dissolver/romper/quebrar/colapsar/desistir/abandonar
ramificar-se	bifurcar/ramificar/brotar
chupar	lactar/amamentar/aleitar
vivificar	acordar
carburar	arder
acertar	atingir/bater/colidir
blasfemar	xingar/insultar/desbocar
observar	traçar/seguir
reavivar	acordar
preservar	permanecer/adiantar-se/seguir/progredir/avançar/ir/continuar/prosseguir
incluir	conter
derrotar	enganar
ver	verificar/visualizar/informar-se/inteirar/assegurar/determinar/enxergar/olhar/traçar/seguir/entender/compreender/achar/descobrir/reunir/assistir
desenhar	arquitetar/criar/traçar/delinear
masturbar-se	masturbar
retroceder	decorrer
requisitar	requerer/solicitar
retocar	tocar
cobrir	enfronhar/encapar/tampar/afixar/aplicar/passar/proteger/englobar/compreender/conter/abarcar/circundar/tratar
dar	dedicar/ajudar/revelar/prover/entregar/legar/servir/aplicar/comprometer/deixar/consentir/permitir/provocar/causar/transmitir
enganar	derrotar/bater/vencer/superar/ultrapassar
desempenhar	afetar
olhar	traçar/seguir/assistir/ver
fornecer	permitir/admitir
seduzir	desencaminhar
atraiçoar	vender
praguejar	xingar/insultar/desbocar
recolocar	substituir/sobrepor/suplantar
decorar	ornar/adornar/ornamentar/embelezar/enfeitar
interditar	tapar
enfronhar	cobrir/tampar
referir	aludir/reportar-se
compor	publicar/escrever
suceder	acontecer
aniquilar	dizimar
intoxicar	envenenar
obnubilar	confundir
capitanear	liderar/desbravar
desejar	procurar
largar	partir/ir/retirar-se/sair/afundar/cair
prevenir	alertar/advertir/avisar
bater	palpitar/pulsar/enganar/acertar/golpear/agitar/atingir/colidir
aguardar	antecipar/esperar/parir/ter
produzir	fazer/criar/instituir
ressecar	mumificar
desobstruir	retirar/limpar
domar	domesticar
semear	plantar
convidar	convocar
dedicar	dar
aceitar	admitir/receber
possuir	conter
pulsar	bater
comportar-se	simular/fingir
redigir	escrever
palpitar	bater
gotejar	pingar
deitar-se	jazer
estrangular	asfixiar/sufocar
decepar	cortar/apartar-se/separar-se/dividir/apartar/separar/terminar
bifurcar	ramificar-se/ramificar
inteirar	encontrar/ver
terminar	cair/decepar/cortar/dividir/separar
choramingar	birra
restar	jazer
substituir	recolocar/suplantar/repor/sobrepor/mudar
enferrujar	oxidar
lavar-se	lavar
precisar	custar
agastar	enervar-se/irritar-se
fascinar	focar/concentrar/centrar
registrar	registrar/demonstrar/perceber
realizar	atingir/cumprir/efetuar/executar
pulverizar	esmiuçar
casar	esposar/juntar/casar-se
prosseguir	preservar/manter/continuar
disparar	atirar
juntar	casar
enraizar	radicar
ganhar	desenvolver
queimar	calcinar/incinerar/acender/arder
suportar	sofrer
rechaçar	empurrar
adiantar-se	preservar/manter/continuar
condensar	destilar
defrontar	deparar/confrontar
birra	choramingar/lamuriar
custar	precisar/demandar/requerer
causar	prover/dar
montar	beijar
assinalar	distinguir/diferenciar
instruir	preparar/treinar
folgar	brincar
espetar	cravar
durar	continuar
comprar	receber/obter/incorrer
motivar	impressionar/comover/afetar
quietar	silenciar
olvidar	abandonar
acariciar	acomodar
comer	beijar/alimentar-se
organizar	acender/fazer
rotular	marcar
romper	separar/dividir/desmoronar
alastrar	circular/espalhar
desistir	desmoronar/desabar/colapsar/quebrar/ruir
germinar	brotar
tolerar	sofrer
viajar	deslocar/mover/cavalgar/andar/ir
legar	dar/transmitir/deixar
criar	desenvolver/elaborar/construir/produzir/fazer/instituir/arquitetar/desenhar
compatibilizar	combinar/concordar/corresponder
ir	deslocar/mover/viajar/cavalgar/preservar/manter/continuar/andar/caminhar/passear/abandonar/largar/partir/deixar/sair
apartar	decepar/cortar/dividir/separar
incomodar	confundir/enervar-se/irritar-se/agitar/enervar
derramar	verter
sobrepor	substituir/recolocar/repor
antecipar	aguardar/esperar
proporcionar	permitir/admitir
indagar	perguntar/questionar
consumir	ocupar/levar
deslocar	andar/ir/caminhar/viajar
aumentar	estender/ampliar
girar	revirar/revolver/rodar/virar-se/virar
bloquear	tapar
superar	enganar
pôr	sentar/sentar-se
chamar	convocar/gritar/urrar/vociferar/mugir/berrar
encostar	encontrar/afluir/convergir
exercitar	malhar/treinar/exercitar-se
competir	equiparar/igualar
amamentar	sugar/chupar
afixar	cobrir
desnudar	desnudar-se/despir-se
varrer	escovar/atravessar/raspar/roçar
treinar	praticar/instruir/malhar/exercitar/preparar
renascer	acordar
surrar	destruir
asfixiar	sufocar/estrangular
radicar	enraizar
atochar	lotar
desbravar	capitanear
sublimar	purificar/distilar/destilar
avisar	alertar/desaconselhar/advertir/admoestar/prevenir
gostar	satisfazer
equilibrar-se	equilibrar/compensar
experimentar	provar
incentivar	impressionar/comover/afetar
comover	atingir/atacar/provocar/propulsar/motivar/estimular/incentivar
perceber	registrar/registrar/demonstrar
provocar	prover/dar/impressionar/comover/afetar
martelar	fincar
desabar	colapsar/desistir/abandonar
estipular	convencionar
atacar	impressionar/atingir/assaltar/atirar/agredir/comover/afetar
apanhar	segurar/agarrar/pegar/flagrar
decorrer	afastar-se/recuar/retroceder
quebrar	arruinar/partir/destruir/morrer/rachar/separar/dividir/desmoronar/fraturar/colapsar/desistir/abandonar
converter	transformar/transmudar/tornar-se/mudar
prolongar-se	continuar
boiar	flutuar
conferir	verificar/assegurar
atormentar	enervar-se/irritar-se
igualar	competir
adoptar	seguir/conformar/acatar
colocar	jogar
atar	colar/grudar
trocar	mudar
recuar	decorrer
virar-se	girar
correr	enfileirar
voar	atravessar/pilotar
declinar	recusar/desprezar/rejeitar
chancelar	vedar/selar
massacrar	dizimar
ficar	cair/vir
adicionar	acrescer/acrescentar/somar
submergir	naufragar
intencionar	significar/denotar
rejeitar	indeferir/desprezar/recusar/declinar
subsistir	resistir/sobreviver/perseverar
embalar	balançar/sacudir
saber	conhecer/entender
afugentar	empurrar
brincar	jogar/folgar/atuar/representar
atirar	atacar/disparar
vasculhar	atravessar/raspar/roçar
haver	resistir/sobreviver/perseverar
publicar	escrever/compor
admoestar	alertar/advertir/avisar
ocupar	consumir/gastar
fechar	cerrar
acrescer	adicionar
procurar	querer/desejar
justiçar	executar
atribuir	imputar
revestir	forrar
resumir	sintetizar/sumarizar
querer_dizer	significar
verbalizar	falar/dizer/conversar/proferir
exercitar-se	malhar/exercitar
tapar	barricar/bloquear/interditar
embevecer	satisfazer
desenvolver	formular/elaborar/ganhar/crescer/adquirir/criar/fazer
assentar	sedimentar
anunciar	advogar/agitar/lutar
delinear	desenhar
irritar-se	atormentar/perturbar/aborrecer/amolar/agastar/vexar/molestar/incomodar/irritar/importunar
copular	beijar
grudar	pregar/atar/aderir/colar
exclamar	gritar/urrar/vociferar/mugir/berrar
progredir	preservar/manter/continuar
funcionar	fazer/servir/trazer/operar
