outro	separado
primeiro	original/dianteiro/temporão/precoce/cedo/primário
mesmo	similar/semelhante/parelho/idêntico/igual/análogo
novo	contemporâneo/moderno/fresco/recente/corrente/actual/atual
bom	favorável/obediente/melhor/respeitável/virtuoso/nobre/decoroso/digno/moral/reto/justo/recto/boa
bem	são/salubre/saudável
próprio	apropriado/correto/justo/certo
passado	antigo/velho/extrovertido
responsável	prudente/judicioso/sensato
partido	imperfeito/avariado/ferido
alto	grande/audível/ruidoso/barulhento
social	sociável/gregário/amigo/amigável/amistoso
direito	destro
possível	realístico/provável/prático
actual	contemporâneo/moderno/novo
importante	precioso/valioso/significante/essencial/decisivo/crítico/significativo
jovem	júnior/imaturo/novo
antigo	passado
certo	previsível/aprimorado/perfeito/textual/literal/próprio/adequado/conveniente/verdadeiro/preciso/exato/acurado/justo/exacto
internacional	estrangeiro/alienígena
plano	imutável/liso/macio
necessário	indispensável/obrigatório/essencial/imprescindível
socialista	esquerdista
geral	extenso/amplo/abrangente/exaustivo/impreciso/comum
forte	resistente/grosso/poderoso
estrangeiro	internacional
claro	branco/cândido/alvo
mau	ruim/imoral/ofensivo/incorrecto
humano	civilizado/misericordioso/compassivo
diferente	vário/incompatível/desigual
baixo	inferior
rápido	apressado/súbito/abrupto/repentino
pessoal	privado
privado	esotérico/pessoal
velho	sênior/experimentado/experiente/maturo/maduro/passado
preciso	específico/inconfundível/aprimorado/perfeito/textual/literal/acurado/exacto/exato/correcto/correto/justo/certo
recente	novo
amigo	congenial/amigável/útil/social/cálido/sociável
bastante	rico
verdadeiro	autêntico/genuíno/legítimo/honesto/sincero/correto/justo/certo
livre	independente
comum	solidário/rotineiro/normal/ordinário/costumeiro/genérico/geral/usual/habitual
prático	realístico/possível/concreto/prestativo
capaz	apropriado/satisfatório/habilitado/competente
material	substancial
interno	central
negro	escuro
simples	singelo/fácil
branco	claro
positivo	afirmativo/optimista/otimista/construtivo
fácil	simples/singelo/brando
existente	remanescente/autêntico/genuíno/legítimo/realístico/concreto
industrial	progressivo
crítico	erudito/desfavorável/sarcástico/essencial/decisivo/importante/crucial
melhor	superior/bom/boa/incomparável
independente	livre/separado
doente	adoentado/doentio/insalubre/enfermo/inapropriado
significativo	significante/importante
igual	comparável/mesmo
normal	ordinário/costumeiro/genérico/comum/geral/usual/habitual/são/sadio/padrão
seguro	previsível/inofensivo/inócuo/invulnerável/indene/indemne
essencial	intrínseco/crítico/importante/crucial/primário/necessário/indispensável/obrigatório/imprescindível
familiar	sabido
legal	lícito/legítimo
físico	concreto
semelhante	mesmo
corrente	contemporâneo/moderno/novo
habitual	comum
alvo	claro
específico	preciso
produtor	próspero/bem-sucedido/fértil/fecundo/frutífero/original/criativo/criador/rendoso/lucrativo/proveitoso
colectivo	unido/solidário
direita	destro
profundo	intenso/intensivo/erudito
favorável	afirmativo/bom/boa/rendoso/lucrativo/proveitoso/propício/oportuno/cómodo
religioso	virtuoso/digno/nobre/sagrado/devoto/piedoso
largo	extenso/amplo/abrangente/exaustivo/espesso/grosso
concreto	tangível/físico/existente/prático
complexo	árduo/difícil/foda/intrincado/composto
original	primário/criador/primeiro/criativo/produtor/produtivo
completo	extenso/amplo/abrangente/exaustivo/integral/inteiro
idêntico	comparável/mesmo
impossível	insuperável/inexorável/inviável/impraticável/desesperado
interessante	emocionante/excitante
má	ruim/imoral/ofensivo/incorrecto
estranho	desajeitado/feio/estrangeiro/desconhecido
inferior	pior/subordinado/baixo/baixa
decisivo	conclusivo/crítico/importante/crucial
moderno	novo/tardio/corrente/actual/atual
permanente	estável/imutável/inalterável
individual	separado
cedo	primeiro
falso	errado/incorreto/desonroso
abaixo	descendente
provável	possível
perigoso	inseguro/vulnerável
efetivo	útil/potente/eficaz/poderoso/eficiente
rico	privilegiado/lauto/farto/bastante/basto/copioso/abundante
definitivo	inconfundível/explícito
conservador	ortodoxo
obrigatório	necessário/essencial
ferido	avariado/lesionado/partido
moral	nobre/digno/virtuoso/reto/justo/recto/bom/boa/casta/casto/honrado
masculino	varonil/viril/varão/macho
constante	estável/imutável/inalterável/invariável
puro	casta/casto
extraordinário	inusual/insólito/impressionante/superior/incomparável
violento	malvado
inteiro	completo/integral
frio	gelado/congelado/fresco/frígido
inevitável	previsível
ilegal	corrupto/ilegítimo
raro	infrequente
eficaz	efetivo/útil/potente/poderoso/eficiente
caro	precioso/valioso
liberal	caridoso/esquerdista
regular	sistemático/simétrico/rítmico
pacífico	quieto/calmo/amigável
contemporâneo	novo/tardio/corrente/actual/atual
belo	gracioso/atraente/aprazível
feliz	animador/animado/ditoso/eufórico/grato/alegre/contente
formal	corriqueiro/convencional/retórico
justo	imparcial/virtuoso/nobre/decoroso/digno/inocente/moral/bom/boa/próprio/adequado/conveniente/verdadeiro/acurado/exacto/exato/preciso/correcto/correto/certo
intelectual	mental/erudito
poderoso	potente/efetivo/eficaz/eficiente/forte
intenso	entranhado/profundo
útil	prestativo/efetivo/eficaz/eficiente/serviçal/prestável/rendoso/lucrativo/proveitoso/amigo/amigável/amistoso/compatível
sensível	consciente/suscetível/ciente/informado
correcto	aprimorado/perfeito/textual/literal/preciso/exato/acurado/justo/exacto
fiel	patriótico/leal
indispensável	essencial/necessário
paralelo	simétrico/comparável
voluntário	consciente
autêntico	verdadeiro/existente/sincero/honesto
perfeito	utópico/exato/preciso/correcto/certo
bonito	gracioso/atraente/aprazível
preto	escuro
escasso	insuficiente/minimum/mínimo
quente	caloroso/passional
optimista	vantajoso/positivo
razoável	válido/racional/lógico
desempregado	inútil/vão
lento	gradual
atento	judicioso/sensato/cauto/cauteloso/prudente/diligente
vão	desempregado/impróprio/ineficiente/inapto/impotente/inútil
humanitário	civilizado/misericordioso/compassivo/humano
esquerdo	canhoto
primário	original/essencial/primeiro
parcial	injusto/incompleto
inesperado	surpreendente
alerta	astuto/vívido/desperto/acordado/cuidadoso/cauteloso
típico	característico
legítimo	verdadeiro/existente/sincero/honesto/válido/legal
triste	pesaroso/infeliz
sistemático	organizado/regular
sólido	duro
amplo	extenso/abrangente/exaustivo/espesso/grosso/largo/geral/completo/integral
previsível	seguro/inevitável/certo
posterior	traseiro/rabo
mortal	limitado/finito
criador	original/produtor/produtivo
surpreendente	imprevisto/inesperado
temporário	instável/precário
estreito	fino
considerável	grande
ofensiva	prejudicial/nocivo/daninho/danoso/desrespeitoso
incapaz	incompetente
insuficiente	escasso
padrão	normal
súbito	rápido/veloz
baixa	inferior
digno	moral/piedoso/religioso/casta/casto/reto/justo/recto/bom/boa/precioso/valioso/honrado/gracioso/esbelto/garboso/airoso/elegante/constituído
distante	longe/longínquo
escuro	negro/preto
calmo	pacífico
produtivo	próspero/bem-sucedido/fértil/fecundo/frutífero/original/criativo/criador/rendoso/lucrativo/proveitoso
exacto	exato/preciso/correcto/correto/justo/certo
agradável	afável/amável/gentil/lhano/aprazível
inteligente	esperto/precoce
delicado	débil
consciente	sensível/acordado/voluntário/informado/ciente/desperto
nobre	recto/moral/piedoso/boa/religioso/justo/bom/reto/casta/casto/honrado
estável	constante/imutável/duradouro/permanente
substancial	material
explícito	unívoco/inequívoco/denotativo/definitivo
santo	sagrado/dedicado
vago	dúbio/ambíguo/confuso
válido	razoável/legítimo
competente	eficiente/qualificado/talentoso/capaz/habilidoso
vário	heterogêneo/diferente
agressivo	assertivo/peremptório/ofensivo/malvado
fresco	novo/frio
simpático	afável/amável/gentil/lhano/aprazível
móvel	movente
extenso	largo/amplo/geral/completo/integral
ambicioso	empreendedor
consequente	racional/lógico
precioso	caro/decoroso/digno/importante
progressivo	dianteiro/industrial
integral	completo/extenso/amplo/abrangente/exaustivo/inteiro
moderado	suave
artificial	lógico/irreal
suscetível	sensível/vulnerável
automático	mecânico
criativo	original/produtor/produtivo
impressionante	comovente
inocente	reto/justo/recto
perdido	maldito
nulo	ilegítimo
contente	satisfeito/animador/animado/ditoso/eufórico/feliz/grato/alegre
júnior	jovem/subalterno
ofensivo	agressivo/prejudicial/nocivo/daninho/danoso/desrespeitoso/maléfico/mau/má/ruim/malvado/abominável/desagradável/arisco
aceitável	satisfatório
acessível	conveniente
crucial	essencial/decisivo/crítico
genérico	comum
grosso	experiente/experimentado/forte/largo/amplo/gordo
pior	inferior/ruim
lógico	razoável/artificial/sintético/analítico/consequente/coerente/racional
saudável	são/salubre/bem
ortodoxo	conservador
injusto	incorrecto/desonroso/imoral/parcial
descendente	abaixo
precário	inseguro/oscilante/inconstante/temporário
convencional	formal
implícito	conotativo
informativo	noticioso
doce	saboroso
adequado	apropriado/correto/justo/certo/satisfatório
solidário	comum/unido/coletivo/colectivo
exigente	limpo/grácil/mimoso
directo	reto
selvagem	desobediente/intratável
noticioso	informativo
compatível	útil/congenial/harmonioso
característico	típico
organizado	sistemático
quadrado	angular
tóxico	prejudicial/nocivo/daninho/danoso
coerente	racional/lógico
paciente	tolerante/resignado
inútil	desempregado/impróprio/ineficiente/inapto/indigno/impotente/vão
dinâmico	energético/enérgico
fino	liso/macio/tênue/esbelto/magro/estreito
sujo	indecente/eriçado/hirto
pessimista	desesperado
variável	inconsistente/inconstante
confuso	indistinto/indefinido/impreciso/ambíguo/vago/dúbio/opaco/incompreensível
limpo	exigente
desejável	amorável
infeliz	pesaroso/triste
emocional	passional/afetado/comovente/cálido
desfavorável	ruim/crítico/malvado/prejudicial/nocivo/daninho/danoso
genuíno	verdadeiro/existente/sincero/honesto
cauteloso	prudente/atento
oportuno	favorável/profícuo/vantajoso/propício
suave	moderado/silencioso/quieto/quiet
animador	alegre/grato/feliz/contente
imprescindível	necessário/essencial
doloroso	prejudicial/nocivo/daninho/danoso/inumano/desumano
sangrento	impiedoso
funcional	prestativo
privilegiado	afortunado/rico
ocupado	diligente
satisfatório	aceitável/capaz/adequado
lesionado	avariado/ferido
lucrativo	útil/produtor/produtivo/favorável/profícuo/vantajoso/propício
eficiente	útil/potente/poderoso/habilitado/competente/efetivo/eficaz
honesto	legítimo/honrado/genuíno/autêntico/correto/verdadeiro
rítmico	regular
prudente	sábio/responsável/judicioso/sensato/cauto/cauteloso/atento/diligente
desconhecido	estrangeiro/estranho
conveniente	apropriado/correto/justo/certo/acessível
imprevisível	incerto
resistente	experiente/experimentado/forte
similar	mesmo
valioso	caro/decoroso/digno/importante
propício	rendoso/lucrativo/proveitoso/oportuno/cómodo/auspicioso/favorável/profícuo/vantajoso
energético	ativo/empreendedor/dinâmico/vívido
protegido	invulnerável
consistente	invariável
unido	coletivo/colectivo/solidário
silencioso	suave
elegante	digno/gracioso/grácil/mimoso/sofisticado
incerto	imprevisível
desagradável	horrível/antipático/ofensivo
prematuro	imaturo
gradual	devagar/inclinado/lento
qualificado	habilitado/competente/elegível
incompatível	diferente
cooperativo	serviçal/prestável
exaustivo	largo/amplo/geral/completo/integral
amoroso	passional/amorável/empenhado
potente	fecundo/fértil/efetivo/eficaz/eficiente/poderoso
alegre	animador/animado/contente
peremptório	agressivo
magro	fino
experiente	grosso/resistente/habilidoso/talentoso
desesperado	desencorajante/pessimista/impossível
racional	lógico/sadio/são/razoável
tenso	desassossegado/inquieto/apertado
comparável	paralelo/paralela/parelho/idêntico/igual/análogo
estúpido	retardado/imbecil/idiota/sonso/lerdo
compreensível	explicável/inteligível
intato	indene/indemne
gordo	espesso/grosso
errado	incorreto/desonroso/falso
flexível	elástico
incompreensível	inexplicável/confuso
limitado	mortal
feio	estranho/esquisito
acordado	consciente/alerta/ciente/informado
afetado	emocional/sobrenatural/paranormal
sábio	prudente/judicioso/sensato/aconselhável
anormal	insano
convincente	persuasivo
vulnerável	inseguro/suscetível/perigoso
atraente	bonito/formoso/lindo/belo/aprazível
infinito	imortal
traseiro	posterior/rabo
ambíguo	indefinido/impreciso/vago/dúbio/confuso
colorido	cromático
prejudicial	maligno/ofensivo/desfavorável/ofensiva/desvantajoso/nocivo/destrutivo/árduo/dolorido/doloroso/extenuante/doído/tóxico
corajoso	audaz/audacioso/bravo/valoroso/valente/afoito/arrojado/destemido/aventureiro
construtivo	vantajoso/positivo
entusiasta	passional
vertical	reto/íngreme
leal	patriótico/fiel
implacável	impiedoso
vantajoso	afirmativo/optimista/otimista/construtivo/rendoso/lucrativo/proveitoso/propício/oportuno/cómodo
horrível	desagradável/arisco
ordinário	costumeiro/genérico/geral/usual/habitual/comum
gelado	frio
instável	inseguro/oscilante/inconstante/temporário
incompleto	parcial/fracionário
secular	profano/sofisticado
hábil	astuto
duradouro	estável/imutável/inalterável
amigável	congenial/útil/social/cálido/sociável/amigo/amistoso/pacífico/amorável
bravo	audaz/audacioso/valoroso/valente/afoito/arrojado/corajoso/destemido/aventureiro
invariável	consistente/constante
sintético	lógico
enérgico	ativo/empreendedor/dinâmico/vívido
abundante	rico
informado	consciente/desperto/acordado/sensível
usual	comum
corrupto	imoral/ilegal/desonroso
esporádico	infrequente
precoce	inteligente/primeiro
sincero	legítimo/honrado/genuíno/autêntico/correto/verdadeiro
dedicado	sagrado/santo
fértil	potente/frutífero/proveitoso/fecundo/produtor/produtivo
inconsciente	adormecido
respeitável	decoroso/digno/bom/boa
devagar	gradual
composto	complexo/intrincado
lindo	gracioso/atraente/aprazível
constituído	digno
inexplicável	incompreensível
intensivo	entranhado/profundo
erudito	crítico/profundo/entranhado/intelectual
separado	outro/independente/individual
impotente	infértil/estéril/improdutivo/débil/inútil/vão/ineficaz
emocionante	interessante/sensual/sexy
civilizado	grácil/mimoso
entusiástico	passional
glorioso	sabido
casta	virtuoso/digno/nobre/moral/puro
abrangente	largo/amplo/geral/completo/integral
intrínseco	inalienável/essencial
maduro	velho
débil	impotente/delicado
imprevisto	surpreendente
superficial	frívolo/fútil/descuidado/negligente
brando	tenro/meigo
tênue	fino
celeste	imortal/sagrado
ilegítimo	nulo/inválido/ilegal
empenhado	carinhoso/amoroso
impróprio	inútil/vão
plausível	crível
inquieto	impaciente/inseguro/oscilante/entusiasmado/excitado/tenso
são	bem/saudável/racional
patriótico	fiel/leal
lacônico	taciturno
incorreto	falso/errado
eufórico	feliz/contente
perplexo	hesitante
aventureiro	valoroso/valente/afoito/arrojado/audacioso/audaz/bravo/destemido/corajoso
aconselhável	prudente/judicioso/sensato/sábio
árduo	prejudicial/nocivo/daninho/danoso/inumano/desumano
pacato	pacífico
leigo	profano/sofisticado
excitante	interessante/sensual/sexy
alta	audível/ruidoso/barulhento
ineficaz	infértil/estéril/improdutivo/impotente
dianteiro	progressivo/primeiro
esquisito	desajeitado/feio
sensato	atento/sábio/prudente/responsável
elegível	qualificado
próspero	afortunado/produtor/produtivo
harmonioso	compatível
inseguro	inquieto/precário/instável/desnivelado/perigoso/vulnerável
caloroso	quente
macho	varonil/viril/varão/masculino
homogêneo	invariável/uniforme/mesmo
indefinido	dúbio/ambíguo/confuso
divergente	oblíquo
rabo	posterior/traseiro
animado	alegre/grato/feliz/contente/astuto
chato	incolor
subordinado	subalterno/inferior
ruidoso	alta/berrante/alto
saboroso	desgradável/azedo/acídulo/doce/apetitoso/salgado
utópico	aprimorado/perfeito
receoso	timorato/covardemente/covarde/cobarde
superior	melhor
inofensivo	indolor/benigno/inócuo/seguro
apropriado	próprio/adequado/conveniente
afirmativo	positivo/vantajoso/favorável
envergonhado	penitente
incompetente	ineficiente
análogo	comparável/mesmo
veloz	apressado/súbito/abrupto/repentino
inconfundível	preciso/definitivo
ávido	entusiástico/entusiasta
elástico	flexível
conclusivo	decisivo
sofisticado	gracioso/esbelto/garboso/airoso/elegante/letrado/leigo/secular/cosmopolita
sagrado	religioso/piedoso/celeste/dedicado
farto	rico
nocivo	maligno/ofensivo/danoso/desfavorável/daninho/ofensiva/desvantajoso/prejudicial/destrutivo/árduo/dolorido/doloroso/extenuante/doído/tóxico
sensual	excitante/emocionante
tolerante	paciente/caridoso
lícito	correto/legal
comovente	impressionante/emocional
entusiasmado	inquieto
adormecido	desfalecido/desmaiado/inconsciente/incônscio/desacordado
grato	animador/animado/contente
reservado	taciturno
virtuoso	recto/moral/piedoso/boa/religioso/justo/bom/reto/casta/casto
infernal	maléfico/mau/má/ruim/malvado
monótono	incolor
ciente	consciente/desperto/acordado/sensível
apertado	tenso
espesso	largo/amplo/gordo
inviável	impossível
idiota	lerdo/estúpido
desumano	árduo/dolorido/doloroso/extenuante/doído
humorístico	aprazível
talentoso	habilitado/competente/experiente/experimentado
impiedoso	implacável/sangrento
satisfeito	contente
cromático	colorido/marrom/castanho
analítico	lógico
sênior	velho
imoral	maléfico/mau/má/ruim/malvado/injusto/indigno/desonroso
arrojado	corajoso/destemido/bravo/audaz/audacioso/aventureiro
inexorável	inconquistável/impossível
figurativo	retórico
retórico	figurativo
hesitante	perplexo
imortal	infinito/celeste
estéril	ineficaz/impotente
incomparável	extraordinário/melhor
encorajador	serviçal/prestável
esquerdista	liberal/socialista
amável	brando/misericordioso/compassivo/benigno/afável/gentil/lhano/simpático/agradável
honrado	honesto/sincero/decoroso/digno/moral/nobre
saliente	indiscreto/imprudente
proeminente	indiscreto/imprudente
abrupto	rápido/veloz
volátil	inconstante
inócuo	inofensivo/indolor/benigno/seguro
singelo	simples/fácil
profano	leigo/secular
indigno	inútil/desprezível/desonroso/imoral
incorrecto	injusto/imoral/maléfico/mau/má/ruim/malvado
ágil	astuto
impaciente	inquieto
literal	exato/preciso/correcto/certo
congelado	frio
empreendedor	aventureiro/ambicioso/enérgico/energético
valente	corajoso/destemido/bravo/audaz/audacioso/aventureiro
macio	fino/escorregadio/plano/comestível
equitativo	imparcial
impraticável	impossível
cobarde	timorato/receoso
irreal	artificial/sobrenatural
maligno	prejudicial/nocivo/daninho/danoso
esperto	inteligente
áspero	rugoso/desnivelado
heterogêneo	diferente/vário
escorregadio	liso/macio
devoto	religioso/piedoso
repentino	rápido/veloz
desinteressante	incolor
manso	tratável
destrutivo	prejudicial/nocivo/daninho/danoso
liso	fino/escorregadio/plano
dúbio	indefinido/impreciso/vago/ambíguo/confuso
rotineiro	ordinário/costumeiro/genérico/comum/geral/usual/habitual
quieto	pacífico/suave
doentio	doente/enfermo/inapropriado
simétrico	paralelo/paralela/regular
acabado	liso/macio
imperfeito	partido
inalterável	permanente/duradouro/constante
azedo	saboroso
afável	amável/simpático/agradável
passional	carinhoso/amoroso/esquentado/quente/emocional/entusiástico/entusiasta
teimoso	inflexível/intratável/desobediente
resignado	paciente
esotérico	privado
reto	virtuoso/nobre/decoroso/digno/inocente/moral/bom/boa/directo/perpendicular/vertical
salgado	saboroso
sobrenatural	irreal
fecundo	potente/frutífero/proveitoso/fértil/produtor/produtivo
apressado	veloz/rápido
proveitoso	fecundo/fértil/útil/produtor/produtivo/favorável/profícuo/vantajoso/propício
barulhento	alta/berrante/alto
remanescente	existente
auspicioso	propício
desconfortável	desassossegado
crível	plausível
tenro	brando/comestível
móbil	movente
inativo	letárgico
sarcástico	crítico/desrespeitoso
fútil	superficial
opaco	confuso
piedoso	virtuoso/digno/nobre/sagrado/devoto/religioso
casual	infrequente
imbecil	lerdo/estúpido
oco	intrusivo/vazio
insuperável	inconquistável/impossível
subalterno	subordinado
infiel	inconstante
aprazível	bonito/formoso/lindo/belo/atraente/humorístico/engraçado/simpático/agradável
obediente	dócil/manipulável/complacente/submisso/tratável/bom/boa
terminado	liso/macio
imutável	permanente/duradouro/constante/estável/plano
atípico	anormal
convergente	oblíquo
inválido	ilegítimo
explicável	compreensível/solúvel
engraçado	aprazível
gentil	amável/simpático/agradável
dispensável	desnecessário
desprezível	indigno
sexy	excitante/emocionante
habilidoso	habilitado/competente/experiente/experimentado
cândido	claro/crédulo
dócil	obediente/tratável
comunicativo	tagarela
desajeitado	estranho/esquisito
inalienável	intrínseco
perpendicular	reto/íngreme
benigno	inofensivo/inócuo/amável
frouxo	lasso
audacioso	bravo/valoroso/valente/afoito/arrojado/corajoso/destemido/aventureiro
indecente	sujo
formoso	gracioso/atraente/aprazível
negligente	imprudente/superficial
audível	alto/berrante/alta
tolo	desaconselhável/imprudente
impreciso	geral/dúbio/ambíguo/confuso
complacente	manipulável/obediente/tratável
canhoto	esquerdo
íngreme	perpendicular/vertical
obstinado	inflexível/intratável/desobediente
gracioso	digno/bonito/formoso/lindo/belo/esbelto/garboso/airoso/elegante/grácil/mimoso/sofisticado
casto	virtuoso/digno/nobre/moral/puro
profícuo	rendoso/lucrativo/proveitoso/propício/oportuno/cómodo
amistoso	congenial/amigável/útil/social/cálido/sociável
airoso	digno/gracioso/grácil/mimoso/sofisticado
tenaz	consciente
diligente	ocupado/prudente/atento
angular	pontudo/quadrado
extrovertido	passado
submisso	manipulável/obediente/tratável
conciso	taciturno
desperto	consciente/alerta/ciente/informado
abominável	malvado/ofensivo
respeitoso	cortês
destemido	audacioso/audaz/bravo/valoroso/valente/afoito/arrojado/corajoso/aventureiro
desnivelado	inseguro/oscilante/áspero
inconsistente	variável
sucinto	taciturno
oblíquo	divergente/convergente/inclinado
textual	exato/preciso/correcto/certo
cortês	respeitoso
avariado	lesionado/ferido/partido
desatento	inconsiderado
varão	masculino/macho
excitado	inquieto
enfermo	doente/adoentado/doentio/insalubre/inapropriado
viril	macho/masculino
carinhoso	passional/amorável/empenhado
significante	importante/significativo
experimentado	grosso/resistente/habilidoso/talentoso
antipático	desagradável/arisco
maléfico	ruim/imoral/ofensivo/incorrecto
recto	virtuoso/nobre/decoroso/digno/inocente/moral/bom/boa
improdutivo	ineficaz/impotente
prolixo	tagarela
insípido	presumido/deselegante
meigo	brando
apetitoso	saboroso
corriqueiro	formal
afortunado	privilegiado/sortudo/próspero/bem-sucedido
afoito	corajoso/destemido/bravo/audaz/audacioso/aventureiro
costumeiro	ordinário/genérico/geral/usual/habitual/comum
descuidado	imprudente/superficial
deselegante	insípido
ineficiente	inútil/vão/incompetente
inconstante	volátil/infiel/instável/precário/variável/mutável
guloso	indulgente
daninho	maligno/ofensivo/desfavorável/ofensiva/desvantajoso/nocivo/destrutivo/árduo/dolorido/doloroso/extenuante/doído/tóxico
inteligível	compreensível
frívolo	superficial
audaz	bravo/valoroso/valente/afoito/arrojado/corajoso/destemido/aventureiro
persuasivo	convincente
habilitado	eficiente/qualificado/talentoso/capaz/habilidoso
sadio	racional
astuto	ágil/alerta/animado/hábil
berrante	audível/ruidoso/barulhento
imprudente	negligente/descuidado/tolo
finito	mortal
inclinado	oblíquo/gradual
malvado	ruim/imoral/incorrecto/agressivo/ofensivo/abominável/violento
frutífero	fecundo/fértil/produtor/produtivo
hirto	sujo
paralela	simétrico/comparável
tangível	concreto
benfeitor	amável
prestável	lhano/serviçal/gentil/afável/amável/útil/cooperativo/encorajador
inapropriado	enfermo/doente/adoentado/doentio/insalubre
indistinto	confuso
esbelto	digno/gracioso/grácil/mimoso/sofisticado/fino
extenuante	prejudicial/nocivo/daninho/danoso/inumano/desumano
imaturo	prematuro/jovem
intratável	desafiador/teimoso/obstinado/silvestre/selvagem/desobediente
ruim	desfavorável/pior/maléfico/mau/má/malvado/desobediente/imoral/ofensivo/incorrecto
valoroso	corajoso/destemido/bravo/audaz/audacioso/aventureiro
silvestre	desobediente/intratável
desaconselhável	imprudente/tolo
oscilante	inquieto/precário/instável/desnivelado
inumano	árduo/dolorido/doloroso/extenuante/doído
inapto	inútil/vão
alienígena	internacional
presumido	insípido
pesaroso	triste/infeliz
incorrigível	desobediente
comestível	digerível/tenro/macio
crédulo	cândido
paranormal	afetado/antinatural
desafiador	intratável/desobediente
danoso	maligno/ofensivo/desfavorável/ofensiva/desvantajoso/nocivo/destrutivo/árduo/dolorido/doloroso/extenuante/doído/tóxico
acídulo	saboroso
taciturno	reservado/sucinto/lacônico/conciso
manipulável	obediente/complacente/submisso/tratável
indolor	inofensivo/inócuo
desmaiado	adormecido
copioso	rico
basto	rico
indulgente	comilão/guloso
rugoso	áspero
bem-sucedido	afortunado/produtor/produtivo
caridoso	liberal
sortudo	afortunado
desvantajoso	prejudicial/nocivo/daninho/danoso
cálido	amigo/amigável/amistoso/emocional
retardado	estúpido/lerdo
garboso	digno/gracioso/grácil/mimoso/sofisticado
rendoso	útil/produtor/produtivo/favorável/profícuo/vantajoso/propício
solúvel	explicável
insalubre	doente/enfermo/inapropriado
infértil	ineficaz/impotente
boa	favorável/obediente/melhor/respeitável/virtuoso/nobre/decoroso/digno/moral/reto/justo/recto/bom
mutável	inconstante
sociável	social/amigo/amigável/amistoso
insano	irracional
incolor	desinteressante/monótono/chato
gregário	social
adoentado	doente/enfermo/inapropriado
substituível	esgotável
judicioso	atento/sábio/prudente/responsável
misericordioso	clemente/amável/humanitário/humano/brando
letárgico	inativo
timorato	receoso/covardemente/covarde/cobarde
tratável	manipulável/obediente/complacente/submisso/dócil/manso
invulnerável	inconquistável/protegido/seguro
penitente	envergonhado
dolorido	prejudicial/nocivo/daninho/danoso/inumano/desumano
tagarela	comunicativo/prolixo
clemente	misericordioso/compassivo
compassivo	clemente/amável/humanitário/humano/brando
desobediente	silvestre/selvagem/ruim/desafiador/incorrigível/teimoso/obstinado/intratável
conspícuo	indiscreto/imprudente
mimoso	civilizado/gracioso/esbelto/garboso/airoso/elegante/exigente
desonroso	falso/errado/corrupto/imoral/injusto/indigno
desrespeitoso	ofensiva/ofensivo/sarcástico
comilão	indulgente
síncrono	sincrônico
sabido	glorioso/familiar
côncavo	intrusivo
frígido	frio
destro	direita/direito
covarde	timorato/receoso
fracionário	incompleto
lauto	rico
arisco	horrível/antipático/ofensivo
desconsiderado	insensível
desassossegado	tenso/desconfortável
sincrônico	síncrono
lasso	solto/frouxo
serviçal	prestável/útil/cooperativo/encorajador
ditoso	feliz/contente
cómodo	favorável/profícuo/vantajoso/propício
antinatural	sobrenatural/paranormal/afetado
intrusivo	côncavo/oco
eriçado	sujo
desencorajante	desesperado
intrincado	árduo/difícil/foda/composto
digerível	comestível
parelho	comparável/mesmo
indemne	intato/seguro/indene
correto	próprio/adequado/conveniente/verdadeiro/preciso/exato/acurado/justo/exacto
correto	lícito/honesto/sincero
entranhado	intenso/intensivo/erudito
realístico	existente/possível/prático
grácil	civilizado/gracioso/esbelto/garboso/airoso/elegante/exigente
cauto	prudente/atento
decoroso	reto/justo/recto/bom/boa/precioso/valioso/honrado
movente	móbil/móvel
vívido	alerta/energético/enérgico/vivo
sonso	lerdo/estúpido
solto	lasso
denotativo	explícito
determinável	calculável
desfalecido	adormecido
assertivo	agressivo
indene	intato/seguro/indemne
inconsiderado	desatento
salubre	bem/saudável
conotativo	implícito
atual	contemporâneo/moderno/novo
acurado	exato/preciso/correcto/correto/justo/certo
esgotável	substituível
amorável	desejável/carinhoso/amoroso/amigável
varonil	macho/masculino
quiet	suave
maturo	velho
calculável	determinável
infrequente	raro/casual/esporádico
inconquistável	inexorável/insuperável/invulnerável
doído	prejudicial/nocivo/daninho/danoso/inumano/desumano
ativo	energético/enérgico/vívido
prestativo	útil/funcional/prático
temporão	primeiro
lerdo	retardado/imbecil/idiota/estúpido/sonso
covardemente	timorato/receoso
lhano	amável/simpático/agradável
aprimorado	utópico/exato/preciso/correcto/certo
pontudo	angular
congenial	amigo/amigável/amistoso/compatível
otimista	vantajoso/positivo
exato	aprimorado/perfeito/textual/literal/acurado/exacto/preciso/correcto/correto/justo/certo
desacordado	adormecido
desgradável	saboroso
coletivo	unido/solidário
esquentado	passional
incônscio	adormecido
