justo	invulnerável/apertado/fiel/exacto/direito/reto/cirúrgico/perfeito/preciso/afinado/certo/exato/recto
construtivo	criativo/estrutural/positivo
inconciliável	inconsistente
insólito	estranho/fantástico/esquisito/singular/diferente/único/curioso/bizarro/gótico
perdoável	venial
cumulativo	cobiçoso/aditivo/sequioso
pasmo	receoso
ascendente	dominante
moral	casto/mental
amarelo	cromático/antigo/velho
consecutivo	contínuo
inconsistente	contraditório/inconciliável/incompatível/discrepante
oportuno	propício/cómodo
infantil	jovem/juvenil/pueril/imaturo
quinhentos	cardinal/cardeal
improdutivo	estéril/infértil
gangrenoso	doente/adoentado/doentio/insalubre
juvenil	infantil/jovem/imaturo
pleonástico	prolixo
corajoso	ousado/animoso/valente/heróico/audaz/audacioso/temerário/intrépido
dócil	tratável
regulável	mutável
complementar	antônimo/aditivo
impessoal	objetivo
avulso	específico
recíproco	bilateral/interativo
inflamatório	doente/adoentado/doentio/insalubre
V	cardinal/cardeal
cooperativo	solidário
concluído	terminado
angelical	amorável/boa
aberrante	anormal
audaz	ousado/aventureiro/heróico/audacioso/temerário/intrépido/bravo/corajoso
frigorífico	frio
mínimo	simbólico/marginal
casual	fácil/isolada/ocasional/irregular/periódico
recente	passado/novo/crocante/estaladiço
flácido	macio/inapropriado
formal	oficial/literário/titular/convencional
partido	incompleto
transtornado	inquieto
vegetativo	involuntário/assexual
ilustre	sabido/conspícuo/saliente/proeminente
amargoso	desagradável
intrépido	audacioso/audaz/bravo/corajoso
prévio	antecedente/passado
mútuo	bilateral/interativo
ruidoso	clamoroso
possível	latente/eventual/atingível/praticável/factível/maneável/executável/manejável/exeqüível/alcançável/realizável
autêntico	verdadeiro/genuíno/legítimo
impudico	sujo
equivocado	desonroso
unidimensional	rectilíneo/linear
oficial	formal/regular/autorizado/estabelecido
desnecessário	prolixo/supérfluo/excessivo
desconcertante	confuso/árduo/difícil/foda/intrincado
tóxico	degradante/pernicioso/virulento/venenoso
conceitual	abstrato
beligerante	malvado
esforçado	diligente
rosa	cromático
sagaz	sábio
noticioso	consultivo/demonstrativo/educativo/explicativo/didático/didáctico/explanatório/consultor
grato	agradecido/apreciativo/obrigado
conflituoso	polémico/controverso/polêmico
afim	relacionado
demoníaco	insano
online	corrente/actual/atual
confortável	suficiente/aliviar/acolhedor/bastante
prudente	minucioso/sábio/circunstanciado/consciencioso
virulento	mortal/tóxico/desagradável
intensificador	exasperante
semicircular	tortuoso/circunflexo
aquiescente	obediente
glauco	opaco
histérico	inquieto
correspondente	similar/relacionado/mesmo/capaz/adequado
mal-educado	indelicado
insensato	tolo
apreciativo	agradecido/grato/gratidão
solto	friável/folgado
relacionado	afim/correspondente/descendente/semelhante
cheio	intocado/estufado
original	primário/primeiro/criativo/fresco/inovador/novo/inventivo/nova/imaginativo
queimado	cozinhado
preliminar	exploratório
semanal	periódico
esperto	astuto
temerário	audacioso/audaz/bravo/corajoso
ziguezagueante	escuso
artístico	estético
termal	quente
inovador	original/progressivo/chique
especificado	específico/nominal/mero
trigésimo	ordinal
pitoresco	bonito/formoso/belo
lastimoso	infeliz
visual	visível
provincial	paroquial/provinciano/rústico
bravo	ousado/indignado/animoso/valente/heróico/lívido/colérico/audaz/feroz/raivoso/audacioso/temerário/furibundo/intrépido
lelé	insano
populoso	inabitado
imaginativo	original/criativo/criador
gótico	estranho/extraordinário/insólito/inusual
rico	afluente
concorrente	síncrono/sincrônico
pequenito	pequeno
cultural	social
infértil	estéril/improdutivo
palaciano	impressionante
devoto	piedoso/religioso
enviesado	inclinado
prata	radiante/brilhante/luminoso
soberbo	orgulhoso
certo	exacto/literal/destinado/justo/perfeito/preciso/correto/afinado/exato/estrito
antecedente	preexistente/prévio/anterior
celular	multicelular
formidável	impressionante/extraordinário
ignoto	inferior
descomunal	grande
conceptual	abstrato
artrítico	doente/adoentado/doentio/insalubre
pesado	maciço/forte/molhado
mandão	dominador
política	governamental
anedótico	comunicativo
pedregoso	áspero
perfeito	infinito/certo/idílico/ideal/implícito/justo/correto/aprimorado/impecável
hilariante	humorístico/engraçado
plausível	argumentável/discutível
pequenino	pequeno
constatável	determinável
modelar	decoroso
humilde	inferior
desigual	desnivelado/assimétrico
célere	rápido/rápida
angélico	amorável/boa
precoce	avançado/nítrico/mirim/primordial/anterior
molhado	aquoso/pluvioso/desleixado/pegajoso/encharcado/pesado/chuvoso/cafona
inócuo	inocente/inofensivo
bilhão	cardinal/cardeal
coerente	persuasivo/adesivo/racional
amoroso	apaixonado/terno/cálido/meigo/enfatuado/carinhoso/afectuoso
irrelevante	tangencial
devasso	imoral/passional/sexy
entendível	compreensível
perfumado	cheiroso/fragrante
mundano	leigo/secular
inclusive	cercado
perceptível	importante
laranja	cromático
fortuito	afortunado
objetivo	comprovável/impessoal
voraz	cobiçoso/comilão/guloso/sequioso
impressionante	efetivo/admirável/majestoso/palaciano/formidável/dramático/nobre/magnífico/fulgurante/heróico/imponente/impo/espectacular/espetacular/surpreendente/eficiente
generoso	liberal/proveitoso/fecundo/frutífero
jeitoso	ágil/alerta/animado/hábil
corrente	real/contemporâneo/actual/hodierno/último/moderno/vigente/atual/online
incómodo	irritante/desconfortável/doloroso
suave	sonoro/baixo/harmonioso
intato	intacto
velho	antediluviano/idosa/senil/amarelo/arcaico/usado/escuro
cabeludo	alarmante/inquietante
retangular	angular/perpendicular
mirim	temporão/precoce/cedo
opressivo	dominador
sinistro	maléfico/má/ruim/malvado
fundamental	basilar/importante/crucial
encorpado	gordo
malicioso	danoso/malevolente/venenoso/malévolo/maldoso/calúnia/malvado
peremptório	definitivo/enfático
circular	cíclico/esférico/global
ameno	simpático
expressivo	comunicativo
vetusto	passado
leigo	mundano/terrestre
arável	produtor/produtivo
incapaz	impotente/inadequado/ineficaz
estupefato	surpreso/surpresa/surpreendido
criminoso	ilegal/culpado
imodesto	orgulhoso
tautológico	prolixo
insalubre	asmático/gangrenoso/patológico/mental/ictérico/inflamatório/espumoso/artrítico/descorado/mórbido
degenerativo	crônico/crónico
colonial	intrincado
típico	verídico/normal/característico/representativo/emblemático/verdadeiro
crocante	fresco/recente
desculpável	justificável
incompreensível	obscuro/misterioso/paradoxal/impenetrável/opaco/misteriosa
duzentos	cardinal/cardeal
oblíquo	diagonal
nenhum	incompleto
flamejante	passional
supérfluo	desnecessário/prolixo
décimo_terceiro	ordinal
covarde	pusilânime
autorizado	oficial
agitado	inquieto
insolente	desrespeitoso
frouxo	folgado/inapropriado
subserviente	subalterno
predador	cobiçoso/sequioso
ditatorial	dominador
refinado	grácil/mimoso
incômodo	irritante/desconfortável/doloroso
frio	glacial/frigorífico/gélido/gelado/ártico
ranço	fedorento/malcheiroso
genial	ágil/alerta/animado/hábil
gostoso	saboroso
mandrião	devagar
preeminente	dominante
correcto	literal/estrito
longínquo	ulterior/remoto/longe/distante
doente	asmático/gangrenoso/frenético/patológico/mental/ictérico/inflamatório/espumoso/delirante/nauseante/artrítico/descorado/tísico/verdejante/diabético/mórbido/vertiginoso/tonto/indisposto
presunçoso	confiante/orgulhoso/contente
carinho	tolo
global	internacional/redondo/amplo/exaustivo/circular/arredondado
prestes	rápido
adicional	secundário/aditivo
luxuriante	gracioso/garboso/airoso/elegante
considerável	grande/apreciável
segundo	ordinal
infiel	adulterino/pérfido/traiçoeiro
oficioso	informal
isolada	raro/casual/esporádico
avermelhado	cromático
agrário	rural
patético	desprezível/sarcástico
realizável	possível
terminal	nefasto/fatal
basilar	fundamental/radical/rudimentar
ébrio	excitado/drogado/orgíaco/tocado/pedrado/entusiasmado/grogue
colossal	grande
acima	alto
argumentável	plausível
todo-poderoso	poderoso
inacreditável	improvável/estarrecedor
imperfeito	humano/defeituoso/irregular
elástico	adaptável/ajustável
esquisito	inusual/sobrenatural/inconformista/insólito/extraordinário/estranho
tonto	frívolo/doente/fútil/enfermo
maldoso	malicioso/danoso/malevolente/venenoso/malévolo/calúnia/malvado/perverso
primário	especial/original
1000	cardinal/cardeal
profundo	intenso/intensivo
inexorável	previsível
experiente	habilidoso/versado/mais_velho/talentoso
pueril	imaturo/infantil
humano	antropóide/civilizado/humanitário/imperfeito/antropomorfo/antropomórfico
inelegível	inadequado/ilegal
satisfeito	orgulhoso/contente
vaidoso	contente
diligente	aplicado/empreendedor/esforçado/operoso/laborioso/trabalhador/assíduo
comilão	voraz
existente	vivente/documental/histórico/real
desenvolto	capaz
futuro	iminente/emergente
indelicado	malcriado/malcomportado/descortês/rude/mal-educado
republicano	democrático
graduável	hierárquico
maldito	maldita/condenado
cereja	cromático
repentino	escarpado/fulminante/íngreme/abrupto
mais_alto	alto
ajustável	elástico/adaptável
arguto	perspicaz
mutável	regulável/instável
psicológico	mental
reprovável	culpado
abstrato	ideológico/esotérico/ideal/conceitual/conceptual
ativo	atlético/rápido/lépido/lesto/ágil/acrobático
iminente	futuro
espetacular	dramático/impressionante
fedorento	ofensivo/bolorento/ruim/rançoso/ranço/fétido/malcheiroso
ancião	sênior
estropiado	inapropriado
asmático	doente/adoentado/doentio/insalubre
aerodinâmica	liso/macio
detestável	ofensivo/abominável
característico	típico/sintomático/distintivo
eufórico	expansivo
formoso	extraordinário/cênico/esplêndido/lindíssimo/fantástico/pitoresco/bonito/precioso/magnífico/deslumbrante/maravilhoso/belo
exeqüível	possível
legendário	sabido
racional	mental/lógico/coerente
singular	inusual/desacompanhado/insólito/extraordinário/estranho
austero	simples
animal	inumano/desagradável/desumano
expansivo	eufórico
lasso	relaxado
séptico	purulento
perpendicular	vertical/ortogonal/retangular/honrado/reto/íngreme
horripilante	alarmante/inquietante
desmazelado	eriçado/hirto
defeso	ilegal
demorado	retardado
negligente	malfeito/desleixado
hilária	humorístico/engraçado
excelente	superior
evocador	consciente
quinzenal	periódico
duradouro	prestativo/estável/permanente/indissolúvel/interminável/perene/eterna/perpétuo/imperecível
agrícola	rural
complicado	foda/difícil/árduo/intrincado
lésbico	homo/gay
lacônico	elíptico/sentencioso/compêndio/sumário/curto/conciso/lacónico/sucinto
filiforme	fino
negro	escuro
prejudicial	difamatório/insidioso/deletério/fraudulento/calunioso/abusivo/infamante/nocivo/daninho/danoso
montanhoso	áspero
alaranjado	cromático
primeira_linha	superior
eleito	eleitoral
nauseante	doente/ofensivo/enfermo
dez_mil	cardinal/cardeal
nonagésimo	ordinal
espesso	gordo/gelatinoso/viscoso
privilegiado	exclusivo/isento
morta	inválido
corpulento	gordo
desleixado	descuidado/negligente/molhado
concreto	sólido/tangível
suficiente	confortável/bastante
fragrante	perfumado/cheiroso
subordinado	secundário/adjunto/assistente
benevolente	amável
senhorial	nobre
inseguro	precário/ambivalente/convulsivo
legítimo	genuíno/legal/autêntico/verdadeiro
escondido	invisível
benéfico	favorável/profícuo/propício
alcoólico	viciado/forte
impotente	incapaz
gelado	frio
caloroso	morna/tépido/morno/tíbio
positiva	favorável/profícuo/propício
efêmero	curto
devido	pagável
literário	formal
acordado	desperto/insone
efémero	curto
cento_e_oitenta	cardinal/cardeal
espumoso	doente/efervescente/adoentado/doentio/insalubre
sinusoidal	tortuoso/circunflexo
furibundo	bravo/irritado
vertiginoso	doente/enfermo
coesivo	adesivo
criminal	culpado
sem-teto	infeliz
ideal	abstrato/aprimorado/perfeito
indigente	pobre
previsto	esperado
sênior	ancião
diagonal	oblíquo
absoluto	inalienável/completo/infinito/implícito/unívoco/integral
abaixo	estabelecido
rude	indelicado
fálico	varão/macho
bastante	confortável/suficiente/torrencial/lauto/fácil/farto/basto/copioso/abundante
mais_velho	experiente/experimentado
subsequente	concomitante/ulterior/resultante/decorrente
refulgente	radiante/brilhante/luminoso
anômalo	anormal/diferente
miraculoso	sobrenatural
semiautomático	automático
inegável	incontestável/irrefutável
alerta	insone/jeitoso/engenhoso/astuto/genial/hábil
agradecido	simpático/apreciativo/grato/obrigado/gratidão
meio	parcial/fracionário
onisciente	sábio
oblíqua	inclinado
permeável	poroso
breve	rápido/curto/rápida
Limpo	asseado
triangular	angular
rústico	provincial
isotônico	tenso
laborioso	intrincado/diligente/foda/difícil/árduo
roxo	cromático
interdependente	dependente
progressivo	progressista/estado-da-arte/inovador/contemporâneo/moderno
desacompanhado	singular/único/única
marrom	cromático
altista	optimista/otimista
sagrado	inviolável/sagrada/espiritual/inefável/bendito/sublime/religioso/santa/santo
garboso	luxuriante/luxuoso
dificil	granítico
glamouroso	emocionante/excitante
nova	original
óbvio	axiomático/franco/transparente/patente/demonstrável/manifesto/evidente
agoniado	pesaroso
predominante	freqüente/frequente
sincrônico	síncrono/coexistente/contemporânea/concorrente/paralelo/moderna/contemporâneo/simultâneo
pirotécnico	extraordinário
malevolente	malicioso/perverso/maldoso
aquático	marinho
significante	monumental/notável
desatento	inconsiderado
curioso	interessado/inusual/insólito/extraordinário/estranho
esmagador	irresistível
rosado	cromático
elétrico	emocionante/excitante
invisível	obscuro/ultravioleta/indetectável/infravermelho/escondido/imperceptível
terciário	ordinal
fulgurante	impressionante
doce	brando
moreno	cromático
valente	bravo/heróico/animoso/afoito/arrojado/brava/corajoso
largo	panorâmico
confiante	segurado/presunçoso/auto-confiante
diáfano	fino
retardado	demorado/idiota/tardio
cabalístico	esotérico
macho	varão/fálico/viril/varonil
onipotente	poderoso
arteiro	irónico/traquinas/sarcástico/irônico
culpável	culpado
ordinal	octagésimo/décima/décimo_quarto/vigésimo_primeiro/vigésimo/décimo_terceiro/terciário/duodécimo/centésimo/1º/sétimo/nono/trigésimo/sexagésima/segundo/décimo_primeiro/quinto/nonagésimo/trigésima/milionésimo/quadragésimo/qüinquagésimo/sexto/sexagésimo/milésimo/sétima/vigésima/décimo_segundo/primeiro/enésimo
tenebroso	escuro
atrapalhado	estranho/esquisito
subjetivo	pessoal/preconceituoso
bonito	extraordinário/cênico/esplêndido/lindíssimo/fantástico/pitoresco/precioso/magnífico/deslumbrante/maravilhoso/formoso/belo
ganancioso	cobiçoso/sequioso
crescido	maturo/maduro
diabético	doente/enfermo
espectacular	impressionante
enrugado	danificado
manco	inapropriado/débil
canceroso	maligno
desalmado	inumano/desumano
existencial	empírico
sobrenatural	maravilhoso/barroco/metafísico/estranho/esquisito/misterioso/extravagante/milagroso/miraculoso/bizarro
simétrico	bilateral/equilibrado/intercambiável
infrequente	ocasional/raro
frenético	doente/inquieto/selvagem/descontrolado/enfermo
idílico	aprimorado/simpático/perfeito
gasoso	vaporoso
anónimo	incógnito/anônimo
fugaz	curto
consciencioso	cautelosa/prudente/atento
intrigante	confuso/interessante
coexistente	síncrono/sincrônico
familiar	informal/conhecido/acostumado
justificável	desculpável
rotineiro	medíocre/cotidiano/banal/indiferente
preconceituoso	subjetivo
determinável	constatável/verificável
deplorável	ruim
contíguo	vizinho/perto
militar	belicoso/marcial/guerreiro
biológico	natural
esplêndido	bonito/formoso/belo
altivo	orgulhoso
adstringente	acídulo/desgradável
precário	inseguro/desassossegado/sísmico/vulcânico
décimo_segundo	ordinal
alternante	cíclico
atlético	ativo
quente	perto/tropical/ígneo/térmico/termal/vizinho/sexy
dorminhoco	adormecido
semelhante	similar/relacionado
gordurento	gordo
impenetrável	incompreensível
enjoativo	ofensivo
corruptível	corrupto
salubre	saudável
recém-nascido	jovem/novo
mestre	habilidoso/talentoso
vernáculo	informal
experimentado	versado/mais_velho
glacial	frio
psicadélico	inquieto/psicotrópico
ciente	sensato/vivo
guerreiro	militar
harmonioso	puro/compatível/sinfônico/consonante/suave
quadragésimo	ordinal
decidido	definitivo
desencorajador	desencorajante
duodécimo	ordinal
chuvoso	molhado
aristocrático	nobre
obsequioso	prestável
amaro	desagradável
feroz	silvestre/inumano/bravo/tempestuoso/intensivo/intenso/desumano/irritado/selvagem/impiedoso
adesivo	coesivo/aderente/tenaz/viscoso/coerente/coeso/colante
pensativo	triste
190	cardinal/cardeal
adorável	amorável
absurdo	tolo
tenro	mastigável/protector/jovem
intacto	indemne/intato/indene
compreensível	abordável/entendível
redondo	esférico/global
rápido	ativo/eficiente/preparado/expresso/alado/instantâneo/célere/breve/pronto/disposto/prestes/rápida
acurado	fiel/cirúrgico
aerodinâmico	liso/macio
sábio	erudito/sagaz/ajuizado/sensato/prudente/onisciente
tardio	póstumo/retardado
comum	democrático/inferior/comunitário/medíocre/informal/crônico/cotidiano/frequente/banal/geral/usual/estatal/habituado/crónico/indiferente/habitual/freqüente/inveterado
multidimensional	dimensional/tridimensional
higiênico	sanitário
desgraçado	desonroso/imoral
forçoso	obrigatório/imprescindível
incomum	extraordinário
novo	original/temporão/passado/virgem/revolucionário/recém-nascido/recente/cedo
dirigente	poderoso
recorrente	contínuo
equilibrado	simétrico/proporcional
perpétuo	contínuo/permanente/duradouro
crepuscular	escuro
atroz	maléfico/alarmante/má/ruim/malvado/inquietante
santo	bendito/sagrada/santa/sagrado
grogue	embriagado/ébrio/bêbedo
íngreme	perpendicular/abrupto/repentino
única	desacompanhado
eletrizante	emocionante/excitante
proibitivo	preventivo
antediluviano	antigo/velho
excessivo	prolixo/desnecessário
neoclássico	clássico
sinótico	mesmo
sentencioso	sucinto/lacônico/conciso/lacónico
coeso	adesivo
hirto	desmazelado/desordenado
atingível	possível
alegórico	representativo
gratidão	agradecido/apreciativo/obrigado
belo	extraordinário/cênico/esplêndido/lindíssimo/fantástico/pitoresco/bonito/precioso/magnífico/deslumbrante/maravilhoso/formoso
fatídico	decisivo
dominador	mandão/tirano/autoritário/opressivo/ditatorial/opressor
congenial	sociável/compatível
confuso	nublado/desconcertante/intrigante/aleatório
antimicrobiano	saudável
frívolo	trivial/informal/tonto/fútil
contemporâneo	chique/moderno/corrente/temporão/progressivo/síncrono/cedo/sincrônico/actual/atual
nítrico	temporão/precoce/cedo
adequado	aceitável/próprio/substancial/apto/decoroso/vitoriano/correspondente/sólido/capaz/apropriado/conveniente
salgado	saboroso
fofa	macio
suicida	perigoso
abrasivo	áspero
admirável	impressionante/aprazível/extraordinário
verdejante	doente/enfermo
incerto	perigoso/indefinido/ambivalente
amedrontado	receoso
lauto	torrencial/fácil/farto/bastante/basto/copioso/abundante
hidrófugo	impermeável
lânguido	letárgico
inadmissível	inaceitável
anônimo	incógnito/anónimo
lívido	bravo/irritado
esguio	pequeno/tênue/magro
imparcial	indiferente
inconquistável	indomável
contagioso	transmissível
estabelecido	abaixo/oficial
paranormal	psíquico
surdo-mudo	surdo
perigoso	alarmante/suicida/traiçoeiro/incerto/insidioso/perigosa/arriscado/desesperador/inquietante
regulamentar	legal
ambicioso	compulsivo/intrincado/foda/difícil/árduo
amplo	espaçoso/panorâmico/grande/plenário/universal/global/vasto/mundial/exaustivo
ambarino	cromático
xenófobo	receoso
imune	isento
abordável	compreensível
beatificação	boa
indisposto	doente/enfermo
acumulativo	cobiçoso/sequioso
digerível	assimilável
galáctico	grande
proficiente	importante
lucrativo	rendoso/económico/rentável/proveitoso
esotérico	arcano/misteriosa/obscuro/místico/abstruso/misterioso/abstrato/recôndito/cabalístico
verdadeiro	indefectível/típico/legítimo/sério/genuíno/autêntico/literal
arenoso	loiro
cronometrado	regular
saboroso	gostoso/acre/amargo/salgado/agridoce/apetitoso/delicioso
terrestre	leigo/secular
imbecil	fátuo/burro/idiota/sonso/estúpido
500	cardinal/cardeal
hostil	inóspito
sexagésima	ordinal
ensanguentado	sangrento
rudimentar	basilar
vertical	erétil/perpendicular/ortostático/honrado/fio_de_prumo
sintético	artificial
valioso	decoroso/equivalente/magnífico/inestimável/precioso/opulento
injusto	sujo
protector	tenro/meigo
voluptuoso	indulgente
pesaroso	agoniado/fúnebre/lúgubre/amargo/lutuoso
drogado	embriagado/ébrio/bêbedo
pedante	erudito
singelo	simplístico
pegajoso	molhado
quatrocentos	cardinal/cardeal
lúgubre	pesaroso/triste
relutante	desafiador
escuso	torcido/torto/ziguezagueante
francófono	comunicativo
ofensivo	injurioso/desgostoso/fedorento/insuportável/terrível/malcheiroso/nauseante/desagradável/nojento/repugnante/detestável/odioso/enjoativo
organizado	metódico
negativo	destrutivo/desvantajoso
oleoso	gordo
hodierno	corrente/actual/atual
marginal	minimum/mínimo
farto	torrencial/abundante/copioso/bastante/lauto/proveitoso/fecundo/frutífero/fácil
marinho	aquático
aleatório	confuso/atabalhoado/estocástico
magro	tênue/cadavérico/anoréxico/esguio/delgado/franzino/fino
ganhador	próspero/bem-sucedido
optimista	altista/alegre
desolado	inóspito/inconsolável
contemporânea	sincrônico/síncrono
multinacional	internacional
imprevisto	inesperado
invejável	desejável
proporcional	equilibrado
afável	amigo/amigável/amistoso/amável/gentil/lhano
1º	ordinal
comutativo	independente
maciço	pesado
virgem	novo/casta/puro/casto/castiço
assistente	subordinado
morna	caloroso
pérfido	infiel
interessante	decoroso/recreativo/fascinante/intrigante/absorvente/entretido
mesmo	equivalente/sinótico/correspondente/idêntico/comparável
nefasto	terminal/fatal/mortal/letal
merecedor	decoroso
canônico	ortodoxo
sincero	sério
científica	tecnológico
invulnerável	justo/intocável/defensável/apertado/inatacável/inviolável
trágico	triste
apreciável	considerável
setentrional	nórdico/azul/federal/nortista
síncrono	coexistente/contemporânea/concorrente/paralelo/sincrônico/moderna/contemporâneo/simultâneo
particular	específico
esbranquiçado	acromático/opaco
errôneo	errado/incorreto
documental	existente
barata	pagável
figurativo	tropical/metafórico/poético/analógico
limitado	moderado
consultor	noticioso/informativo
difuso	prolixo
staccato	chocante/inopinado
disponível	descartável/comprável/adquirível/visível
necessário	requerido/imprescindível/indispensável/obrigatório
entusiasmado	embriagado/louco/nervoso/ébrio
abominável	alarmante/execrável/maléfico/odioso/detestável/má/ruim/malvado/inquietante
franco	evidente/óbvio
relaxado	lasso
desvantajoso	negativo
acrobático	ativo
faiscante	radiante/brilhante/luminoso
emocionante	elétrico/glamouroso/glamoroso/prestigioso/eletrizante
egoísta	orgulhoso
caloso	resistente/grosso
alérgico	suscetível/susceptível
temível	inquietante/alarmante
importuno	suplicante
deslumbrante	radiante/bonito/brilhante/luminoso/formoso/belo
áspero	abrasivo/montanhoso/anguloso/rochoso/acidentado/desagradável/pedroso/pedregoso
suplementar	secundário/aditivo
diminuto	fino/pequeno
profano	secular/laico
anémico	débil
abandonado	irrestrito/inabitado/desabitado
impiedoso	feroz/mortal
consumado	habilidoso/talentoso
limpo	imaculado
penetrante	perspicaz
atempado	apropriado
massudo	grande
requerido	necessário
gordo	sujo/gorducho/oleoso/pançudo/corpulento/viçosa/rechonchudo/roliço/gordurento/grosso/gorduroso/espesso/abdominal/encorpado
obrigado	agradecido/grato/gratidão
guloso	voraz
sucinto	elíptico/sentencioso/compêndio/sumário/curto/lacônico/conciso/lacónico
bilateral	simétrico/recíproco/mútuo
étnico	social
inalienável	intransmissível/absoluto/inviolável
pagável	devido/barata
estatal	comum
poderoso	dirigente/forte/influente/constrangedor/todo-poderoso/onipotente
dominante	supremo/ascendente/primordial/preeminente
indiscreto	imprudente
quíntuplo	múltiplo
diário	periódico
determinante	decisivo
curativo	saudável
comercial	inferior/mercantil
c	cardinal/cardeal
radical	basilar
inigualável	incomparável
quedo	imóvel
bombástico	retórico
estéril	inóspito/infértil/improdutivo
aventureiro	arriscado/ousado/audaz/audacioso
influente	possante/importante/prestigioso/poderoso
extrajudicial	ilegal
informado	sensato/vivo
eleitoral	eleito
lhano	afável/amável
audacioso	aventureiro/ousado/heróico/temerário/intrépido/audaz/bravo/corajoso
intolerável	inaceitável/insuportável/amargo
antropomorfo	humano
imperceptível	invisível
vistoso	insípido
160	cardinal/cardeal
supersticioso	irracional
acinzentado	acromático
asseado	Limpo
exploratório	preliminar
plano	horizontal
natural	biológico/biológica/normal
estético	artístico/cosmético
autônomo	independente/livre/involuntário
permanente	irreversível/indissolúvel/interminável/perene/eterna/perpétuo/imperecível/duradouro
moderno	corrente/progressivo/chique/contemporâneo/actual/atual
predisposto	inclinado
centésimo	ordinal
culpado	censurável/punível/criminoso/criminal/reprovável/repreensível/culpável/passível
lotado	intocado/estufado
intocável	invulnerável
faminto	esfomeado/desnutrido
seletivo	exclusivo/discriminatório
conspícuo	proeminente/importante/ilustre
luxuoso	gracioso/garboso/airoso/elegante
indulgente	favorável/permissivo/decadente/voluptuoso
prestativo	duradouro/funcional/utilizável/durável/usável/duradoiro
excitante	elétrico/glamouroso/glamoroso/prestigioso/eletrizante
um_mil	cardinal/cardeal
arriscado	alarmante/aventureiro/perigoso/inquietante
milagroso	sobrenatural
milésimo	ordinal
inexplicável	misterioso/paradoxal/misteriosa
periódico	raro/cíclico/semanal/diário/trienal/quinzenal/trianual/casual/esporádico
borbulhante	efervescente
empreendedor	empresarial/diligente
responsável	refutável/sujeito/fidedigno
baio	cromático
despercebido	esquecido
incremental	aditivo
apertado	justo/invulnerável
operoso	diligente
estocástico	aleatório
fechado	restrito/comprimido/cercado
passado	recente/vetusto/histórico/anterior/antigo/último/medieval/novo/prévio/antiga
severo	intenso/intensivo
senil	velho
levado	ruim
dramático	espetacular/impressionante/melodramático
unido	confederativo/unitário/combinado/determinado/aliado/integrado
cavernoso	oco/vazio
cúbico	tridimensional/isométrico
opressor	dominador
esticado	tenso
partidário	favorável
devotado	dedicado
sinuoso	tortuoso/circunflexo
autoritário	dominador
alternativa	cíclico
malévolo	malicioso/perverso/maldoso
trezentos	cardinal/cardeal
abundante	torrencial/lauto/fácil/farto/bastante/basto/copioso
pasmado	receoso
triunfante	próspero/bem-sucedido
utópico	visionário
vário	diverso
pomposo	presumido
educativo	noticioso
assassinado	morto
risível	tolo
cauteloso	moderado
gratificante	aprazível
secundário	subordinado/alternativo/colateral/adicional/suplementar
refletivo	vazio
predileto	popular
fecundo	produtor/prolífico/generoso/farto/produtivo
imperecível	permanente/duradouro
pontual	tempestivo
auto-suficiente	independente
cruel	inumano/desumano
salutar	saudável
infernal	desagradável/maléfico/má/ruim/malvado
mentiroso	falso/errado
propício	benéfico/preferencial/positiva/oportuno/positivo/boa/favorável/discriminatório
penitente	penitencial
último	passado/improvável/corrente/actual/atual
maligno	canceroso
solteiro	divorciado
fatal	nefasto/terminal/mortal/letal
malcomportado	indelicado
normal	medíocre/típico/cotidiano/média/banal/natural/indiferente
impeditivo	preventivo
mil	cardinal/cardeal
consultivo	noticioso/informativo
libidinoso	sexy
crucial	fundamental/importante/decisivo
apático	letárgico
místico	esotérico
panorâmico	largo/amplo
imprescindível	necessário/obrigatório/indispensável/forçoso/compulsório/vital
exaustivo	amplo/completo/plenário/universal/global/mundial/integral
mundial	internacional/amplo/exaustivo
enfatuado	carinhoso/afectuoso/amoroso
aplicável	relevante/pertinente
idiota	retardado/fátuo/burro/imbecil/sonso/estúpido
carinhoso	apaixonado/terno/cálido/meigo/enfatuado/afectuoso/amoroso
estrangeiro	internacional/estranho
compulsivo	ambicioso
específico	especificado/circunstancial/ad_hoc/nominal/mero/especial/particular/avulso/Ad-hoc/próprio/peculiar
alienígena	internacional
progressista	progressivo/chique/liberal
maternal	materno
incolor	pálido
contrário	antônimo/malvado
segurado	confiante
quádruplo	múltiplo
dedicado	devotado
sétimo	ordinal
fantástico	inusual/bonito/insólito/extraordinário/estranho/formoso/belo
separável	divisível
fervoroso	entusiástico/entusiasta
rentável	rendoso/lucrativo/proveitoso
tépido	caloroso
coletivo	solidário/socialista
vívido	vivo
terapêutico	saudável
desesperador	perigoso
fúnebre	pesaroso
homo	lésbico/bicha/transsexual/gay
estaladiço	fresco/recente
anoréxico	tênue/magro
espiritual	sagrado/imaterial
azul	setentrional/cromático/boreal
cândido	crédulo/ingénuo
tridimensional	cúbico/multidimensional/isométrico
transcontinental	continental
horrendo	triste
verificável	determinável
eficiente	rápido/impressionante/habilitado/económico/competente
dinâmico	cinético
indolor	fácil
procedente	relevante/pertinente
anglófono	comunicativo
pornográfico	sexy
substantivo	significativo
judicial	legal
afortunado	sortudo/fortuito/contente/boa
imaculado	puro/limpo
saibro	acromático
poético	retórico/figurativo
friável	solto
boreal	azul/federal
nojento	ofensivo
quantificável	quantitativo
durável	prestativo
abstruso	esotérico
eminente	alto
cardeal	c/160/500/cem_mil/dez_mil/bilhão/quarenta/mil/trilhão/5/uno/duzentos/cento_e_oitenta/trezentos/noventa_e_nove/quatrocentos/cento_e_sessenta/190/180/quinhentos/um_mil/1000/2/V/cinco
discriminatório	discriminativo/favorável/eclético/selectivo/seletivo/profícuo/propício
informal	ordinário/frívolo/familiar/vernáculo/Vernáculo/comum/coloquial/oficioso/fútil
verde-azeitona	cromático
assimilável	digerível
sadio	lúcido
aderente	adesivo
compulsório	obrigatório/imprescindível
nominal	específico/especificado
impressionável	suscetível/susceptível
viscoso	adesivo/espesso
inadequado	inelegível/insuficiente/incapaz
tênue	cadavérico/anoréxico/magro/esguio/delgado/franzino/fino
esbanjador	destrutivo
exasperante	intensificador
encardido	sujo
subalterno	feudal/subserviente
agridoce	triste/saboroso
solidário	coletivo/cooperativo
personalizado	pessoal
lilás	cromático
estofado	adornado
nebuloso	triste
bem-sucedido	produtivo/vitorioso/próspero/triunfante/viçoso/ganhador
assíduo	diligente
convexo	biconvexo
destacado	superior
intransigente	inflexível
exímio	superior
anacrônico	assíncrono
indissolúvel	permanente/duradouro
significativo	comunicativo/monumental/notável/substantivo/substancial
aveludado	liso/macio
casto	moral/virgem/virginal
pusilânime	covardemente/covarde/cobarde
estrito	exato/preciso/correcto/certo
avançado	precoce/alto/dianteiro
vigésimo	ordinal
ininterrupto	contínuo
sequioso	voraz/predatório/possessivo/cumulativo/avaro/ávido/ganancioso/acumulativo/predador
irrefutável	inegável
bifocal	central
jovem	recém-nascido/terno/pequeno/juvenil/cedo/infantil/pré-adolescente/temporão/tenro
classificado	categorizado
espaçoso	amplo
penal	ilegal
arcano	esotérico
facultativo	opcional
deslizante	escorregadio
selvagem	feroz/delirante/frenético/fero
interdito	ilegal
conciso	elíptico/sentencioso/compêndio/sumário/sucinto/curto/lacônico/lacónico
diferente	anômalo/antitético/sortido/distinto/diverso/divergente/estranho/inusual/insólito/extraordinário
controverso	discutível/polémico/conflituoso/polêmico
desencorajante	desencorajador/desalentador
mental	doente/moral/psicológico/racional/psíquico/adoentado/doentio/insalubre
impecável	aprimorado/nobre/perfeito
funcional	prestativo/prático/estrutural
brioso	nobre
adulterino	infiel
pronto	rápido
humorístico	hilária/sutil/irônico/engraçado/espirituoso/jocoso/hilariante/cômico
ilícito	ilegal/extraconjugal
improvável	incrível/último/inacreditável
amargo	saboroso/intolerável/pesaroso/desagradável/insuportável
intangível	imaterial
ensurdecedor	tempestuoso/berrante/alto
desnutrido	faminto
secular	profano/mundano/terrestre
afluente	rico
aliviar	confortável
próspero	produtivo/vitorioso/triunfante/viçoso/ganhador/bem-sucedido
anormal	defeituoso/anômalo/aberrante/irregular
exclusivo	privilegiado/selectivo/seletivo
completo	exaustivo/absoluto/inteiro/integral
empinado	alto
fervente	entusiástico/entusiasta
irônico	humorístico/brincalhão/engraçado/arteiro
minucioso	cautelosa/prudente/atento
lúcido	são/sadio
tenso	nervoso/isotônico/esticado/irritável
perene	contínuo/permanente/duradouro
sonoro	suave
multicelular	celular
orgulhoso	satisfeito/imodesto/presunçoso/ranhoso/imperioso/egoísta/altivo/ufano/soberbo/arrogante
intenso	puro/profundo/sensasional/forte/brutal/esmero/severo/terrível/veemente/maior/feroz/intensivo
emergente	futuro
gracioso	elegante/luxuriante/fluente/luxuoso/fluido
medonho	inquietante/alarmante
barroco	sobrenatural
visível	visual/aberto/disponível/microscópico
intrincado	frustrante/complicada/ambicioso/controvertido/tortuoso/difícil/sensitivo/labiríntico/laborioso/desafiador/desconcertante/complicado/problemático/espinhoso/colonial
delgado	tênue/magro
crédulo	cândido
plenário	amplo/exaustivo
evidente	definitivo/axiomático/franco/transparente/patente/demonstrável/óbvio/manifesto
quinto	ordinal
gélido	frio
alto	ensurdecedor/magestoso/mais_alto/alto_nível/derradeiro/empinado/acima/grande/vocal/avançado/capitanear/superior/eminente
reto	direito/perpendicular/justo
terno	jovem/árduo/dolorido/doloroso/extenuante/doído/carinhoso/afectuoso/amoroso
punível	culpado
equivalente	precioso/parelho/mesmo/idêntico/análogo/valioso
intensivo	profundo/sensasional/forte/brutal/esmero/severo/terrível/veemente/intenso/maior/feroz
eqüidistante	parelho/idêntico/análogo
escancarado	aberto
meigo	protector/carinhoso/afectuoso/amoroso
ad_hoc	específico
azul-petróleo	cromático
coral	cromático
integrante	intrínseco
cadavérico	tênue/magro
decadente	indulgente
insidioso	prejudicial/perigoso/nocivo/daninho/danoso
censurável	culpado
danoso	malicioso/difamatório/insidioso/deletério/prejudicial/fraudulento/calunioso/abusivo/infamante/perverso/maldoso/nocivo/daninho
vigente	corrente/actual/atual
inapropriado	ruim/manco/incongruente/mole/deficiente/brando/estropiado/aleijado/fofo/flácido/perneta/frouxo
cedo	jovem/nítrico/mirim/contemporâneo/novo/primordial/primitiva/anterior
amistoso	social/amável/afável
mimoso	refinado/cultivado/gentil
aliado	unido
demonstrativo	noticioso
inestimável	precioso/valioso
marcial	militar
inutilizável	inapto/inútil/impróprio
incógnito	anónimo/anônimo
testável	empírico
nobre	impressionante/imperial/impecável/brioso/senhorial/aristocrático/sublime/real
bendito	sagrada/santa/sagrado/santo/contente
sintomático	característico
cozinhado	queimado/Saltear/saltear
penitencial	penitente
ruivo	cromático
decoroso	próprio/precioso/modelar/modelo/interessante/merecedor/exemplar/valioso/notável/adequado/conveniente
obediente	condescendente/aquiescente
recto	direito/justo
covardemente	pusilânime
torto	escuso/assimétrico
apaixonado	carinhoso/afectuoso/amoroso
esperável	esperado
pragmático	prático/realístico
sem-abrigo	infeliz
inconformista	esquisito/alternativo/bizarro/estranho
avaro	cobiçoso/sequioso
paralelo	síncrono/sincrônico
acídulo	cortante/adstringente/acerbo/picante
minúsculo	pequeno
vizinho	contíguo/acalorado/quente/calmoso/junto/perto
inventivo	original/capaz/criativo/criador
privado	pessoal/confidencial
condenado	maldita/maldito
excepcional	extraordinário/superior
insuficiente	inadequado
presumido	insípido/pomposo
interativo	recíproco/mútuo
poroso	permeável
tendencioso	parcial
defensável	invulnerável
virginal	puro/casta/casto/castiço
fusiforme	pontudo
arcaico	antigo/velho
rígido	imóvel/inflexível
infamante	imoral/prejudicial/nocivo/daninho/danoso
habilitado	capaz/eficiente
fracionário	fragmentário/meio/metade
alarmante	ameaçador/abominável/macabro/arriscado/horripilante/medonho/calamitoso/ominoso/terrível/pavoroso/temível/cabeludo/atroz/perigoso
sapiente	erudito
áureo	cromático/metálico
imaterial	espiritual/intangível
daninho	difamatório/insidioso/deletério/prejudicial/fraudulento/calunioso/abusivo/danoso/infamante
espantoso	surpreendente
varonil	macho
encarnado	cromático
casadoiro	maturo/maduro
reluzente	radiante/brilhante/luminoso
contínuo	perene/consecutivo/constante/recorrente/perpétuo/ininterrupto
errado	incorrecto/mentiroso/falaz/errôneo
falador	comunicativo
brando	doce/inapropriado
ermo	triste
inacessível	distante
astronômico	grande
defeituoso	anormal/imperfeito
estado-da-arte	progressivo
condescendente	obediente
primeiro	original/ordinal/arquetípico/inicial
quarenta	cardinal/cardeal
falaz	errado/incorreto
decimal	quantitativo
adquirível	disponível
cautelosa	minucioso/circunstanciado/consciencioso
intercambiável	substituível/simétrico
lácteo	opaco
determinado	unido
magnífico	precioso/impressionante/superior/extraordinário/bonito/boa/valioso/formoso/belo
hesitante	perplexo
inocente	irrepreensível/inócuo/inofensivo
antecipado	esperado
contente	animador/bendito/afortunado/alegre/radiante/presunçoso/vaidoso/satisfeito/animado
económico	rendoso/parcimonioso/eficiente/lucrativo/proveitoso
exigente	cuidadoso
inclinado	propenso/oblíqua/predisposto/enviesado/tendente
cento_e_sessenta	cardinal/cardeal
sexto	ordinal
inóspito	desolado/hostil/estéril
laico	profano
cinza	acromático
cinco	cardinal/cardeal
divergente	diferente
tinhoso	ávido
erótico	sexy
iconoclástico	destrutivo
retórico	poético/bombástico/forense/oratório
resultante	subsequente/ulterior
estatutário	legal
cênico	bonito/formoso/belo
puro	harmonioso/imaculado/intenso/virginal/impoluto/virgem/castiço
incorrecto	repreensível/errado/enganado
capitanear	alto
traiçoeiro	perigoso/infiel
anêmico	débil
Saltear	cozinhado
eriçado	desmazelado/desordenado
livre	definido/autônomo/independente
controvertido	árduo/difícil/foda/intrincado
acerbo	acídulo/desagradável/desgradável
massivo	grande
serviçal	prestável/direito
pontudo	fusiforme/piramidal/pontiagudo
tenaz	adesivo/teimoso/obstinado
bucólico	rural
imóvel	rígido/estacionário/estático/quedo
honrado	perpendicular/augusto/fio_de_prumo/vertical
esquerdista	liberal
célebre	sabido
atento	absorto/consciente/minucioso/solícito/circunstanciado/consciencioso
cómodo	oportuno
alisado	bidimensional
alado	rápido/rápida
adormecido	sonolento/dorminhoco
maior	grande/intenso/intensivo/maturo/maduro
tangível	concreto
antropomórfico	humano
enganador	desonroso
isométrico	cúbico/tridimensional
macabro	alarmante/inquietante
amigável	bem-intencionado/social/amável/favorável/afável
crónico	ordinário/degenerativo/costumeiro/genérico/comum/geral/usual/habitual
combinado	unido
idêntico	proporcionado/equidistante/mesmo/equivalente/eqüidistante/congruente
efetivo	impressionante
salvo	indene/indemne
lícito	legal
ideológico	abstrato
concomitante	subsequente/ulterior
tácito	implícito
letal	nefasto/fatal
fio_de_prumo	vertical/honrado
calamitoso	inquietante/alarmante
nefando	maléfico/má/ruim/malvado
estático	imóvel
tempestivo	pontual
medíocre	normal/inferior/ruim/ordinário/comum/costumeiro/rotineiro
sumário	sucinto/lacônico/conciso/lacónico
nono	ordinal
surpresa	estupefato
viciado	alcoólico/dependente
ansioso	ávido
difamatório	prejudicial/nocivo/daninho/danoso
solícito	atento
iridescente	radiante/brilhante/luminoso
permissivo	indulgente
impraticável	romântico
materno	maternal
traumático	árduo/dolorido/doloroso/extenuante/doído
eterna	permanente/duradouro
transsexual	homo/gay
viçoso	próspero/bem-sucedido
preexistente	antecedente
tirano	dominador
geral	comum/crônico/usual/habituado/crónico/habitual/inveterado
incongruente	incompatível/discrepante/inapropriado
sólido	concreto/adequado/boa
cuidadoso	exigente
alcançável	possível
derradeiro	alto
superior	alto/brilhante/destacado/seleto/magnífico/primordial/fino/excepcional/excelente/extraordinário/fabuloso/luzente/exímio/primeira_linha
tagarela	conversador
irreversível	permanente
irresistível	esmagador
gentil	grácil/afável/cortês/amável/mimoso
governamental	política
mortal	virulento/nefasto/fatal/impiedoso
sensível	vivo/excitável/árduo/dolorido/doloroso/extenuante/doído
vaporoso	gasoso
viçosa	gordo
louco	entusiasmado/tolo/insano/excitado
estonteante	surpreendente/extraordinário
antiácido	incompatível
freqüente	habitual/comum/predominante
maduro	adulto/outonal/casadoiro/maior/núbil/crescido/maturo
heróico	audacioso/impressionante/grande/valente/afoito/arrojado/brava/audaz/bravo/corajoso
representativo	típico/alegórico/simbólico
manipulável	administrável/controlável/governável
tolo	carinho/risível/inane/insensato/louco/néscio/maluco/absurdo/demente
prateado	acromático/radiante/brilhante/luminoso
tortuoso	semicircular/sinusoidal/sinuoso/curvilíneo/intrincado
acalorado	perto/vizinho
incompleto	partido/parcial/metade/nenhum
lascivo	sexy
esverdeado	cromático
indeciso	débil
tradicional	convencional/ortodoxo
brincalhão	irónico/traquinas/sarcástico/irônico
clássico	neoclássico
hipócrita	religioso/piedoso
ágil	ativo/jeitoso/engenhoso/astuto/genial/hábil
fútil	trivial/frívolo/informal/tonto/inapto/inútil/impróprio
sujeito	responsável/afetado
loiro	arenoso
comprável	disponível
biológica	natural
maldita	condenado/maldito
inesperado	imprevisto
esperado	previsto/esperável/antecipado
duro	pobre/granítico
venial	perdoável
decisivo	definitivo/conclusivo/fatídico/determinante/importante/crucial
preocupado	desassossegado
letárgico	apático/indiferente/lânguido
demente	tolo
desejável	invejável
hispanófono	comunicativo
copioso	torrencial/lauto/fácil/farto/bastante/basto/abundante
Vernáculo	informal
feudal	subalterno
usado	antigo/velho
jocoso	humorístico/engraçado
pedroso	áspero
desabitado	abandonado
inabitado	povoado/populoso/abandonado
sério	importante/real/sincero/genuíno/verdadeiro
preferencial	favorável/profícuo/propício
consciente	atento/evocador/nostálgico/sugestivo
relevante	pertinente/aplicável/procedente
indemne	intacto/salvo
consonante	harmonioso
colante	adesivo
divorciado	solteiro
supremo	dominante/definitivo
fofo	inapropriado/macio
conveniente	prático/próprio/capaz/favorável/decoroso/vitoriano/apropriado/adequado
fragmentário	parcial/fracionário
suplicante	importuno
tecnológico	científico/científica
estufado	cheio/pleno/lotado
fraudulento	prejudicial/nocivo/daninho/danoso
manejável	possível
ameaçador	alarmante/inquietante
encantador	desonroso
maleável	tratável
explicativo	noticioso
tangencial	irrelevante
imenso	grande
descartável	líquido/usável/disponível/utilizável
resistente	desafiador/caloso
ocasional	imprevisível/raro/infrequente/casual/esporádico
religioso	piedoso/hipócrita/sagrado/devoto
turístico	popular
banal	rotineiro/costumeiro/comum/ordinário/normal
tíbio	caloroso
preparado	rápido
cem_mil	cardinal/cardeal
descorado	doente/adoentado/doentio/insalubre
robusto	forte
franzino	tênue/magro
frugal	parcimonioso
habituado	costumado/usual/geral/comum/habitual/genérico/costumeiro/ordinário
gorduroso	gordo
oco	cavernoso/tubular
inane	tolo
revolucionário	novo
circunflexo	semicircular/sinusoidal/sinuoso/curvilíneo
verídico	típico
pré-adolescente	jovem
brutal	intenso/inumano/desumano/intensivo
sexagésimo	ordinal
noventa_e_nove	cardinal/cardeal
lindíssimo	bonito/formoso/belo
obstinado	tenaz/porfiado/teimoso
sinfônico	harmonioso
transparente	fino/evidente/óbvio
média	normal
mole	inapropriado/macio
assimétrico	desigual/torto
genuíno	verdadeiro/sério/autêntico/legítimo
nuclear	central
pardo	cromático
prestigioso	influente/emocionante/excitante
enjoado	triste
prolixo	difuso/pleonástico/excessivo/supérfluo/desnecessário/tautológico
estrutural	construtivo/funcional
horizontal	plano
móvel	portátil/movente
oposto	malvado
integral	intrínseco/exaustivo/completo/absoluto/inteiro
diagnosticável	identificável
nervoso	tenso/entusiasmado/excitável/excitado
imponente	impressionante
especular	meditabundo
escrito	gráfico
metafísico	sobrenatural
automático	mecânico/semiautomático/involuntário
modular	padrão
destinado	certo
sortido	diferente/heterogêneo
elíptico	sucinto/lacônico/conciso/lacónico
afirmativo	positivo
desprezível	patético/maléfico/abjeto/má/ruim/malvado
venenoso	malicioso/tóxico/perverso/maldoso
estacionário	imóvel
prático	conveniente/pragmático/realístico/funcional
único	incomparável/inusual/desacompanhado/insólito/extraordinário/estranho
convulsivo	inseguro/oscilante
nortista	setentrional
recebido	corriqueiro/convencional
aurífero	metálico
especial	primário/extraordinário/específico
boa	satisfatório/angelical/afortunado/favorável/magnífico/sólido/beatificação/aceitável/angélico/profícuo/propício
minimum	simbólico/marginal
governável	manipulável
evangélico	entusiástico/entusiasta
pálido	incolor
fenomenal	extraordinário
mirabolante	insípido
criativo	construtivo/original/inventivo/imaginativo/criador
esquecido	despercebido
instantâneo	rápido/rápida
proverbial	sabido
ruim	levado/inferior/maléfico/sinistro/vil/inapropriado/deplorável/medíocre/atroz/apavorante/terrível/nefando/lamentável/fedorento/desprezível/infernal/abominável/má/malvado
microscópico	pequeno/visível
desonesto	corrupto
recôndito	esotérico
patológico	doente/adoentado/doentio/insalubre
auto-confiante	confiante
selectivo	exclusivo/discriminatório
antiga	passado
intransmissível	inalienável
didático	noticioso
resoluto	definitivo
comprimido	fechado/compressível
polido	terminado
escuro	tenebroso/triste/velho/crepuscular/negro/morena
moderna	sincrônico/síncrono
ártico	frio
possante	influente
moderado	modesto/limitado/cauteloso/razoável/pequeno
controlável	manipulável
purulento	séptico
modelo	decoroso
calunioso	prejudicial/nocivo/daninho/danoso
barulhento	clamoroso
cortante	acídulo/desgradável
discriminativo	discriminatório
ofendido	árduo/dolorido/doloroso/extenuante/doído
científico	tecnológico
lodoso	escorregadio
imperial	nobre
divisível	separável
repugnante	ofensivo
empírico	confirmável/existencial/experimental/testável
misteriosa	esotérico/incompreensível/inexplicável
inferior	modesto/brega/comercial/lamentável/medíocre/comum/ruim/ignoto/humilde/pequeno
métrico	rítmico
passível	culpado
5	cardinal/cardeal
factível	possível
produtivo	próspero/cultivável/prolífico/arável/proveitoso/fecundo/frutífero/bem-sucedido
apropriado	atempado/próprio/capaz/adequado/conveniente
abusivo	prejudicial/nocivo/daninho/danoso
uno	cardinal/cardeal
torcido	escuso
berrante	ensurdecedor/grande/vocal
anti-helmíntico	saudável
surpreendente	impressionante/estonteante/espantoso
bicha	homo/gay
questionável	solúvel
calmoso	perto/vizinho
vitorioso	próspero/bem-sucedido
nulidade	inapto/inútil/impróprio
isento	privilegiado/imune
ortostático	vertical
movente	cinético/móvel
desastroso	infeliz
sujo	injusto/sórdido/encardido/obsceno/ranhoso/gordo/impudico
malvado	sinistro/contrário/malicioso/vil/atroz/ruim/nefando/oposto/desprezível/infernal/beligerante/abominável/perverso/maldoso
regional	territorial
ortogonal	perpendicular
misto	heterogêneo
convencional	ortodoxo/recebido/tradicional/habitual/formal
má	sinistro/vil/atroz/ruim/nefando/desprezível/infernal/abominável
razoável	moderado
vacante	vazio
doméstica	nacional/autárquico/municipal
sonolento	adormecido
castanho	cromático
vazio	cavernoso/tubular/refletivo/vacante/desocupado
susceptível	moldável/impressionável/alérgico/hipersensível
erétil	vertical
discutível	polêmico/plausível/contestável/controverso/polémico
escorregadio	lodoso/deslizante
real	sério/corrente/existente/nobre/actual/atual
manifesto	óbvio/evidente
inatacável	invulnerável
fluido	líquido/gracioso
teimoso	tenaz/porfiado/obstinado
tubular	vazio/oco
rápida	expresso/alado/instantâneo/célere/breve/rápido
sonso	idiota/fátuo/burro/imbecil/estúpido
equidistante	parelho/idêntico/análogo
estável	duradouro
argênteo	metálico/radiante/brilhante/luminoso
assertivo	enfático
inaceitável	inadmissível/insuportável/intolerável
lacónico	elíptico/sentencioso/compêndio/sumário/sucinto/curto/lacônico/conciso
nostálgico	consciente
foda	frustrante/complicada/ambicioso/controvertido/difícil/sensitivo/laborioso/desafiador/desconcertante/complicado/problemático/espinhoso
décima	ordinal
provinciano	provincial
indefinido	incerto
enganoso	desonroso
perplexo	hesitante/nublado
momentâneo	curto
cativante	aprazível
malandro	corrupto
apetitoso	saboroso
cortês	gentil
usual	crônico/costumado/habituado/geral/comum/crónico/habitual/genérico/costumeiro/ordinário/inveterado
estranho	inusual/sobrenatural/inconformista/atrapalhado/artificial/fantástico/esquisito/singular/diferente/único/curioso/bizarro/desajeitado/estrangeiro/insólito/extraordinário/gótico
veemente	forte/intensivo/intenso
parcimonioso	económico/frugal
respeitoso	honorífico/deferente
identificável	classificável/diagnosticável
cultivável	produtor/produtivo
ávido	ansiosa/entusiástico/cobiçoso/tinhoso/ansioso/sequioso/entusiasta
inapto	nulidade/inutilizável/inútil/fútil
perto	vizinho/contíguo/acalorado/quente/calmoso/junto
extraordinário	bonito/superior/fenomenal/incomum/estranho/pirotécnico/especial/excepcional/formidável/misterioso/fantástico/esquisito/notável/raro/singular/diferente/admirável/único/maravilhoso/curioso/estonteante/fabuloso/grande/bizarro/grandioso/magnífico/formoso/belo/gótico
aceitável	capaz/boa/adequado
terrível	ofensivo/intenso/ruim/desagradável/alarmante/inquietante/intensivo
lógico	racional
absorvente	esponjoso/interessante
substancial	significativo/adequado
sutil	humorístico/engraçado
musculoso	forte
núbil	maturo/maduro
adaptável	adaptativo/elástico/ajustável
inopinado	staccato
ilegal	criminoso/extrajudicial/interdito/penal/ilegítimo/ilícito/defeso/inelegível
sensasional	intenso/intensivo
congruente	idêntico
sugestivo	indecente/consciente
extraconjugal	ilícito
analógico	figurativo
receoso	claustrofóbico/xenófobo/pasmo/agorafóbico/pasmado/amedrontado
esmero	intenso/intensivo
crônico	degenerativo/ordinário/costumeiro/genérico/comum/geral/usual/habitual
luzente	superior
satírico	sarcástico
doidão	insano/sexy
litorâneo	marítimo
melhor	óptimo
fanático	passional
municipal	doméstica
lamentável	inferior/desagradável/ruim/infeliz
animador	contente/alegre/radiante/animado
psicotrópico	psicadélico
laminado	fino
pequeno	microscópico/jovem/moderado/inferior/minúsculo/pequenito/esguio/anão/diminuto/pequenino
fidedigno	responsável
temporão	jovem/nítrico/mirim/contemporâneo/novo/primordial/primitiva/anterior
absorto	atento
aplicado	diligente/forense
fiel	exacto/justo/acurado/exato/preciso
cirúrgico	preciso/exato/acurado/justo/exacto
antitético	diferente
sanitário	higiênico
socialista	colectivo/coletivo
fabulosa	aprazível
brega	inferior
antigo	passado/antediluviano/amarelo/arcaico/usado
interno	intrínseco
purpúreo	cromático
simplístico	simples/singelo
profilático	saudável
metafórico	figurativo
indene	intacto/salvo
décimo_primeiro	ordinal
enfermo	frenético/delirante/nauseante/tísico/verdejante/diabético/vertiginoso/tonto/indisposto
inverso	antônimo
unitário	unido
chocante	staccato
informativo	consultivo/consultor
picante	acídulo/desgradável
brilhante	superior/deslumbrante/reluzente/iridescente/prata/radiante/prateado/argênteo/refulgente/faiscante/argentino/luminoso
soturno	triste
substituível	intercambiável
numérico	quantitativo
polémico	discutível/conflituoso/polêmico/controverso
infinito	absoluto/inesgotável/ilimitado/perfeito
produtor	cultivável/fecundo/prolífico/arável
idosa	velho
desordenado	eriçado/hirto
irónico	brincalhão/arteiro
imprudente	indiscreto
odioso	ofensivo/abominável
autárquico	doméstica
inconsolável	desolado
parelho	equidistante/equivalente/eqüidistante
popular	democrático/turístico/predileto
desrespeitoso	insolente/escarnecedor
feio	monstruoso
judiciário	legal
2	cardinal/cardeal
adoentado	asmático/gangrenoso/patológico/mental/ictérico/inflamatório/espumoso/artrítico/descorado/mórbido
anão	pequeno
brônzeo	metálico
elefantino	grande
néscio	tolo
deleitoso	aprazível
lutuoso	triste/pesaroso
vitoriano	próprio/adequado/conveniente
grosso	caloso/baixo/gordo/grande
insípido	espalhafatoso/presumido/vistoso/mirabolante
meditabundo	especular
virtual	realístico
claustrofóbico	receoso
ilegítimo	ilegal
orgíaco	embriagado/ébrio/bêbedo/sexy
costumado	habituado/usual
roliço	gordo
ilimitado	infinito
indiferente	imparcial/rotineiro/letárgico/costumeiro/comum/ordinário/normal
sórdido	sujo
esférico	redondo/circular/arredondado
arrogante	orgulhoso
suprema	definitivo
desesperado	indefeso/escalvado
sísmico	instável/precário
amável	amigo/afável/benigno/benevolente/benévolo/amigável/amistoso/gentil/lhano
efervescente	espumoso/borbulhante
didáctico	noticioso
estreito	mesquinho/dogmático
passional	colérico/ardente/fanático/devasso/flamejante
universal	internacional/amplo/exaustivo
quadricular	quadrado
abençoado	salvado
mero	específico/especificado
magestoso	alto
inesgotável	infinito
esponjoso	macio/absorvente
inquieto	psicadélico/histérico/frenético/transtornado/agitado/febril/excitado
incompatível	antônimo/incongruente/antiácido/contraditório/inconsistente
amolgado	fino
nórdico	setentrional
cor-de-laranja	cromático
inquebrantável	constante
opcional	facultativo
ardente	entusiástico/passional/entusiasta
entusiasta	ardente/evangélico/ávido/fervente/fervoroso
desgradável	cortante/adstringente/acerbo/picante
térmico	quente
adulto	maturo/maduro
corriqueiro	recebido/habitual
exato	fiel/literal/certo/cirúrgico/justo/correto/estrito
amarelado	cromático
alternativo	inconformista/secundário
irregular	anormal/raro/imperfeito/casual/esporádico
casta	virgem/virginal
hipersensível	suscetível/susceptível
tendente	inclinado
silenciosa	pacato
inválido	morta/nulo
entretido	interessante
augusto	honrado
afetado	sujeito/artificioso/artificial
acre	saboroso/desagradável
utilizável	prestativo/descartável
constrangedor	persuasivo/poderoso
constante	inquebrantável/contínuo
desafiador	relutante/intrincado/resistente/foda/difícil/árduo
astuto	ladino/ágil/precioso/ardiloso/esperto/alerta/animado/hábil
bem-intencionado	amigável
comunicável	comunicativo
polêmico	discutível/conflituoso/controverso/polémico
demonstrável	evidente/óbvio
épico	grande
comparável	mesmo
arrojado	heróico/animoso/valente
interessado	curioso
insone	desperto/alerta/acordado
desagradável	ofensivo/infernal/amargoso/lamentável/pavoroso/áspero/dolorido/acre/triste/amaro/virulento/terrível/acerbo/animal/amargo/cáustico/doloroso
memorável	inesquecível
indomável	inconquistável
argentino	radiante/brilhante/luminoso
ondeante	tempestuoso
incrível	improvável/estarrecedor
indispensável	necessário/vital/imprescindível
trivial	frívolo/fútil
fluente	gracioso
cósmico	grande
doido	insano
débil	indeciso/manco/anémico/anêmico
metálico	dourado/argênteo/aurífero/brônzeo/áureo
talentoso	mestre/consumado/versado/competente/hábil/habilidoso/experiente
cômico	humorístico/engraçado
heterogêneo	misto/sortido
alimentar	saudável
positivo	afirmativo/favorável/construtivo/otimista/profícuo/propício
chique	elegante/actual/contemporâneo/inovador/moderno/progressista
dolorido	desagradável/traumático/terno/sensível/ofendido
ansiosa	ávido
excitado	embriagado/inquieto/louco/nervoso/ébrio/sexy
orgânico	saudável
definido	livre
brava	heróico/animoso/valente
madrepérola	acromático
forense	aplicado/retórico
embutido	cercado
clamoroso	barulhento/ruidoso
social	amistoso/sociável/gregário/amigável/étnico/amigo/cultural
fátuo	imbecil/idiota/estúpido/sonso
compressível	comprimido
vulcânico	instável/precário
maluco	insano/tolo
episódico	imprevisível
enganado	incorrecto
nocivo	degradante/difamatório/pernicioso/insidioso/deletério/prejudicial/fraudulento/calunioso/abusivo/danoso/infamante
ufano	orgulhoso
Ad-hoc	específico
cáustico	destrutivo/desagradável
deficiente	inapropriado
hierárquico	graduável
proporcionado	idêntico
maneável	possível
inerme	indefeso
suscetível	impressionável/moldável/alérgico/hipersensível
bárbaro	inumano/desumano
múltiplo	denário/triplo/quádruplo/quíntuplo/dúplice
simpático	agradecido/idílico/ameno/aprazível
embriagado	excitado/drogado/orgíaco/tocado/pedrado/entusiasmado/grogue
heráldico	comunicativo
espirituoso	humorístico/engraçado
ladino	astuto
irritado	indignado/lívido/colérico/feroz/raivoso/furibundo
maravilhoso	sobrenatural/extraordinário/bonito/formoso/belo
administrável	manipulável
direito	reto/serviçal/prestável/justo/recto
desocupado	vazio
misterioso	incompreensível/extraordinário/sobrenatural/esotérico/inexplicável
abjeto	desprezível/infeliz
inteiro	completo/integral
fácil	indolor/casual/lauto/farto/bastante/basto/copioso/abundante
democrático	comum/popular/republicano
melancólico	triste
tísico	doente/enfermo
sangrento	ensanguentado
melodramático	dramático
saturnino	sarcástico
adornado	estofado
inútil	nulidade/inutilizável/fútil/inapto/impróprio
ofensiva	injurioso
actual	chique/corrente/real/contemporâneo/hodierno/último/moderno/vigente/online/atual
devagar	mandrião
indetectável	invisível
confirmável	empírico
glamoroso	emocionante/excitante
territorial	regional
cosmético	estético
metade	incompleto/parcial/fracionário
correto	exacto/perfeito/preciso/afinado/certo/exato
sexual	sexy
cinético	dinâmico/movente
inquietante	ameaçador/abominável/macabro/arriscado/horripilante/medonho/calamitoso/ominoso/terrível/pavoroso/temível/cabeludo/atroz/perigoso
quadrado	quadricular
disposto	rápido
cercado	inclusive/fechado/embutido
cálido	carinhoso/afectuoso/amoroso
peculiar	específico
falecido	morto
conclusivo	definitivo/decisivo
décimo_quarto	ordinal
enfático	peremptório/assertivo
colateral	secundário
seleto	superior
vivente	remanescente/realístico/existente
burro	imbecil/idiota/estúpido/sonso
ortodoxo	convencional/canônico/tradicional
primordial	superior/temporão/dominante/precoce/cedo
benévolo	amável
perverso	danoso/malevolente/venenoso/malévolo/maldoso/calúnia/malvado
marítimo	litorâneo
trigésima	ordinal
afoito	heróico/animoso/valente
anguloso	áspero
vital	vivo/imprescindível/indispensável
vigésimo_primeiro	ordinal
opaco	incompreensível/esbranquiçado/glauco/lácteo
categorizado	classificado
rectilíneo	unidimensional
simbólico	representativo/minimum/mínimo
cafona	molhado
denário	múltiplo
óptimo	melhor
elegante	chique/gracioso/luxuriante/luxuoso
conhecido	familiar
sagrada	sagrado/bendito/santo
pétreo	cromático
biconvexo	convexo
grande	importante/astronômico/extraordinário/titânico/considerável/épico/massudo/massivo/maior/colossal/cósmico/descomunal/elefantino/volumoso/imenso/galáctico/gigantesco/grosso/heróico/vasto/amplo/berrante/alto
danificado	enrugado
intrínseco	inerente/interno/integrante/integral
triplo	múltiplo
silvestre	feroz/fero
unívoco	absoluto
torrencial	lauto/farto/bastante/basto/copioso/abundante
antônimo	incompatível/complementar/contrário/contraditório/inverso
aquoso	líquido/molhado
morena	escuro
volumoso	grande
incorreto	falaz/errôneo
indefectível	verdadeiro
romântico	impraticável
incontestável	inegável
discrepante	incongruente/inconsistente
irrepreensível	inocente
dimensional	multidimensional
contingente	definitivo
póstumo	tardio
colectivo	socialista
afectuoso	apaixonado/terno/cálido/meigo/enfatuado/carinhoso/amoroso
incomparável	inigualável/único
gelatinoso	espesso
preventivo	proibitivo/saudável/obstrutivo/impeditivo
expresso	rápido/rápida
fascinante	interessante
criador	criativo/inventivo/imaginativo
caucasiana	branco/caucasiano
paradoxal	incompreensível/inexplicável
desconfortável	incômodo/irritante/doloroso/incómodo
empresarial	empreendedor
rechonchudo	gordo
violeta	cromático
falso	mentiroso/artificial
ventoso	tempestuoso
amigo	social/amável/afável
porfiado	teimoso/obstinado
salvado	abençoado
caucasiano	branco/caucasiana
descendente	relacionado
aprazível	fabulosa/simpático/cativante/deleitoso/gratificante/admirável/cheiroso/delicioso
rochoso	áspero
ajuizado	sábio
sublime	sagrado/nobre
capaz	habilitado/aceitável/apto/engenhoso/desenvolto/habilidoso/apropriado/correspondente/conveniente/inventivo/competente/adequado
perigosa	perigoso
exacto	fiel/certo/cirúrgico/justo/correto
inicial	primeiro
belicoso	militar
dura	granítico
vigésima	ordinal
engraçado	hilária/humorístico/sutil/irônico/espirituoso/jocoso/hilariante/cômico
promíscuo	sexy
habilidoso	capaz/mestre/consumado/versado/competente/hábil/experiente/talentoso
surpreendido	estupefato
nulo	inválido
indecente	ordinário/obsceno/sugestivo/sexy
desalentador	desencorajante
fero	silvestre/selvagem
quantitativo	numérico/quantificável/decimal
artificial	esquisito/afetado/artificioso/falso/estranho/sintético
180	cardinal/cardeal
folgado	frouxo/solto
diverso	diferente/vário
atabalhoado	aleatório
gráfico	realístico/escrito
curto	lacónico/curto_prazo/efêmero/momentâneo/conciso/fugaz/lacônico/breve/efémero/sucinto
execrável	abominável
trienal	periódico
lesto	ativo
cardinal	c/160/500/cem_mil/dez_mil/bilhão/quarenta/mil/trilhão/5/uno/duzentos/cento_e_oitenta/trezentos/noventa_e_nove/quatrocentos/cento_e_sessenta/190/180/quinhentos/um_mil/1000/2/V/cinco
assexual	vegetativo
oscilante	convulsivo
inconsiderado	desatento
anterior	passado/antecedente/temporão/precoce/cedo
costumeiro	medíocre/crônico/cotidiano/banal/usual/habituado/crónico/indiferente/habitual/inveterado
comunitário	comum
sortudo	afortunado
remanescente	vivente
raivoso	bravo/tempestuoso/irritado
instruído	erudito
alterno	cíclico
restrito	fechado
insano	doido/instável/louco/doidão/lelé/demoníaco/sandeu/paranóico/maluco
aleijado	inapropriado
doentio	asmático/gangrenoso/patológico/mental/ictérico/inflamatório/espumoso/artrítico/descorado/mórbido
parasita	dependente
bolorento	malcheiroso/fedorento
angular	retangular/triangular
agorafóbico	receoso
olivo	cromático
aprimorado	perfeito/idílico/ideal/impecável
esquisito	atrapalhado/artificial/desajeitado
milionésimo	ordinal
crespo	encaracolado
análogo	equidistante/similar/equivalente/eqüidistante
hábil	jeitoso/habilidoso/ágil/engenhoso/astuto/genial/alerta/animado/talentoso
paroquial	provincial
venal	corrupto
entreaberto	aberto
narrativo	comunicativo
piedoso	devoto/hipócrita/religioso
obsceno	indecente/sujo
junto	vizinho/perto
histórico	importante/passado/existente
civilizado	humano
ingénuo	cândido
torpe	desonroso/imoral
prestável	serviçal/obsequioso/direito
mórbido	doente/adoentado/doentio/insalubre
vivaz	realístico
ominoso	alarmante/inquietante
doído	traumático/terno/sensível/ofendido
metódico	organizado
pedrado	embriagado/ébrio/bêbedo
oratório	retórico
corrupto	malandro/desonesto/venal/corruptível
sandeu	insano
trabalhador	diligente
parcial	tendencioso/incompleto/fragmentário/meio/metade
nutritivo	saudável
fabuloso	extraordinário/superior
pleno	intocado/estufado
recreativo	interessante
habitual	frequente/corriqueiro/crônico/freqüente/habituado/crónico/ordinário/inveterado/costumeiro/genérico/comum/geral/usual/convencional
árduo	frustrante/complicada/ambicioso/controvertido/traumático/difícil/sensitivo/laborioso/terno/sensível/desafiador/ofendido/desconcertante/complicado/problemático/espinhoso
comprovável	objetivo
desarmado	indefeso
curto_prazo	curto
encaracolado	tempestuoso/crespo
basto	torrencial/abundante/copioso/bastante/lauto/fácil
inflexível	intransigente/rígido
adjunto	subordinado
autonómico	involuntário
castiço	puro/virginal/impoluto/virgem
ictérico	doente/adoentado/doentio/insalubre
rançoso	fedorento/malcheiroso
terminado	polido/concluído
febril	inquieto
compêndio	sucinto/lacônico/conciso/lacónico
tratável	maleável/dócil
liso	aveludado/aerodinâmica/aerodinâmico
escarpado	abrupto/repentino
modesto	moderado/inferior
extravagante	sobrenatural
pançudo	gordo
branco	caucasiano/caucasiana
internacional	universal/alienígena/multinacional/global/mundial/estrangeiro
estúpido	fátuo/burro/imbecil/idiota/sonso
delicioso	aprazível/saboroso
cotidiano	rotineiro/costumeiro/comum/ordinário/normal
titular	formal
descontrolado	delirante/frenético
tropical	quente/figurativo
humanitário	humano
sétima	ordinal
mesquinho	estreito
trianual	periódico
ardiloso	astuto
maturo	maduro/adulto/outonal/casadoiro/maior/núbil/crescido
desassossegado	precário/preocupado
labiríntico	intrincado
executável	possível
liberal	exuberante/esquerdista/generoso/progressista
saltear	cozinhado
federal	nacional/setentrional/boreal
indignado	bravo/irritado
incondicional	independente
degradante	tóxico/desonroso/nocivo/imoral
bidimensional	alisado
malcriado	indelicado
gregário	social
maléfico	sinistro/vil/atroz/ruim/nefando/desprezível/infernal/abominável
morto	assassinado/falecido
mendigo	infeliz
estudioso	erudito
opulento	precioso/valioso
impoluto	castiço/puro
ignominioso	desonroso/imoral
patente	óbvio/evidente
vivo	ciente/vívido/sensível/realístico/vital/informado
obrigatório	necessário/forçoso/compulsório/imprescindível
refutável	responsável
solúvel	questionável
profícuo	benéfico/preferencial/positiva/positivo/boa/discriminatório
prolífico	produtor/produtivo/proveitoso/fecundo/frutífero
decorrente	subsequente/ulterior
simultâneo	síncrono/sincrônico
são	lúcido/saudável
indutivo	implícito
insuportável	inaceitável/ofensivo/amargo/intolerável
psíquico	mental/paranormal
engenhoso	ágil/capaz/alerta/animado/hábil
subtil	perspicaz
trilhão	cardinal/cardeal
vil	maléfico/má/ruim/malvado
mendiga	infeliz
esporádico	isolada/ocasional/irregular/periódico
otimista	altista/alegre/positivo
extenuante	traumático/terno/sensível/ofendido
ambivalente	incerto/inseguro
cobiçoso	voraz/predatório/possessivo/cumulativo/avaro/ávido/ganancioso/acumulativo/predador
libertino	imoral
transmissível	contagioso
similar	semelhante/correspondente/análogo
conversador	tagarela
rural	bucólico/agrícola/agrário
meticuloso	preciso
irritante	desconfortável/incómodo/incômodo
portátil	móvel
instável	insano/sísmico/vulcânico/mutável
inefável	sagrado
amarelento	cromático
axiomático	evidente/óbvio
versado	experiente/habilidoso/experimentado/talentoso
perneta	inapropriado
escarnecedor	desrespeitoso
viril	macho
fétido	fedorento/malcheiroso
favorável	conveniente/indulgente/amigável/benéfico/propício/preferencial/positiva/positivo/partidário/boa/discriminatório
preciso	literal/certo/fiel/cirúrgico/justo/meticuloso/correto/estrito
luminoso	deslumbrante/reluzente/iridescente/prata/radiante/prateado/argênteo/refulgente/faiscante/argentino/brilhante
complicada	árduo/difícil/foda/intrincado
bizarro	inusual/inconformista/sobrenatural/insólito/extraordinário/estranho
povoado	inabitado
vocal	berrante/alto
inviolável	sagrado/inalienável/invulnerável
independente	livre/incondicional/autônomo/auto-suficiente/comutativo/involuntário
sable	acromático
confidencial	privado
rítmico	métrico
experimental	empírico
baixo	grosso/suave
raro	extraordinário/isolada/ocasional/irregular/periódico/infrequente
possessivo	cobiçoso/sequioso
tempestuoso	ventoso/ensurdecedor/encaracolado/ondeante/feroz/raivoso
mastigável	tenro/macio
aditivo	incremental/cumulativo/complementar/suplementar/adicional
compatível	congenial/harmonioso
gorducho	gordo
ordinário	indecente/informal/medíocre/crônico/cotidiano/banal/usual/habituado/crónico/indiferente/habitual/inveterado
infeliz	abjeto/mendigo/lamentável/coitado/desastroso/lastimoso/triste/pobre/mendiga/sem-teto/sem-abrigo
potencial	latente
sensitivo	árduo/difícil/foda/intrincado
animoso	bravo/valente/afoito/arrojado/brava/corajoso
tirante	cromático
inumano	desalmado/bestial/feroz/bárbaro/animal/cruel/brutal/desumano
duradoiro	prestativo
desgostoso	ofensivo
imoral	devasso/desgraçado/infamante/degradante/libertino/ignominioso/torpe
frustrante	árduo/difícil/foda/intrincado
majestoso	impressionante
involuntário	vegetativo/autônomo/independente/autonómico/automático
difícil	árduo/frustrante/complicada/ambicioso/controvertido/sensitivo/laborioso/desafiador/desconcertante/complicado/problemático/espinhoso/foda/intrincado
infravermelho	invisível
acolhedor	confortável
lépido	ativo
exemplar	decoroso
piramidal	pontudo
imprevisível	ocasional/episódico
abrupto	escarpado/fulminante/íngreme/repentino
distante	inacessível/ulterior/remoto/longe/longínquo
simples	austero/simplístico
circunstanciado	cautelosa/prudente/atento
moldável	susceptível/suscetível
surdo	surdo-mudo
entusiástico	ardente/evangélico/ávido/fervente/fervoroso
corrosivo	sarcástico/destrutivo
granítico	dificil/dura/duro
varão	fálico/macho
obscuro	incompreensível/invisível/esotérico
sensato	ciente/sábio/informado
continental	transcontinental
paranóico	insano
octagésimo	ordinal
inerente	implícito/intrínseco
central	importante/nuclear/bifocal
descuidado	malfeito/desleixado
macio	aveludado/esponjoso/mastigável/flácido/aerodinâmica/fofo/mole/aerodinâmico/fofa
esfomeado	faminto
afinado	certo/justo/correto
animado	jeitoso/animador/alegre/engenhoso/radiante/astuto/genial/hábil/contente
impermeável	hidrófugo
arquetípico	primeiro
dourado	metálico/cromático
frequente	habitual/comum/predominante
mecânico	automático
antropóide	humano
excitável	nervoso/sensível
distinto	importante/diferente
mercantil	comercial
renomado	sabido
azulado	cromático
amorável	angélico/adorável/angelical
bêbedo	drogado/orgíaco/tocado/pedrado/grogue
pacato	quieto/silenciosa
longe	remoto/distante/longínquo
vasto	amplo/grande
frontal	dianteiro
benigno	amável
coitado	infeliz
avelaneira	cromático
pernicioso	tóxico/nocivo
descalço	descalça
pobre	duro/indigente/infeliz
latente	possível/potencial
impo	impressionante
nacional	doméstica/federal
airoso	luxuriante/luxuoso
contestável	discutível
descalça	descalço
curvilíneo	tortuoso/circunflexo
dianteiro	frontal/avançado
linear	unidimensional
radiante	contente/deslumbrante/reluzente/iridescente/prata/prateado/argênteo/refulgente/faiscante/argentino/animado/animador/brilhante/luminoso
exuberante	liberal
implícito	indutivo/perfeito/inerente/tácito/absoluto
erudito	sábio/estudioso/instruído/sapiente/pedante
frutífero	prolífico/generoso/produtivo/farto
dependente	viciado/parasita/interdependente
realístico	gráfico/pragmático/vivo/virtual/vivaz/vivente/prático
grandioso	importante/extraordinário
fresco	original/crocante/estaladiço
injurioso	ofensiva/ofensivo
precioso	decoroso/astuto/bonito/equivalente/magnífico/inestimável/opulento/valioso/formoso/belo
cerúleo	cromático
visionário	utópico
destrutivo	negativo/iconoclástico/cáustico/esbanjador/corrosivo
titânico	grande
grácil	refinado/cultivado/gentil
apto	capaz/adequado
circunstancial	específico
classificável	identificável
sarcástico	corrosivo/brincalhão/saturnino/patético/satírico/arteiro
previsível	inexorável
genérico	crônico/usual/habituado/crónico/habitual/inveterado
dúplice	múltiplo
forte	alcoólico/veemente/intenso/pesado/poderoso/robusto/musculoso/intensivo
imaturo	juvenil/pueril/infantil
confederativo	unido
predatório	cobiçoso/sequioso
importante	perceptível/influente/conspícuo/monumental/histórico/grandioso/distinto/sério/central/crucial/decisivo/fundamental/notável/proficiente/grande/saliente/proeminente
alto_nível	alto
analfabeto	semi-analfabeto
alegre	animador/optimista/otimista/animado/contente
deferente	respeitoso
acromático	madrepérola/esbranquiçado/saibro/prateado/acinzentado/cinza/gris/sable
arredondado	esférico/global
ineficaz	incapaz
obstrutivo	preventivo
cobarde	pusilânime
desperto	acordado/insone
gris	acromático
primitiva	temporão/cedo
cheiroso	aprazível/fragrante/perfumado
notável	significativo/extraordinário/sabido/decoroso/significante/importante
traquinas	arteiro/brincalhão
pavoroso	desagradável/inquietante/alarmante
apavorante	ruim
eventual	definitivo/possível
colérico	passional/bravo/irritado
fino	transparente/superior/laminado/diminuto/tênue/filiforme/diáfano/magro/amolgado
escalvado	desesperado
próprio	pessoal/específico/decoroso/vitoriano/conveniente/adequado/apropriado
cromático	rosa/pétreo/rosado/amarelo/ambarino/baio/olivo/ruivo/coral/acastanhado/áureo/laranja/roxo/azul-petróleo/amarelento/verde-azeitona/azul/avermelhado/cerúleo/cor-de-laranja/castanho/pardo/azulado/tirante/amarelado/esverdeado/marrom/purpúreo/avelaneira/moreno/cereja/violeta/dourado/lilás/encarnado/alaranjado
surpreso	estupefato
pluvioso	molhado
pertinente	relevante/aplicável/procedente
literal	exato/verdadeiro/preciso/correcto/certo
indefeso	inerme/desesperado/desarmado
ulterior	longínquo/concomitante/resultante/decorrente/subsequente/distante
proeminente	conspícuo/importante/ilustre/saliente
ígneo	quente
gay	homo/lésbico/bicha/transsexual
malfeito	descuidado/negligente
estarrecedor	incrível/inacreditável
doloroso	desagradável/traumático/terno/sensível/desconfortável/ofendido/incómodo/incômodo
acastanhado	cromático
comunicativo	falador/francófono/expressivo/hispanófono/anglófono/anedótico/narrativo/heráldico/comunicável/significativo
perspicaz	penetrante/arguto/subtil
proveitoso	económico/prolífico/generoso/produtivo/rentável/lucrativo/farto
regular	cronometrado/padrão/oficial
pontiagudo	pontudo
contraditório	inconsistente/antônimo/incompatível
malcheiroso	bolorento/ofensivo/rançoso/fedorento/ranço/fétido
abdominal	gordo
santa	sagrado/bendito/santo
saudável	curativo/antimicrobiano/profilático/anti-helmíntico/orgânico/alimentar/preventivo/terapêutico/salutar/nutritivo/são/salubre
monumental	importante/significante/significativo
espalhafatoso	insípido
irritável	tenso
problemático	árduo/difícil/foda/intrincado
padrão	modular/regular
cíclico	periódico/circular/alternante/alterno/alternativa/alternado
artificioso	artificial/afetado
inusual	estranho/fantástico/esquisito/singular/diferente/único/curioso/bizarro/gótico
sexy	pornográfico/sexual/libidinoso/erótico/doidão/orgíaco/promíscuo/excitado/indecente/quente/devasso/lascivo
espinhoso	árduo/difícil/foda/intrincado
distintivo	característico
inveterado	ordinário/costumeiro/genérico/comum/geral/usual/habitual
deletério	prejudicial/nocivo/daninho/danoso
triste	desagradável/pensativo/agridoce/trágico/horrendo/soturno/lúgubre/enjoado/nebuloso/lastimável/escuro/lutuoso/ermo/melancólico/infeliz
intocado	cheio/pleno/lotado
assíncrono	anacrônico
cultivado	grácil/mimoso
enésimo	ordinal
imperioso	orgulhoso
desonroso	encantador/desgraçado/equivocado/degradante/enganador/enganoso/ignominioso/torpe
encharcado	molhado
ranhoso	sujo/orgulhoso
semi-analfabeto	analfabeto
explanatório	noticioso
satisfatório	boa
sabido	proverbial/renomado/célebre/notável/ilustre/legendário
morno	caloroso
acostumado	familiar
gigantesco	grande
usável	descartável/prestativo
honorífico	respeitoso
interminável	permanente/duradouro
saliente	proeminente/importante/ilustre
remoto	longínquo/longe/distante
desnivelado	desigual
ultravioleta	invisível
persuasivo	constrangedor/coerente
inofensivo	inócuo/inocente
emblemático	típico
alternado	cíclico
descortês	indelicado
nublado	confuso/perplexo
acidentado	áspero
eclético	discriminatório
praticável	possível
propenso	inclinado
pessoal	subjetivo/personalizado/próprio/privado
monstruoso	feio
legal	judiciário/lícito/regulamentar/legítimo/estatutário/judicial
ousado	audacioso/aventureiro/audaz/bravo/corajoso
outonal	maduro/maturo
líquido	descartável/aquoso/fluido
integrado	unido
irracional	supersticioso
sociável	social/congenial
quieto	pacato
inesquecível	memorável
impróprio	nulidade/inutilizável/inútil/fútil
qüinquagésimo	ordinal
desumano	desalmado/bestial/inumano/feroz/bárbaro/animal/cruel/brutal
fulminante	abrupto/repentino
delirante	selvagem/doente/descontrolado/enfermo
bestial	inumano/desumano
calúnia	malicioso/perverso/maldoso
desajeitado	estranho/esquisito
atual	real/corrente/contemporâneo/hodierno/último/moderno/vigente/online/actual
lastimável	triste
aberto	escancarado/visível/entreaberto
coloquial	informal
repreensível	incorrecto/culpado
rendoso	económico/rentável/lucrativo
competente	habilidoso/capaz/eficiente/talentoso
definitivo	conclusivo/eventual/decisivo/peremptório/supremo/evidente/contingente/decidido/suprema/resoluto
tocado	embriagado/ébrio/bêbedo
medieval	passado
irrestrito	abandonado
dogmático	estreito
adaptativo	adaptável
