justo	invulnerável/apertado/fiel/exacto/direito/reto/cirúrgico/perfeito/bom/preciso/afinado/certo/exato/justo/eqüitativo/recto
construtivo	criativo/vantajoso/estrutural/Reconstructor/reconstructor/positivo
empático	simpática
feia	grotesco/monstruoso
alterado	mudado/ajustado/trocado
inconciliável	inconsistente
insólito	exótico/estranho/fantástico/esquisito/singular/diferente/único/curioso/bizarro/assustador/gótico
perdoável	perdoável/venial
cumulativo	cobiçoso/aditivo/sequioso
prorrogável	longo
pasmo	receoso
de_tirar_o_fôlego	emocionante/excitante
louvável	decoroso/digno
corporal	corpóreo/corpórea
ascendente	dominante
daltônico	invisual/cego
moral	casto/mental
amarelo	cromático/antigo/velho
consecutivo	contínuo
quiet	silencioso
inconsistente	contraditório/inconciliável/incompatível/discrepante
oportuno	propício/bom/oportuno/cómodo
vitalício	de_duração
infantil	jovem/juvenil/pueril/imatura/infantil/imaturo
quinhentos	cardinal/cardeal
improdutivo	estéril/infértil
testado	de_confiança/digno_de_confiança/confiável/fidedigno/fiável
gangrenoso	doente/adoentado/doentio/insalubre
juvenil	infantil/jovem/imaturo
pleonástico	prolixo
corajoso	ousado/animoso/valente/heróico/Inconsequente/audaz/destemido/audacioso/temerário/intrépido
dócil	manso/tratável
regulável	variável/mutável
plural	dual
eterno	permanente/duradouro
complementar	antônimo/aditivo
impessoal	objetivo/não_subjetivo
avulso	específico
recíproco	partilhado/bilateral/interactivo/interativo
inflamatório	doente/adoentado/doentio/insalubre
V	cardinal/cardeal
fronteiriça	minimum/mínimo
magoado	árduo/dolorido/doloroso/extenuante/doído
empolgante	emocional
cooperativo	solidário
concluído	terminado/finalizado/acabado
angelical	bom/amorável/boa
vanglorioso	orgulhoso
temido	inquietante/alarmante
aberrante	anormal
audaz	ousado/aventureiro/heróico/Inconsequente/audacioso/temerário/intrépido/audaz/bravo/destemido/corajoso
frigorífico	frio
mínimo	fronteiriça/simbólico/marginal
faminta	esfomeado/com_fome/esfomeada/faminto
peluda	pubescente/lanoso
casual	fácil/isolada/ocasional/intermitente/irregular/periódico
recente	passado/congelante/novo/crocante/estaladiço/efervecente
flácido	macio/inapropriado
formal	oficial/literário/titular/solene/convencional
reduntante	desnecessário/desnecessária
incapacitado	impotente
partido	incompleto
transtornado	inquieto
perturbado	inquieto
vegetativo	involuntário/assexual/involuntária
o_máximo	importante
assim_assim	rotineiro/costumeiro/comum/ordinário/normal
ilustre	sabido/conspícuo/saliente/proeminente
amargoso	arisco/desagradável
intrépido	audacioso/audaz/bravo/destemido/corajoso
possuído	controlado/insano
prévio	antecedente/passado
mútuo	bilateral/partilhado/interactivo/interativo
ruidoso	colorido/clamoroso
possível	matemático/latente/conquistável/eventual/possível/atingível/praticável/factível/viável/maneável/executável/exequível/manejável/fazível/exeqüível/alcançável/realizável
que_está_chegando	futuro
autêntico	verdadeiro/autêntico/genuíno/legítimo
impudico	suja/sujo
equivocado	desonroso
pulcro	bonito/formoso/lindo/belo
unidimensional	rectilíneo/linear
apenso	próximo
com_tesão	sensual/sexy
oficial	formal/regular/autorizada/de_perito/autorizado/constituído/estabelecido
fedida	ruim
desnecessário	desnecessária/prolixo/supérfluo/redundante/extra/desnecessário/reduntante/gratuito/excessivo
desconcertante	confuso/árduo/difícil/foda/intrincado
diluído	aquoso
tóxico	venenosa/degradante/pernicioso/hepatotóxico/virulento/perniciosa/venenoso
conceitual	abstrato
beligerante	malvado
esforçado	diligente
intensional	conotativo/conotativa
refrigerado	frio/fresco
errante	falível
cosmopolita	viajado
rosa	cromático
sagaz	sábio
quadragésima	ordinal
noticioso	consultivo/demonstrativo/educativo/explicativo/didático/didática/didáctico/aconselhador/explanatório/consultor
com_fome	faminta/faminto
calmo	constituído
flavo	arenoso/cor_de_linho
grato	agradecido/apreciativo/obrigado
conflituoso	polémico/controverso/polêmico
afim	relacionado
demoníaco	insano
online	corrente/actual/atual
confortável	suficiente/aliviar/acolhedor/confortável/íntimo/bastante
de_mérito	decoroso/digno
prudente	minucioso/sábio/consciensiosamente/discreto/elaborada/pormenorizado/circunstanciado/elaborado/consciencioso
virulento	mortal/arisco/tóxico/desagradável
intensificador	aumentativo/exasperador/exasperante/agravante
semicircular	tortuoso/circunflexo/curvo
capenga	lasso/débil/inapropriado
aquiescente	obediente
emocional	inquieto/empolgante/sentimental/lírico/afetivo
agoráfobo	receoso
glauco	opaco
valoroso	heróico/animoso/valente/destemido
histérico	inquieto
correspondente	similar/relacionado/mesmo/capaz/adequado/o_mesmo
mal-educado	indelicado/impolido
insensato	tolo
apreciativo	agradecido/reconhecido/grato/gratidão
distorcido	astuto
superficial	aparente/fácil/superficial
solto	friável/folgado
burguês	classe_média
relacionado	cossangüineo/cognato/afim/filiado/correspondente/descendente/afiliado/semelhante
cheio	cheio_demais/intocado/estufado
centrípeto	aferente
original	primário/primeiro/escrito_à_mão/criativo/fresco/inovador/novo/desenhado_à_mão/inventivo/nova/feito_à_mão/original/imaginativo
queimado	cozinhado
preliminar	exploratório/essencial
semanal	periódico/periodico
a_bombordo	esquerdo
esperto	astuto/esperto
reciclável	útil
temerário	audacioso/audaz/bravo/destemido/corajoso
ziguezagueante	escuso
artístico	estético
secundanista	intermédio
termal	quente/forgoso
muxibento	eriçado/hirto
totalizado	realizado/total/exaustivo/completo/absoluto/completado/completa
duplo	múltiplo
inovador	original/progressivo/chique
assustador	alarmante/inusual/inquietante/insólito/extraordinário/estranho
especificado	específico/nominal/mero
trigésimo	ordinal
pitoresco	colorido/bonito/formoso/lindo/belo
lastimoso	infortunoso/infeliz/miserável
visual	visível
provincial	caipira/paroquial/provinciano/rústico
comprido	de_duração
bravo	ousado/indignado/violento/animoso/valente/heróico/lívido/Inconsequente/colérico/furioso/irado/audaz/destemido/feroz/raivoso/audacioso/zangado/temerário/furibundo/intrépido
lelé	insano
populoso	inabitado
imaginativo	original/criativo/criador
gótico	estranho/extraordinário/insólito/inusual
rico	rica/afluente/rico
concorrente	síncrono/sincrônico
pequenito	pequeno
cultural	social
infértil	infértil/estéril/improdutivo
sã	lúcido
desastrado	incoveniente
palaciano	impressionante
devoto	piedoso/devoto/religioso
enviesado	inclinado
serelepe	ativo
horrorizado	receoso
prata	radiante/vivído/brilhante/luminoso/claro
grande_coração	liberal
soberbo	orgulhoso
certo	exacto/literal/destinado/rigoroso/justo/perfeito/predeterminado/preciso/correto/afinado/certo/textual/exato/estrito/matemático
antecedente	preexistente/prévio/anterior
celular	multicelular/alveolada/pluricelular
partilhado	recíproco/mútuo/comum
estratégico	importante
formidável	impressionante/extraordinário
ignoto	inferior
descomunal	grande
dilapidado	avariado/danificado
conceptual	abstrato
artrítico	doente/adoentado/doentio/insalubre
convindo	unido
pesado	maciço/forte/húmido/molhado/úmido
mandão	dominador
política	governamental
anedótico	comunicativo
pedregoso	áspero
perfeito	infinito/perfeito/certo/sem_erros/idílico/ideal/implícito/justo/correto/aprimorado/impecável
hilariante	humorístico/engraçado
desgostosamente	ofensivo
de_primeira_mão	primário
plausível	argumentável/discutível
caseoso	doente/adoentado/doentio/insalubre
pequenino	pequeno
constatável	determinável
modelar	decoroso/digno
humilde	inferior
da_cor_do_bronze	cromático
desigual	desnivelado/assimétrico/desuniforme/despadronizado
célere	rápido/rápida/veloz
incólume	indene/indemne
angélico	amorável/bom/boa
bem_disposto	jeitoso/engenhoso/astuto/genial/hábil
precoce	avançado/nítrico/antes_da_hora/primitivo/de_antemão/mirim/primordial/prematuro/anterior/o_mais_cedo/mais_cedo
molhado	aquoso/nevoeirento/pluvioso/húmido/desleixado/pegajoso/encharcado/pesado/chuvoso/cafona/esnobe_e_barato/fajuto/de_mau_gosto/úmido
inócuo	que_não_causa_danos/inócuo/inocente/inofensivo
efeminado	efeminado
bilhão	cardinal/cardeal
coerente	persuasivo/adesivo/racional/sem_remendos/sem_emenda/sem_improvisos
aumentativo	crescente/intensificador
afiliado	relacionado
amoroso	queama/que_ama/apaixonado/enfeitiçado/terno/cálido/meigo/enfatuado/afeiçoado/carinhoso/afectuoso/amoroso
irrelevante	tangencial
devasso	imoral/passional/sensual/sexy
entendível	compreensível
perfumado	cheiroso/fragrante/aromática/perfumado
furiosa	passional
mundano	leigo/sofisticado/secular
inclusive	cercado/rodeado/delimitado
ligeiramente_embriagado	embriagado/ébrio/bêbado/bêbedo
perceptível	importante
laranja	cromático
fortuito	afortunado
objetivo	comprovável/clínico/impessoal
voraz	cobiçoso/comilão/guloso/sequioso
impressionante	efetivo/admirável/majestoso/palaciano/formidável/dramático/nobre/magnífico/fulgurante/heróico/imponente/formigueiro/impo/espectacular/espetacular/impressionante/acertado/surpreendente/eficaz/eficiente
convincente	credível/crível
adjacente	próximo
cego	invisual/desafiado/daltônico/cego
generoso	fértil/liberal/proveitoso/fecundo/frutífero
jeitoso	ágil/alerta/animado/bem_disposto/hábil
corrente	real/mais_recente/contemporâneo/ligado/actual/em_curso/hodierno/último/moderno/em_linha/vigente/atual/até_a_data/online
omnipresente	presente
angulado	tricúspide/bicúspide/retangular/triangular/rectangular
incómodo	sem_conforto/azarado/irritante/desconfortável/doloroso
suave	sonoro/baixo/comedido/suave/manso/harmonioso/eufónico
intato	intacto
venerável	honrado/velho
velho	de_segunda_mão/escurecido/antediluviano/Professor_emérito/idosa/senil/centenário/amarelo/Veneráveis/venerável/arcaica/arcaico/usado/segunda_mão/Professor_Emérito/escuro
cabeludo	alarmante/inquietante
enfeitiçado	queama/carinhoso/afectuoso/amoroso
desinteressado	aborrecida/indiferente/apático
trêmulo	inseguro/oscilante
retangular	angular/perpendicular/angulado
sudoeste	sulista
mirim	temporão/precoce/cedo
metódica	organizado
digno_de_confiança	digno_de_confiança/testado/sólido/são/comprovado
opressivo	dominador
sinistro	maléfico/mau/má/ruim/maléfica/malvado
fundamental	crítico/basilar/essencial/importante/crucial
não_subjetivo	comprovável/clínico/impessoal
encorpado	gordo
malicioso	perversa/danoso/malevolente/venenoso/malévolo/maldoso/calúnia/malvado
guarnecido_com_ameias	protegido
estadual	público
peremptório	definitivo/enérgico/enfático
circular	cíclico/esférico/global
ameno	simpático/agradável
expressivo	comunicativo
de_trás	traseiro/mais_hindmost/posterior
vetusto	passado
leigo	mundano/terrestre
arável	produtor/produtivo
incapaz	impotente/incompetente/inadequado/ineficaz
estupefato	surpreso/surpresa/surpreendido/surpreendida
criminoso	ilegal/culpado
imodesto	orgulhoso
tautológico	prolixo
vagaroso	desempregado
insalubre	asmático/caseoso/gangrenoso/patológico/mental/ictérico/inflamatório/espumoso/edematoso/artrítico/descorado/mórbido
recatado_em_excesso	próprio/adequado/conveniente
degenerativo	crônico/crónico
colonial	complexo/intrincado
típico	verídico/normal/característico/representativo/emblemático/verdadeiro/caraterístico
crocante	fresco/recente
desculpável	justificável
incompreensível	obscuro/misterioso/paradoxal/enigmático/impenetrável/opaco/misteriosa
duzentos	cardinal/cardeal
eqüitativo	direito/bom/justo
oblíquo	diagonal
nenhum	incompleto
temporário	episódico/condicionado/improvisado/efémero/evanescente/precário/em_exercício/efêmero/interino/transitório/temporário/passageiro
flamejante	passional
supérfluo	desnecessário/prolixo/desnecessária
salgada	salífero/salobra
infeccioso	contagioso/transmissível
esfarrapado	destruído/fatigado/desgastado/cansado/cansada
marcado	percebível/que_se_pode_detectar
décimo_terceiro	ordinal
covarde	pusilânime
estendível	longo
autorizado	oficial
agitado	inquieto
insolente	desrespeitoso
frouxo	folgado/inapropriado
A_Sangue_Frio	inumano/desumano
subserviente	subalterno/servil
cor-de-rosa	cromático
Hollow_man	ultravioleta/indetectável/escondida/infravermelho/escondido
acabado	polido/terminado/finalizado/completado/acabado/concluído
predador	agressivo/cobiçoso/sequioso
ditatorial	dominador
completa	completo/integral/totalizado
gratís	autônoma/definido/autônomo/soberano/independente/autonômico
distiguivel	diferenciável
refinado	grácil/mimoso
incômodo	sem_conforto/azarado/irritante/desconfortável/doloroso
tacanho	tinhoso
frio	refrigerante_(mecânica)/glacial/refrigerado/frigorífico/gélido/frio/gelado/polar/ártico/refrigerado_a_ar
que_pode_ser_medido	importante
ranço	fedorento/malcheiroso
multicolor	colorido
cansada	extenuado/esfarrapado/exausto/cansado/morto_de_cansado
genial	ágil/alerta/animado/bem_disposto/hábil
gostoso	saboroso
mandrião	devagar/lento
comemorada	glorioso
penitenciário	punitivo
preeminente	dominante
correcto	literal/rigoroso/textual/estrito/matemático
fedido	ruim
longínquo	longo/ulterior/mais_distante/remoto/longe/longínquo/distante
em_brasas	passional
doente	asmático/que_causa_vertigem/caseoso/gangrenoso/frenético/patológico/mental/ictérico/inflamatório/espumoso/delirante/edematoso/nauseante/de_convalescência/artrítico/paralítico/com_mal-estar/descorado/tísico/verdejante/diabético/mórbido/vertiginoso/com_tontura/de_melhora/tonto/menstruada/indisposto
presunçoso	confiante/orgulhoso/contente
carinho	tolo
estragado	destruído
motejante	sarcástico
sem_fôlego	emocionante/excitante
global	internacional/extenso/redondo/detalhado/amplo/abrangente/exaustivo/circular/arredondado
enrolado	débil
prestes	imediato/rápido
adicional	secundário/aditivo
luxuriante	gracioso/esbelto/garboso/airoso/elegante
aconselhador	noticioso/informativo
em_ondas	encaracolado/cacheado
considerável	grande/apreciável/considerável
birracial	racial
segundo	ordinal
infiel	adulterino/perfido/pérfido/traiçoeiro
oficioso	informal
isolada	raro/casual/esporádico
avermelhado	cromático
agrário	rural
patético	desprezível/sarcástico
que_muda_constantemente	dinâmico
realizável	possível
terminal	nefasto/fatal
basilar	fundamental/radical/elementar/rudimentar
imortal	imortal
ébrio	excitado/drogado/orgíaco/ligeiramente_embriagado/tocado/pedrado/excitada/entusiasmado/grogue
namoda	popular
colossal	grande
acima	alto
argumentável	plausível
íngrime	perpendicular/abrupto/repentino/brusco
viajado	cosmopolita
todo-poderoso	poderoso
inacreditável	improvável/estarrecedor
imperfeito	humano/defeituoso/imperfeito/irregular
elástico	adaptável/flexível/elástico/ajustável
curisoso	recreativo/fascinante/intrigante/absorvente/entretido/divertido
esquisito	inusual/sobrenatural/não_convencional/inconformista/sobrecomum/insólito/extraordinário/estranho
tonto	frívolo/doente/fútil/enfermo
maldoso	perversa/malicioso/danoso/malevolente/venenoso/malévolo/calúnia/malvado/perverso/maldoso
total	completo/inteiro/integral/totalizado
primário	especial/original/de_primeira_mão
1000	cardinal/cardeal
profundo	sem_fundo/intenso/intensivo
denso	espesso/Família_de_Tyrogue
inexorável	inevitável/que_se_pode_prever/previsível
nordestino	nórdico/nortista
experiente	habilidoso/versado/mais_velho/talentoso
fictício	irreal/não_material
pueril	imaturo/infantil
humano	antropóide/civilizado/humanitário/imperfeito/antropomorfo/antropomórfico
mal_afamado	imundo/mal_afamado/famigerado/notório/infame
inelegível	inadequado/ilegal
satisfeito	orgulhoso/contente/deleitado/divertido
bigeminal	múltiplo
sujado	sórdido/encardido/piolhoso/ranhoso/gordo/grudento/sujo/imunda
vaidoso	contente
aliforme	voado/alado
voluntário	voluntário
constitucional	essencial
diligente	paciente/aplicado/empreendedor/esforçado/operoso/laborioso/trabalhador/assíduo/diligente
comilão	voraz
existente	vivente/presente/documental/histórico/real
desenvolto	capaz
futuro	prospectivo/iminente/emergente/próximo/que_vai_acontecer/que_está_chegando/que_está_vindo
indelicado	grosseiro/malcriado/malcomportado/descortês/rude/mal-educado
furiosas	passional
republicano	democrático
pura	puro/castiço
lendário	sabido/irreal/não_material
graduável	hierárquico/hierárquica
autorizada	oficial
maldito	perdido/maldita/condenado/amaldiçoado/maldito
cereja	cromático
repentino	escarpado/íngrime/repentina/explosivo/fulminante/brusco/íngreme/súbito/abrupto/repentino
semvida	sem_vida/inviável/pedra-inoperante/natimorto/assassinado/morto/falecido
mais_alto	alto
ajustável	elástico/adaptável/variável/flexível/ajustável
arguto	perspicaz
mutável	volatile/volúvel/regulável/volátil/instável
com_sede	seco
psicológico	mental
monótono	dessecado/sem_brilho/sem_vitalidade
escrito_à_mão	original
reprovável	culpado
abstrato	ideológico/esotérico/ideal/conceitual/concetual/conceptual
ativo	atlético/activista/rápido/hiperativo/lépido/lesto/serelepe/ligeiro/ativo/ativo_em_excesso/ágil/ativista/acrobático
incandescente	glorioso/iluminado
que_gosta_de_ler	erudito
iminente	futuro/próximo
espetacular	dramático/impressionante
fedorento	ofensivo/bolorento/ruim/rançoso/fedorento/ranço/fétido/malcheiroso
ancião	sênior
fuscícoma	bronzeado/escareado/escuro
interactivo	recíproca/recíproco/mútuo
estropiado	inapropriado
asmático	doente/adoentado/doentio/insalubre
aerodinâmica	liso/macio
rouca	cacofônico
detestável	ofensivo/abominável
perdido	destruído/extraviado/sumido/desperdiçado/maldito/perdido/faltante/desaparecido
contraceptivo	proteccionista
cheio_de_remendos	desnivelado/desuniforme/despadronizado
característico	típico/sintomático/distintivo
eufórico	expansivo
bem_sucedido	produtivo/vitorioso/próspero/lucrável/triunfante/viçoso/ganhador
júnior	mais_novo/mais_jovem
inexpressivo	reservado/não_comunicativo
formoso	de_bom_aspecto/extraordinário/cênico/atraente/esplêndido/pitoresca/lindíssimo/pulcro/fantástico/bem_parecido/glorioso/pitoresco/bonito/precioso/magnífico/deslumbrante/maravilhoso/formoso/lindo/belo
exeqüível	possível
legendário	sabido
racional	intelectual/mental/inteligente/lógico/coerente/racional
sossegado	constituído
singular	inusual/desacompanhado/individual/insólito/extraordinário/estranho
impulsivo	espontâneo
austero	simples
animal	inumano/desagradável/arisco/desumano
expansivo	eufórico
lasso	sem_cuidado/relaxado/fora_de_serviço/capenga/flexível/sem_tensão/queda_de_rendimento/desatencioso
bisonho	incoveniente
séptico	com_pus/poluente/purulento
baixa	reduzido
perpendicular	íngrime/vertical/ortogonal/retangular/honrado/reto/perpendicular/íngreme
horripilante	alarmante/inquietante
irreal	ilusório/fantástico/fictício/mítico/alucinatório/imaginário/místico/lendário
desmazelado	eriçado/hirto
defeso	ilegal
de_menor	dependente
imundo	mal_afamado
demorado	retardado/de_duração
sombrio	falta_de_esperança/triste/escuro/desesperado
horrível	extraordinário/triste/ruim/desagradável/sujo/intenso/mesquinho/alarmante/intensivo/inquietante/arisco
crível	convincente/suposto
pubescente	imaturo/peludo/peluda
pirado	insano
negligente	malfeito/sem_cuidado/desleixado/desatencioso
hilária	humorístico/engraçado
que_vem	disponível
excelente	superior
evocador	consciente
reconstructor	construtivo
bronzeado	fuscícoma/cromático/marronícoma/brunícoma/de_cabelo_castanho/obscurícoma/morena/castanícoma
quinzenal	periódico/periodico
duradouro	prestativo/eternos/estável/de_duração/permanente/indissolúvel/interminável/eterno/eternas/perene/eterna/sem_idade/perpétuo/imperecível/duradouro
agrícola	rural
complicado	complexo/foda/difícil/árduo/intrincado
lésbico	homo/gay/homossexual
lacônico	elíptico/sentencioso/compêndio/sumário/curto/lacônico/conciso/lacónico/sucinto
celeste	divino/celeste
duvidoso	inseguro/incerto
hemostático	adstringente
filiforme	fino
negro	escuro
prejudicial	difamatório/insidioso/deletério/prejudicial/fraudulento/catastrófico/mal/calunioso/abusivo/injuriante/infamante/nocivo/daninho/danoso
montanhoso	áspero
alaranjado	cromático
primeira_linha	superior
caótico	eriçado/desorganizado/selvagem/descontrolado/hirto
eleito	eleitoral
nauseante	doente/ofensivo/enfermo
escarnificante	sarcástico
dez_mil	cardinal/cardeal
nonagésimo	ordinal
espesso	gordo/gelatinoso/coagulável/denso/viscoso
Detestável_em_alto_grau	abominável
privilegiado	exclusivo/isento
morta	inválido
absorvido	atento
feito_à_mão	original
corpulento	gordo
focal	central
desleixado	húmido/descuidado/negligente/molhado/úmido
de_desculpa	defensivo
concreto	sólido/tangível
fixo	imutável/seguro/imóvel/geoestacionário/estacionário/firme/inalterável
suficiente	confortável/bastante/suficiente
escondida	invisível/Hollow_Man/Hollow_man
fragrante	perfumado/cheiroso
ácido	desgradável/ácida/azedo/fermentado/acídulo
subordinado	auxiliar/secundário/adjunto/assistente
benevolente	amável
senhorial	nobre
inseguro	vulnerável/precário/trêmulo/duvidoso/ambivalente/convulsivo
legítimo	genuíno/legítimo/legal/autêntico/verdadeiro
escondido	invisível/Hollow_Man/Hollow_man
incluído	cercado/rodeado/delimitado
benéfico	favorável/profícuo/vantajoso/propício
alcoólico	viciado/forte/espiritoso
impotente	incapaz/incapacitado/fraco
gelado	frio
caloroso	morna/tépido/tépida/morno/tíbio
positiva	favorável/profícuo/vantajoso/propício
truculento	agressivo
efêmero	curto/temporário
delicado	frágil
acessível	compreensível/prático/acessível/cômodo/útil
aterrorizado	receoso
devido	que_não_foi_pago_na_data_certa/pagável/coletável
literário	formal
ferido	ferido/machucado
são_e_salvo	seguro
acordado	desperto/insone/acordado
efémero	temporário/curto
agradável	agradecido/simpático/idílico/ameno/aprazível/agradável
azarado	incômodo/infortunoso/infeliz/miserável/triste/incómodo/desconfortável/pouco_à_vontade
infectado	com_pus/poluente/purulento
cento_e_oitenta	cardinal/cardeal
não_realizável	impossível
espumoso	doente/efervescente/adoentado/doentio/insalubre
sinusoidal	tortuoso/circunflexo/curvo
furibundo	bravo/zangado/raivosa/irado/irritado
vertiginoso	doente/enfermo
coesivo	adesivo
criminal	culpado
sem-teto	infortunoso/infeliz/miserável
próximo	vizinho/confidencial/futuro/querido/envolvente/circundante/íntimo/aproximado/acalorado/imediato/apenso/contíguo/familiar/adjacente/quente/iminente/calmoso/junto/próximo/perto
ideal	abstrato/aprimorado/perfeito
indigente	pobre
previsto	esperado
sênior	ancião
diagonal	oblíquo
controlado	possuído/obcecado
rosa_claro	cromático
nacroscópico	visível/grande
absoluto	inequívoco/arbitrária/inalienável/completo/infinito/implícito/discrionário/unívoco/arbitrário/integral/totalizado
abaixo	estabelecido
conforme	consistente
mais_jovem	júnior
seismico	instável/precário
rude	indelicado/impolido
fálico	varão/macho
bastante	confortável/suficiente/verde/torrencial/abudante/lauto/fácil/farto/bastante/basto/copioso/abundante
mais_velho	experiente/experimentado
subsequente	concomitante/posterior/conseqüente/anexado/ulterior/resultante/decorrente
da_moda	popular
refulgente	radiante/vivído/brilhante/luminoso/claro
de_ouro	metálico
anômalo	anormal/diferente
ajustado	alterado
miraculoso	sobrenatural/sobrecomum
semiautomático	automático
inverossímil	improvável
inegável	incontestável/irrefutável
alerta	insone/jeitoso/engenhoso/astuto/genial/hábil
averiguável	determinável
agradecido	simpático/agradecido/apreciativo/reconhecido/grato/obrigado/gratidão/agradável
meio	parcial/fracionário
onisciente	sábio
nivelado	plano/no_mesmo_nível
oblíqua	inclinado
permeável	poroso
sem_brilho	desinteressante/monótono/chato
peludo	pubescente/lanoso
breve	rápido/curto/rápida/veloz
Limpo	bem_bolado/em_ordem/asseado/limpado
Imagem_3D	multidimensional
triangular	angular/angulado
material	físico/substancial/tangível
rústico	provincial
isotônico	tenso
laborioso	intrincado/diligente/foda/difícil/árduo
roxo	cromático
hilário	humorístico/engraçado
usada	secundário
interdependente	dependente
progressivo	progressista/estado-da-arte/inovador/contemporâneo/moderno
desacompanhado	sem_igual/solitário/singular/único/única
marrom	cromático
sudeste	sulista
altista	optimista/otimista
sagrado	inviolável/sagrada/espiritual/inefável/divino/bendito/sublime/religioso/santa/sagrado/santo
garboso	demasiado_educado/luxuriante/luxuoso
dificil	endurecido/granítico/de_ferro
faltante	perdido
vantajoso	favorável/benéfico/afirmativo/construtivo/preferencial/positiva/bom/positivo/otimista/boa/discriminatório/profícuo/vantajoso/propício
constituinte	essencial
enorme	grande
glamouroso	emocionante/excitante
agencioso	activista/ativista
nova	original
desengoçado	desajeitado
o_mesmo	equivalente/sinótico/indistiguivel/correspondente/idêntico/que_não_pode_ser_distinguido/comparável
inteligente	racional/inato/sofisticado/ágil/brilhante/ligeiro
ligado	corrente/actual/atual
óbvio	axiomático/franco/transparente/patente/demonstrável/obvio/óbvio/manifesto/evidente
casado	casado
agoniado	pesaroso
antepenúltimo	intermédio
com_sono	adormecido
predominante	freqüente/frequente
sensual	físico/esquentado/voluptário/pornográfico/sexual/libidinoso/erótico/doidão/orgíaco/verde/matando_cachorro_a_grito/promíscuo/excitado/indecente/com_tesão/devasso/lascivo/quente
seguro	invulnerável/são_e_salvo/fixado/destinado/predeterminado/sã_e_salva/fixo
servil	servil/subserviente
sincrônico	síncrono/coexistente/contemporânea/concorrente/paralelo/moderna/simultânea/contemporâneo/coincidente/simultâneo/sincrônico
pirotécnico	extraordinário
caraterístico	típico/sintomático/distintivo
primitivo	temporão/precoce/cedo
malevolente	malicioso/perverso/maldoso
aquático	marinho/subaquático
com_pus	infectado/séptico
significante	operativa/monumental/notável
desatento	inconsiderado
derrelito	inabitado/desabitado
curioso	interessado/inusual/insólito/extraordinário/estranho
esmagador	irresistível
rosado	cromático
elétrico	emocionante/excitante
cósmica	grande
invisível	obscuro/ultravioleta/indetectável/escondida/infravermelho/escondido/imperceptível
desafiado	cego
terciário	ordinal
provável	suposto/provável
idiossincrático	individual
fulgurante	impressionante
obtenível	disponível
rachado	áspero
desatencioso	lasso/negligente
doce	brando
moreno	cromático
valente	bravo/heróico/animoso/destemido/valoroso/valente/afoito/arrojado/brava/corajoso
largo	panorâmico
maníaco	descontrolado/insano/selvagem
confiante	segurado/presunçoso/auto-confiante
diáfano	fino
retardado	demorado/idiota/retardado/tardio
cabalístico	esotérico
macho	masculino/varão/fálico/viril/varonil/masculina/macho
sem_cabeça	acéfala
onipotente	poderoso
arteiro	irónico/sapeca/traquinas/sarcástico/irônico/bagunceiro
culpável	culpado
ordinal	octagésimo/sexta/quadragésima/oitavo/zerésimo/décima/décimo_quarto/octagésimo_quinto/quadragésimo_quinto/centésimo_quadragésimo/setuagésima/centésimo_primeiro/vigésimo_primeiro/milionésima/vigésimo/qüinquagésima/centésimo_quadragésimo_quinto/décimo_terceiro/terciário/duodécimo/centésimo/1º/sétimo/nono/trigésimo/sexagésima/qüingentésima/segundo/décimo_primeiro/centésimo_quinto/quinto/milésima/nonagésimo/trigésima/milionésimo/quadragésimo/nonagésima/qüinquagésimo/setuagésimo/sexto/sexagésimo/qüingentésimo/milésimo/umsétimo/sétima/vigésima/enegésimo/centesimal/décimo_segundo/décimo/primeiro/terceiro/enésimo
tenebroso	escuro
atrapalhado	estranho/_esquisito
conseqüente	sem_remendos/subseqüente/subsequente/posterior/sem_emenda/ulterior/sem_improvisos
subjetivo	pessoal/preconceituoso
bonito	de_bom_aspecto/extraordinário/cênico/atraente/esplêndido/pitoresca/lindíssimo/pulcro/fantástico/bem_parecido/glorioso/pitoresco/bonito/precioso/magnífico/deslumbrante/maravilhoso/formoso/lindo/belo
ganancioso	cobiçoso/sequioso
crescido	maturo/maduro
diabético	doente/enfermo
espectacular	impressionante
enrugado	avariado/danificado
manco	inapropriado/débil
canceroso	canceroso/maligno
desalmado	inumano/desumano
existencial	empírico
sobrenatural	maravilhoso/barroco/metafísico/mágico/estranho/esquisito/misterioso/extravagante/milagroso/que_tem_efeito_extraordinário/miraculoso/bizarro
simétrico	bilateral/equilibrado/intercambiável/balanceado
infrequente	ocasional/raro
a_grande_altura	alto
frenético	doente/inquieto/selvagem/descontrolado/enfermo
de_antemão	cedo/precoce/temporão
solene	sério/ceremonioso/formal
dobrável	flexível
idílico	aprimorado/simpático/perfeito/agradável
úmido	aquoso/nevoeirento/pluvioso/húmido/desleixado/pegajoso/encharcado/pesado/chuvoso/cafona/esnobe_e_barato/fajuto/de_mau_gosto/molhado/úmido
que_se_pode_prever	previsível/inevitável/inexorável
jovial	ditoso
gasoso	gasoso/vaporoso
preguiçoso	desempregado
anónimo	incógnito/anónimo/anônimo
fugaz	curto
అత్యవసరం	energético/enérgico
consciencioso	cuidadosa/cautelosa/prudente/atento
mais_novo	júnior
menor	pequeno
intrigante	curisoso/confuso/interessante
discreto	prudente/judicioso/sensato
coexistente	síncrono/sincrônico
familiar	informal/conhecido/próximo/acostumado
justificável	desculpável
rotineiro	medíocre/assim_assim/cotidiano/banal/quotidiano/indiferente/mais_ou_menos
indefensável	vulnerável
preconceituoso	subjetivo
determinável	constatável/verificável/averiguável
teórico	especulativo/metafísico/hipotético
deplorável	ruim
volátil	inconstante/mutável/variável
acidente-accident-prone	inclinado/ter_queda_para
contíguo	vizinho/próximo/perto
militar	belicoso/marcial/guerreiro/combatente
biológico	natural
esplêndido	bonito/formoso/lindo/belo
à_prova_de_falhas	infalível
altivo	orgulhoso
adstringente	hemostático/acídulo/fermentado/azedo/desgradável
precário	inseguro/desassossegado/sísmico/temporário/vulcânico/seismico
classe_média	burguesa/burguês
décimo_segundo	ordinal
bilíngüe	multilingue/multilíngue
alternante	cíclico
atlético	ativo
indisponível	inacessível/não_adquirível
digno	precioso/distinto/impecável/digno_de_nota/de_mérito/modelar/modelo/interessante/que_vale_a_pena/louvável/merecedor/exemplar/valioso/notável/decoroso/digno
quente	tórrido/perto/tropical/ígneo/sensual/térmico/termal/próximo/vizinho/sexy
diferenciável	que_pode_ser_distinguido/distiguivel
grudento	sujo/adesivo/suja/sujado
dorminhoco	adormecido
semelhante	similar/relacionado
fundo	sem_fundo
gordurento	gordo/obeso
impenetrável	incompreensível
injuriante	prejudicial/nocivo/daninho/danoso
enjoativo	ofensivo
corruptível	corrupto
salubre	saudável/anictérico
recém-nascido	jovem/novo
mestre	habilidoso/talentoso
que_gosta_de_estudar	erudito
vernáculo	informal
experimentado	versado/mais_velho
virtuoso	impecável
desperdiçado	perdido
glacial	frio
psicadélico	inquieto/colorido/psicotrópico
ciente	sensato/vivo
guerreiro	militar
harmonioso	puro/compatível/sinfônico/consonante/suave
quadragésimo	ordinal
decidido	definitivo
desencorajador	desencorajante
duodécimo	ordinal
afetivo	emocional
bêbado	drogado/excitado/orgíaco/ligeiramente_embriagado/tocado/pedrado/excitada/entusiasmado/grogue
chuvoso	húmido/molhado/úmido
sem_pé_nem_cabeça	randômico/aleatório
aristocrático	nobre
oriental	oriental
obsequioso	prestável
amaro	arisco/desagradável
feroz	imisericordioso/silvestre/inumano/bravo/violento/tempestuoso/intensivo/intenso/desumano/zangado/raivosa/irado/irritado/selvagem/impiedoso
sem_improvisos	conseqüente/coerente/consequente/lógico
abudante	lauto/fértil/farto/bastante/basto/copioso/abundante/proveitoso/fecundo/frutífero
extra	aditivo/desnecessário/desnecessária
adesivo	coesivo/aderente/tenaz/viscoso/coerente/coeso/colante/grudento
pensativo	triste/destestável
190	cardinal/cardeal
exótico	inusual/estrangeiro/insólito/extraordinário/estranho
adorável	amorável
destruído	perdido/esfarrapado/ruim/estragado/enguiçado
claro	deslumbrante/pulvéreo/reluzente/brilhante/iridescente/prata/radiante/prateado/argênteo/refulgente/luminoso/faiscante/argentino
absurdo	tolo
tenro	mastigável/protector/jovem/sentimental
do_norte	azul/federal
intacto	indemne/intato/indene
compreensível	acessível/compreensível/abordável/entendível
redondo	esférico/global
zeloso	entusiástico/entusiasta
consertado	solidário
rápido	ativo/eficiente/preparado/ligeiro/instantânea/expresso/alado/acelerado/instantâneo/célere/breve/rápido/pronto/disposto/prestes/rápida/veloz
acurado	fiel/cirúrgico
umsétimo	ordinal
aerodinâmico	liso/macio
tórrido	esquentado/quente
qüinquagésima	ordinal
sábio	erudito/omnisciente/sagaz/ajuizado/sensato/prudente/onisciente
balanceado	simétrico/proporcional
não_adquirível	inacessível/indisponível
meio_caminho	intermédio
endurecido	dificil/resistente/grosso/dura/duro
tardio	póstumo/retardado
maquinal	involuntária
comum	democrático/inferior/comunitário/medíocre/informal/partilhado/assim_assim/crônico/cotidiano/frequente/público/banal/geral/usual/estatal/habituado/quotidiano/crónico/indiferente/habitual/freqüente/mais_ou_menos/inveterado
multidimensional	dimensional/tridimensional/Imagem_3D
multifatorial	complexo/intrincado
higiênico	sanitário
inequívoco	absoluto/explícito
desgraçado	desonroso/imoral
forçoso	obrigatório/essencial/imprescindível
incomum	extraordinário
novo	original/temporão/passado/virgem/revolucionário/recém-nascido/parvenido/novo/recente/parvenida/cedo
empoeirado	coberto
dirigente	poderoso
equipado	emestoque/fornecido/encarregado/mobilado/equipado
recorrente	contínuo
obcecado	controlado
textual	explícito/exato/preciso/correcto/certo
equilibrado	simétrico/proporcional
perpétuo	contínuo/permanente/duradouro
multicolorido	colorido
crepuscular	escuro
atroz	maléfico/malvada/alarmante/iniquo/mau/má/ruim/maléfica/malvado/inquietante
santo	bendito/sagrada/santa/sagrado/santo
grogue	embriagado/ébrio/bêbado/bêbedo
íngreme	perpendicular/abrupto/repentino/brusco
única	desacompanhado
furiosos	passional
eletrizante	emocionante/excitante
tranqüilo	constituído
proibitivo	preventivo
antediluviano	antigo/velho
excessivo	prolixo/desnecessário/desnecessária
invisual	cego/daltônico
neoclássico	clássico
público	nacional/comum/aberto/estadual/estatal
sinótico	mesmo/o_mesmo
sentencioso	sucinto/lacônico/conciso/lacónico
coeso	adesivo
hirto	caótico/muxibento/bagunçado/desmazelado/desordenado/mulambento
atingível	possível
que_está_por_aparecer	disponível
reduzido	baixo/remitente/atenue/reduzido/pequeno/baixa
hidrossolúvel	solúvel
alegórico	representativo
cinzento	acromático
gratidão	agradecido/apreciativo/obrigado
concetual	abstrato
cristão	cristão
sensorial	aferente
consistente	conforme/imutável/em_conformidade
belo	de_bom_aspecto/extraordinário/cênico/atraente/esplêndido/pitoresca/lindíssimo/pulcro/fantástico/bem_parecido/glorioso/pitoresco/bonito/precioso/magnífico/deslumbrante/maravilhoso/formoso/lindo/belo
afeiçoado	queama/carinhoso/afectuoso/amoroso
fatídico	decisivo
dominador	mandão/tirano/autoritário/opressivo/ditatorial/opressor
cubóide	cúbico/tridimensional
congenial	sociável/compatível
bagunceiro	brincalhão/travesso/arteiro
confuso	randômico/nublado/desconcertante/vago/intrigante/confuso/aleatório
antimicrobiano	saudável
frívolo	trivial/frívolo/leviano/informal/tonto/fútil
contemporâneo	chique/moderno/corrente/temporão/progressivo/contemporâneo/síncrono/cedo/sincrônico/actual/atual
leve	translúcido
nítrico	temporão/precoce/cedo
entristecedor	triste
adequado	aceitável/elegível/próprio/substancial/bom/apto/decoroso/vitoriano/correspondente/sólido/recatado_em_excesso/puritânico/capaz/apropriado/adequado/conveniente
esnobe	privado
salgado	salífero/saboroso/salobra
fofa	macio
suicida	perigoso
pormenorizado	cuidadosa/cautelosa/prudente/atento
entregue	devotado
sentimental	emocional/meigo/tenro
abrasivo	áspero
admirável	impressionante/aprazível/extraordinário
estrepitante	ensurdecedor/grande/vocal
verdejante	doente/enfermo
adoptivo	adoptivo/adotivo
evasivo	proteccionista
incerto	duvidoso/condicionado/perigoso/indefinido/ambivalente
amedrontado	receoso
obscurícoma	bronzeado/escareado/escuro
eficaz	habilitado/impressionante/competente
lauto	verde/torrencial/abudante/lauto/fácil/farto/bastante/basto/copioso/abundante
hidrófugo	impermeável
lânguido	letárgico
inadmissível	inaceitável
anônimo	incógnito/anónimo/anônimo
capaz_de_ser_provado_como_falso	empírico
indireto	secundário
lívido	bravo/iluminado/zangado/raivosa/irado/irritado
esguio	pequeno/tênue/esbelto/magro
imparcial	cor-cego/imparcial/indiferente
inconquistável	invencível/indomável/insuperável
malcuidada	avariado/danificado
contagioso	infeccioso/transmissível/contagioso
octagésimo_quinto	ordinal
antipático	sujo/mesquinho
estabelecido	abaixo/reconhecido/oficial
forçado	afetado/artificial
paranormal	psíquico
surdo-mudo	surdo
perigoso	periculoso/crítico/alarmante/suicida/traiçoeiro/incerto/insidioso/desesperado(a)/perigosa/arriscado/perigoso/desesperador/inquietante
regulamentar	legal
muitogrande	grande
insuperável	inconquistável
ambicioso	compulsivo/intrincado/agressivo/foda/difícil/árduo
amplo	espaçoso/panorâmico/grande/extenso/plenário/universal/súper/global/vasto/mundial/detalhado/amplo/abrangente/exaustivo
ambarino	cromático
xenófobo	receoso
fluorescente	iluminado/colorido
imune	isento
realizado	habilidoso/totalizado/integral/completo/talentoso
abordável	compreensível
beatificação	bom/boa
indisposto	doente/enfermo
acumulativo	cobiçoso/sequioso
digerível	assimilável
conquistável	possível
galáctico	grande
que_não_tem_razão	repreensível/errado/mau/enganado
impreciso	ter_muitos_significados/enigmático
proficiente	importante
lucrativo	rendoso/económico/rentável/econômico/lucrativo/proveitoso
isolado	privado/separado/inacessível/que_não_pode_ser_acessado
esotérico	arcano/misteriosa/enigmático/abstracto/obscuro/místico/abstruso/misterioso/abstrato/oculto/secreto/recôndito/cabalístico
cumplido	habilidoso/talentoso
recíproca	bilateral/interactivo/interativo
comutativa	independente
verdadeiro	indefectível/típico/legítimo/sério/genuíno/autêntico/verdadeiro/literal
arenoso	loiro/flavo
cronometrado	regular
saboroso	frutado/gostoso/acre/amargo/salgado/agridoce/saboroso/apetitoso/delicioso
terrestre	leigo/secular
imbecil	fátuo/burro/imbecil/idiota/sonso/estúpido
setuagésima	ordinal
500	cardinal/cardeal
ativista	agencioso/ativo
vicário	secundário/anormal
hostil	inóspito
sexagésima	ordinal
de_duração	longitudinal/comprido/infinito/longevo/por_toda_vida/demorado/perene/longo_prazo/incessante/prolixo/infinita/longo/prolongado/vitalício/duradouro/infindável/interminável
certificável	insano
ensanguentado	sangüíneo/sangrento
rudimentar	basilar
vertical	erétil/perpendicular/ortostático/honrado/fio_de_prumo/vertical
sem_uso	vão/inapto/inútil/impróprio
sintético	polisintético/f''/artificial
valioso	semiprecioso/decoroso/equivalente/magnífico/inestimável/impagável/sem_valor/que_não_tem_preço/precioso/opulento/digno
injusto	sujo
protector	tenro/meigo
inevitável	inexorável/que_se_pode_prever/destinado/predeterminado/inevitável/previsível
voluptuoso	indulgente
de_confiança	testado/comprovado
pesaroso	agoniado/fúnebre/lúgubre/amargo/lutuoso
extrangeiro	ao_estrangeiro/externo/internacional
drogado	embriagado/ébrio/bêbado/bêbedo
pedante	erudito
singelo	simplístico
pegajoso	húmido/molhado/úmido
cacheado	encaracolado/em_ondas/crespo
aromática	perfumado/cheiroso
iterativo	repetitivo
quatrocentos	cardinal/cardeal
sem_cor	pálido
lúgubre	pesaroso/triste
relutante	desafiador
escuso	torcido/torto/refrativo/ziguezagueante
francófono	comunicativo
periculoso	perigoso
ofensivo	injurioso/abominoso/desgostoso/fedorento/insuportável/terrível/desgostosamente/malcheiroso/nauseante/desagradável/nojento/repugnante/detestável/odioso/aborrecivel/enjoativo
organizado	metódica/corporativo/metódico
de_ascensão	optimista/otimista
negativo	destrutivo/desvantajoso/desfavorável
imisericordioso	feroz/mortal
oleoso	gordo/obeso
impermeável_ao_ar	invulnerável
hodierno	corrente/actual/atual
marginal	minimum/mínimo
farto	fértil/verde/torrencial/abundante/copioso/bastante/abudante/lauto/proveitoso/fecundo/frutífero/fácil
marinho	aquático/aquática
conotativa	intensional
aleatório	confuso/sem_pé_nem_cabeça/atabalhoado/estocástico/randômico/aleatório
gratuito	desnecessária/desnecessário
cónico	estreita/estreito
magro	tênue/cadavérico/anoréxico/extenuado/esguio/delgado/franzino/fino/esbelto/magro
ganhador	próspero/bem-sucedido/bem_sucedido
optimista	altista/alegre/de_ascensão
desolado	inóspito/inconsolável
de_convalescência	doente/enfermo
contemporânea	sincrônico/síncrono
multinacional	internacional
legível	legível
imprevisto	inesperado/não_previsto/imprevisto
invejável	desejável
proporcional	equilibrado/balanceado
afável	amigo/afável/amigável/amistoso/amável/gentil/lhano
1º	ordinal
comutativo	independente
maciço	pesado
do_pólo_sul	polar
virgem	novo/casta/puro/casto/castiço
assistente	subordinada/subordinado
morna	caloroso
pérfido	infiel
pior	pior/péssimo/último
interessante	colorido/atraente/decoroso/recreativo/fascinante/intrigante/absorvente/entretido/divertido/digno
feliz	ditoso/afortunado/_animador/bendito/animado/contente
mesmo	equivalente/sinótico/indistiguivel/correspondente/idêntico/que_não_pode_ser_distinguido/comparável
inteira	integral/inteiro
nefasto	terminal/fatal/mortal/letal
merecedor	decoroso/digno
canônico	ortodoxo
sincero	sério
científica	tecnológico
invulnerável	seguro/justo/intocável/impermeável_ao_ar/defensável/apertado/defendível/inatacável/inviolável
trágico	destestável/triste
apreciável	considerável
caseiro	caseiro/doméstico
setentrional	nórdico/azul/federal/nortista
espiritoso	alcoólico
síncrono	coexistente/contemporânea/concorrente/paralelo/sincrônico/moderna/simultânea/contemporâneo/coincidente/simultâneo
não_satisfeito	mal_sucedido/sem_sucesso
bicôncavo	côncavo/oco
particular	específico
enigmático	incompreensível/esotérico/indefinido/impreciso/ambíguo/vago/dúbio
esbranquiçado	acromático/opaco
errôneo	errado/incorreto
penúltimo	intermédio
documental	existente
barata	possível_financeiramente/pagável
figurativo	tropical/metafórico/poético/analógico
à_tona	à_deriva
sem_paradas	contínuo
limitado	moderado
consultor	noticioso/informativo
vadio	desempregado
difuso	prolixo
staccato	chocante/inopinado
disponível	descartável/à_venda/obtenível/que_está_por_vir/disponível/a_ser_lançado/a_ser_publicado/comprável/adquirível/visível/que_está_por_aparecer/que_vem
necessário	requerido/imprescindível/indispensável/obrigatório/essencial
manso	dócil/suave
entusiasmado	embriagado/louco/nervoso/ébrio/bêbado/reage
castanícoma	bronzeado/escareado/escuro
ileso	indene/indemne
cansado	fatigado/extenuado/esfarrapado/exausto/morto_de_cansado/cansado/cansada
abominável	alarmante/execrável/maléfico/Detestável_em_alto_grau/abominável/odioso/detestável/mau/má/ruim/maléfica/malvado/inquietante
zombador	desrespeitoso
melancólica	triste/destestável
azedo	desgradável/cortante/ácido/adstringente/acerbo/picante/azedo/fermentado/acídulo
franco	evidente/obvio/óbvio
relaxado	lasso
deficiente_físico	inapropriado
sem_conforto	incômodo/incómodo/desconfortável/pouco_à_vontade
desvantajoso	negativo
acrobático	ativo
assado	cozinhado
faiscante	radiante/vivído/brilhante/luminoso/claro
emocionante	elétrico/de_tirar_o_fôlego/glamourosa/glamouroso/glamoroso/prestigioso/sem_fôlego/eletrizante
implacável	implacável
egoísta	orgulhoso
caloso	resistente/grosso
alérgico	suscetível/susceptível
temível	inquietante/alarmante
arriscador	aventureiro
importuno	suplicante
deslumbrante	radiante/bonito/vivído/brilhante/luminoso/claro/formoso/lindo/belo
que_ama	queama/carinhoso/afectuoso/amoroso
estruturado	orgânico
áspero	abrasivo/cacofônico/arisco/montanhoso/rachado/anguloso/áspero/rochoso/acidentado/desagradável/pedroso/pedregoso
pulvéreo	claro/fino
sobrecomum	maravilhoso/barroco/metafísico/mágico/estranho/esquisito/misterioso/extravagante/milagroso/que_tem_efeito_extraordinário/miraculoso/bizarro
suplementar	secundário/aditivo
chaminés_(indústria)	movente
diminuto	fino/pequeno
profano	secular/_laico
anémico	débil
abandonado	irrestrito/inabitado/desabitado
rígida	inflexível
chicaneiro	crítico
infame	mal_afamado
impiedoso	feroz/mortal
consumado	habilidoso/talentoso
biogênico	essencial
caprichoso	inconstante
limpo	limpável/limpo/imaculado
penetrante	perspicaz
atempado	apropriado
não_cumprido	mal_sucedido/sem_sucesso
massudo	grande
requerido	necessário/essencial
do_nordeste	nórdico/nortista
gordo	adipose/sujo/gorducho/rechonchuda/oleoso/amanteigado/pançudo/gordo/corpulento/viçosa/rechonchudo/roliço/gordurento/grosso/gorduroso/espesso/obeso/abdominal/encorpado/suja/sujado
obrigado	agradecido/reconhecido/grato/gratidão
barato	possível_financeiramente/pagável
guloso	voraz
sucinto	elíptico/sentencioso/compêndio/sumário/sucinto/curto/lacônico/conciso/lacónico
bilateral	recíproca/simétrico/recíproco/mútuo
étnico	social
à_venda	disponível
cuidadosa	minucioso/consciensiosamente/elaborada/pormenorizado/circunstanciado/elaborado/consciencioso
pluricelular	celular
homossexual	transexual/lésbico/bicha/transsexual/veado/gay
inalienável	intransmissível/absoluto/inviolável
pagável	devido/barata/vencido/barato
estatal	comum/público
poderoso	dirigente/forte/influente/constrangedor/omnipotente/poderoso/potente/todo-poderoso/onipotente
dominante	supremo/ascendente/preponderante/o_mais_alto_na_escala/soberano/primordial/dominante/preeminente
silencioso	quiet/quieto/silencioso
chato	dessecado/sem_brilho/sem_vitalidade
biónico	f''/artificial
indiscreto	imprudente
quíntuplo	múltiplo
diário	periódico/periodico
determinante	decisivo
curativo	saudável
externo	exterior/alienígena/externo/estrangeiro/extrangeiro
comercial	inferior/mercantil
c	cardinal/cardeal
radical	basilar
queda_de_rendimento	lasso
inigualável	incomparável
heterocíclico	cíclico
quedo	imóvel
carismático	atraente
beato	salvado
bombástico	retórico
sã_e_salva	seguro
polar	antártico/frio/ártica/do_pólo_sul/antárctico/ártico
estéril	inóspito/infértil/estéril/improdutivo
aventureiro	arriscador/arriscado/destemido/ousado/audaz/audacioso
coletivista	socialista
influente	possante/importante/prestigioso/potente/poderoso
extrajudicial	ilegal
informado	sensato/vivo
eleitoral	eleito
lhano	afável/amável
audacioso	aventureiro/ousado/heróico/Inconsequente/audacioso/temerário/intrépido/audaz/bravo/destemido/corajoso
subordinada	auxiliar/secundário/adjunto/assistente
que_se_pode_detectar	observável/marcado/detectável/evidente
intolerável	inaceitável/insuportável/amargo/intolerável
antropomorfo	humano
imperceptível	invisível
vistoso	colorido/insípido
160	cardinal/cardeal
supersticioso	irracional
nevoso	coberto/acromático
acinzentado	acromático
asseado	Limpo
formigueiro	impressionante
picada_de_vermes	desgastado
exploratório	preliminar
em_pó	fino
menstruada	doente/enfermo
desabrigado	vulnerável
plano	horizontal/plano/nivelado/no_mesmo_nível
bem_parecido	bonito/formoso/lindo/belo
lírico	emocional
natural	físico/biológico/biológica/normal
estético	artístico/cosmético
autônomo	independente/livre/involuntária/involuntário/gratís
permanente	irreversível/eternos/indissolúvel/interminável/eterno/eternas/perene/eterna/sem_idade/perpétuo/imperecível/duradouro
moderno	corrente/progressivo/chique/contemporâneo/actual/atual
predisposto	inclinado/ter_queda_para
centésimo	ordinal
culpado	envergonhado/censurável/punível/criminoso/criminal/reprovável/repreensível/culpável/passível
lotado	cheio_demais/intocado/estufado
respectivo	individual
bonita	atraente
austral	sulista
mal_nutrido	desnutrido/faminto
intocável	invulnerável
faminto	mal_nutrido/esfomeado/faminta/com_fome/esfomeada/faminto/desnutrido
acelerado	rápido/rápida/veloz
ocidental	ocidental
impressionado	afetado
sem_precedentes	desconhecido
seletivo	exclusivo/discriminatório
relativo	relacional
curvo	semicircular/sinusoidal/sinuoso/curvilíneo
incisivo	perspicaz
final	definitivo
sumido	perdido
desiludido	mal_sucedido/sem_sucesso
sexta	ordinal
reusável	útil
conspícuo	proeminente/importante/ilustre
eufónico	suave
luxuoso	gracioso/esbelto/garboso/airoso/elegante
indulgente	favorável/permissivo/decadente/voluptuoso
infinita	infinito/de_duração
salífero	salgada/salgado
fornecido	emestoque/encarregado/equipado
prestativo	duradouro/funcional/utilizável/durável/usável/duradoiro
excitante	elétrico/de_tirar_o_fôlego/glamourosa/glamouroso/glamoroso/prestigioso/sem_fôlego/eletrizante
multipotente	potente
inato	inteligente
sangue-vermelho	cromático
um_mil	cardinal/cardeal
arriscado	alarmante/aventureiro/perigoso/inquietante
sem_remendos	conseqüente/coerente/consequente/lógico
centésimo_quadragésimo	ordinal
milagroso	sobrenatural/sobrecomum
milésimo	ordinal
inexplicável	misterioso/paradoxal/misteriosa
periódico	raro/mensal/cíclico/semanal/diário/anual/trienal/quinzenal/trianual/casual/esporádico
borbulhante	efervescente
concordado	unido
empreendedor	empresarial/diligente
bimetálico	metálico
invariante	invariável
dilapidados	avariado/danificado
responsável	refutável/sujeito/fidedigno/responsable/responsável
sem_sentido	insignificante/insignificanta
baio	cromático
rabo	posterior
mais_ou_menos	rotineiro/costumeiro/comum/ordinário/normal
que_oferece_vários_aspectos	diferente
despercebido	esquecido
adotivo	adoptivo/adotivo
incremental	aditivo
suposto	crível/improvável/provável/acreditável
apertado	justo/invulnerável
operoso	diligente
estocástico	randômico/aleatório
metade_do_caminho	intermédio
fechado	restrito/comprimido/cercado/rodeado/delimitado
passado	recente/vetusto/histórico/pré-histórico/anterior/antigo/último/medieval/novo/prévio/antiga/passado
severo	intenso/intensivo
senil	velho
elaborado	cuidadosa/cautelosa/prudente/atento
levado	ruim
fisiológico	físico
dramático	espetacular/impressionante/melodramático
unido	confederativo/convindo/unitário/incorporado/coalescente/concordado/combinado/determinado/aliado/unificado/integrado
cavernoso	oco/vazio
chocada	receoso
cúbico	cúbico/cubóide/tridimensional/isométrico
opressor	dominador
esticado	tenso
partidário	favorável
devotado	dedicado/entregue
elevado	nobre/alto
dirigível	manipulável
sinuoso	tortuoso/circunflexo/curvo
autoritário	dominador
alternativa	cíclico
simultânea	síncrono/sincrônico
malévolo	malicioso/perverso/maldoso
obeso	adipose/oleoso/amanteigado/gordo/gordurento/gorduroso
trezentos	cardinal/cardeal
abundante	verde/torrencial/abudante/lauto/fácil/farto/bastante/basto/copioso/abundante
infalível	à_prova_de_falhas/à_prova_de_erros
pasmado	receoso
triunfante	próspero/bem-sucedido/bem_sucedido
de_perito	oficial
utópico	visionário
vário	diverso/variável
pomposo	presumido
primeira	primeiro
vangloriosa	orgulhoso
educativo	noticioso
assassinado	semvida/morto
hidrófilo	esponjoso
risível	tolo
cauteloso	moderado
gratificante	aprazível
não_oficial	informal
proteccionista	evasivo/contraceptivo/esquivo
chocado	receoso
secundário	auxiliar/subordinado/tributário/indireto/usada/vicário/alternativo/colateral/adicional/subordinada/suplementar
refletivo	vazio
consequente	sem_remendos/sem_emenda/sem_improvisos
predileto	popular
quadragésimo_quinto	ordinal
fecundo	produtor/prolífico/generoso/fertilizável/fecundo/farto/abudante/produtivo/fértil
gradual	emrampa
qüingentésima	ordinal
imperecível	permanente/duradouro
pontual	pontual/tempestivo/sem_demora
auto-suficiente	independente
cruel	inumano/desumano
salutar	saudável
infernal	desagradável/maléfico/mau/má/ruim/maléfica/malvado/arisco
mentiroso	falso/errado
rectangular	angular/angulado
saciado	contente
sem_cuidado	lasso/negligente
escurecido	velho
calculável	computável
fixado	seguro/geoestacionário/estacionário/firme
gestante	grávida
fundamentado	válido
propício	benéfico/preferencial/positiva/oportuno/vantajoso/bom/positivo/boa/propício/favorável/discriminatório
auxiliar	secundário/subordinada/subordinado
penitente	penitencial
transversal	horizontal/transversal/transverso
último	passado/improvável/corrente/pior/actual/atual
maligno	canceroso
tricolor	colorido
solteiro	divorciado
fatal	nefasto/terminal/mortal/letal/fatal
malcomportado	indelicado/impolido
normal	medíocre/modal/assim_assim/típico/cotidiano/média/banal/natural/normal/quotidiano/indiferente/mais_ou_menos/médio
oculto	esotérico
impeditivo	preventivo
mil	cardinal/cardeal
sem_valor	precioso/valioso
lipófilo	solúvel
consultivo	noticioso/informativo
mentalmente_sadio	lúcido
insubstancial	etéreo
libidinoso	sensual/sexy
racial	birracial/racista
crucial	fundamental/importante/decisivo/crítico
fatigado	extenuado/esfarrapado/exausto/cansado/morto_de_cansado
apático	letárgico/desinteressado
apocalíptico	profético
potente	multipotente/poderoso/forte/influente
masculino	varão/viril/macho/varonil
místico	irreal/esotérico/não_material
panorâmico	largo/ampla/amplo
deleitado	satisfeito/contente
imprescindível	necessário/obrigatório/indispensável/forçoso/crítico/compulsório/vital/essencial/imprescindível
inexpressível	reservado/não_comunicativo
exaustivo	amplo/completo/extenso/plenário/universal/súper/global/mundial/integral/totalizado
esquivo	proteccionista
mundial	internacional/extenso/detalhado/amplo/abrangente/exaustivo
enfatuado	queama/carinhoso/afectuoso/amoroso
aplicável	relevante/pertinente
salobra	salgada/salgado
idiota	retardado/fátuo/burro/imbecil/idiota/sonso/estúpido
deprimido	falta_de_esperança/fino/desesperado
carinhoso	queama/que_ama/apaixonado/enfeitiçado/terno/cálido/meigo/enfatuado/afeiçoado/carinhoso/afectuoso/amoroso
estrangeiro	ao_estrangeiro/externo/internacional/estranho/exótico/estrangeiro
tolerante	paciente
combinável	combinatório
compulsivo	ambicioso
específico	especificado/circunstancial/ad_hoc/nominal/mero/especial/particular/avulso/Ad-hoc/próprio/peculiar/específico
muito_bom	bom/boa
alienígena	ao_estrangeiro/externo/internacional
anexado	subseqüente/subsequente/posterior/ulterior
progressista	progressivo/chique/liberal
maternal	materno
incolor	pálido
contrário	antônimo/malvado
segurado	confiante
arisco	infernal/amargoso/áspera/lamentável/pavoroso/áspero/dolorido/acre/triste/amaro/virulento/terrível/acerbo/animal/horrível/amargo/cáustico/doloroso
quádruplo	múltiplo
dedicado	devotado
sétimo	ordinal
fantástico	irreal/inusual/bonito/insólito/extraordinário/estranho/formoso/lindo/belo/não_material
mecanizado	mecânico
separável	divisível
fervoroso	entusiástico/entusiasta
destestável	triste/melancólica/pensativo/agridoce/trágico/lutuoso
dilapidada	avariado/danificado
rentável	rendoso/lucrativo/proveitoso
relativo_a_ou_característico_de_Proteus	variável
tépido	caloroso
coletivo	solidário/socialista
escarlate	colorido
vívido	ditoso/vivo
terapêutico	saudável
desesperador	perigoso
fúnebre	pesaroso
grosseiro	indelicado/impolido
alucinogênico	psicotrópico
homo	transexual/lésbico/bicha/transsexual/veado/gay
estaladiço	fresco/recente
anoréxico	tênue/esbelto/magro
espiritual	sagrado/imaterial
azul	setentrional/cromático/do_norte/boreal
ter_muitos_significados	indefinido/impreciso/ambíguo/vago/dúbio
cândido	crédulo/ingénuo
tridimensional	cúbico/multidimensional/cubóide/isométrico
transcontinental	continental
horrendo	triste
verificável	determinável
eficiente	rápido/impressionante/habilitado/econômico/económico/competente
dinâmico	cinético/propulsores/marcado_pela_mudança_constante/semovente/autopropelido/em_constante_mudança/que_muda_constantemente
sem_vitalidade	desinteressante/monótono/chato
teso	inflexível
indolor	fácil
preditivo	profético
procedente	relevante/pertinente
anglófono	comunicativo
derrelicto	inabitado/desabitado
pornográfico	sensual/sexy
substantivo	significativo/essencial
bicolor	colorido
crescente	aumentativo
onipresente	presente
judicial	legal/crítico
parlamentar	democrático
exíguo	escasso
afortunado	bom/sortudo/fortuito/contente/feliz/sortuda/boa
imaculado	puro/limpo
combinacional	combinatório
saibro	acromático
poético	retórico/figurativo
invariável	constante/imutável/inalterável/invariante/invariável
friável	solto
mítico	irreal/não_material
não_realizado	mal_sucedido/sem_sucesso
boreal	azul/federal
nojento	ofensivo
aristocrata	nobre
quantificável	quantitativo
durável	prestativo
abstruso	esotérico
refrativo	escuso
judicioso	discreto
eminente	alto
cardeal	meia_dúzia/c/160/500/cem_mil/dez_mil/bilhão/quarenta/mil/trilhão/5/cento_de_noventa/uno/dois/duzentos/cento_e_oitenta/trezentos/noventa_e_nove/quatrocentos/onze/cento_e_sessenta/milhar/190/180/quinhentos/um_mil/1000/2/V/cinco
discriminatório	discriminativo/favorável/eclético/selectivo/seletivo/profícuo/vantajoso/propício
fertilizável	fecundo/fértil
informal	ordinário/não_oficial/frívolo/familiar/vernáculo/Vernáculo/comum/coloquial/oficioso/fútil
verde-azeitona	cromático
assimilável	digerível
sadio	lúcido
aderente	adesivo
compulsório	obrigatório/essencial/imprescindível
nominal	específico/especificado
impressionável	suscetível/susceptível
viscoso	adesivo/espesso/Família_de_Tyrogue
arbitrário	absoluto
inadequado	inelegível/insuficiente/incompetente/incapaz
tênue	cadavérico/anoréxico/magro/extenuado/esbelto/esguio/delgado/franzino/fino
co-igual	parelho/idêntico/igual/análogo
galático	grande
lanoso	macio/peludo/peluda
étnica	social
esbanjador	destrutivo
exasperante	intensificador
encardido	sujo/suja/sujado
subalterno	feudal/súdito/subserviente
subagudo	pontiagudo
detalhado	amplo/extenso/plenário/universal/súper/global/mundial
agridoce	triste/saboroso/destestável
solidário	coletivo/simpática/consertado/cooperativo/corporativo
confiável	testado/comprovado
personalizado	pessoal/sob_medida
lilás	cromático
estofado	adornado
nebuloso	triste
bem-sucedido	produtivo/vitorioso/próspero/lucrável/triunfante/viçoso/ganhador
Professor_Emérito	velho
assíduo	diligente
imunda	sujo/suja/sujado
convexo	biconvexo
destacado	superior
intransigente	inflexível
hepatotóxico	tóxico
Inconsequente	audacioso/audaz/bravo/destemido/corajoso
exímio	superior
anacrônico	assíncrono
irrecuperável	Sfumato/sfumato
indissolúvel	permanente/duradouro
significativo	significativo/operativa/comunicativo/monumental/notável/substantivo/substancial
aveludado	liso/macio
casto	moral/virgem/virginal
pusilânime	covardemente/covarde/cobarde
prematuro	temporão/precoce/cedo
encarregado	fornecido/mobilado/equipado
estrito	exato/preciso/correcto/certo
avançado	precoce/alto/dianteiro
vigésimo	ordinal
ininterrupto	contínuo
sequioso	voraz/predatório/possessivo/cumulativo/avaro/ávido/ganancioso/acumulativo/predador
irrefutável	que_não_se_pode_contestar/que_não_se_pode_negar/inegável
médio	moderado/normal
bifocal	central
jovem	recém-nascido/terno/pequeno/juvenil/cedo/infantil/pré-adolescente/temporão/tenro/vulnerável
nanico	pequeno
classificado	agrupado/categorizado
nordestina	nórdico/nortista
invasivo	agressivo
espaçoso	amplo
bicúspide	angular/angulado
penal	punitivo/ilegal
arcano	esotérico
entreaberta	aberto
facultativo	opcional
rica	rico/afluente
propulsores	dinâmico
deslizante	escorregadio
selvagem	feroz/maníaco/delirante/caótico/frenético/fero
interdito	ilegal
cumprido	habilidoso/talentoso
conciso	elíptico/sentencioso/compêndio/sumário/sucinto/curto/lacônico/conciso/lacónico
diferente	incomun/variado/separado/outro/que_oferece_vários_aspectos/anômalo/antitético/sortido/diferente/distinto/vários/diverso/divergente/estranho/inusual/insólito/extraordinário
controverso	discutível/polémico/conflituoso/polêmico/controverso
desencorajante	desencorajador/desalentador
mental	doente/parapsíquico/intelectual/moral/psicológico/racional/psíquico/adoentado/doentio/insalubre
impecável	virtuoso/aprimorado/digno/nobre/perfeito
clínico	não_subjetivo/objetivo
funcional	prestativo/prático/útil/estrutural
brioso	nobre
cacofônico	rouca/estridente/áspero/rouco/rouquenho
adulterino	infiel
obvio	axiomático/franco/transparente/patente/demonstrável/óbvio/evidente/manifesto
pronto	imediato/rápido
humorístico	hilária/ridículo/sutil/gracejador/irônico/busseta/engraçado/espirituoso/jocoso/hilário/hilariante/cômico/divertido/grotesco
de_segunda_mão	antigo/velho
ilícito	ilegal/extraconjugal
improvável	incrível/último/suposto/inverossímil/inacreditável
amargo	saboroso/intolerável/pesaroso/arisco/desagradável/insuportável
excitada	embriagado/louco/nervoso/ébrio/bêbado
desorganizado	caótico/perplexo
impossível	não_realizável/impossível/desesperado/impraticável
intangível	imaterial
ensurdecedor	estrepitante/tempestuoso/alta/berrante/alto
à_deriva	à_tona/flutuante
seccional	territorial
desnutrido	mal_nutrido/faminto/desnutrido
secular	profano/mundano/terrestre
afluente	rica/rico
aliviar	confortável
transformado	mudado/trocado
próspero	produtivo/vitorioso/próspero/lucrável/triunfante/viçoso/ganhador/bem-sucedido/bem_sucedido
desenhado_à_mão	original
anormal	defeituoso/anômalo/aberrante/irregular/vicário
exclusivo	privilegiado/selectivo/seletivo
destemido	aventureiro/ousado/heróico/Inconsequente/audacioso/temerário/intrépido/valoroso/valente/afoito/arrojado/brava/audaz/bravo/destemido/corajoso
completo	realizado/total/exaustivo/completo/absoluto/inteiro/integral/totalizado/completado/completa
empinado	alto
lindo	de_bom_aspecto/extraordinário/belo/cênico/atraente/esplêndido/pitoresca/lindíssimo/pulcro/fantástico/bem_parecido/lindo/formoso/glorioso/pitoresco/bonito/precioso/magnífico/deslumbrante/maravilhoso
fervente	entusiástico/entusiasta
irônico	humorístico/brincalhão/engraçado/travesso/arteiro
minucioso	cuidadosa/cautelosa/prudente/atento
lúcido	mentalmente_são/são/sadio/mentalmente_sadio/sã
tenso	nervoso/isotônico/esticado/tenso/irritável
mulambento	eriçado/hirto
trocado	transformado/alterado
perene	contínuo/de_duração/permanente/duradouro
sonoro	suave
multicelular	celular
emestoque	equipado/mobilado/fornecido
quebrado	avariado/falido/danificado
orgulhoso	satisfeito/convencido/imodesto/presunçoso/ranhoso/imperioso/egoísta/vanglorioso/altivo/orgulhoso/vangloriosa/ufano/soberbo/arrogante
intenso	puro/profundo/sensasional/forte/brutal/violento/esmero/severo/terrível/veemente/intenso/maior/feroz/horrível/intensivo
emergente	futuro
o_mais_alto_na_escala	dominante
gracioso	elegante/demasiado_educado/luxuriante/fluente/luxuoso/fluido
medonho	inquietante/alarmante
voado	aliforme
em_constante_mudança	dinâmico
fosforescente	iluminado
barroco	sobrenatural/sobrecomum
de_renome	sabido
inábil	incoveniente
arejado	ventilado
queama	que_ama/amoroso/apaixonado/enfeitiçado/terno/carinhoso/cálido/meigo/enfatuado/afeiçoado/afectuoso
corpóreo	físico/corporal/corporativo
visível	visual/aberto/disponível/nacroscópico/microscópico
intrincado	frustrante/complexo/complicada/ambicioso/controvertido/arduo/cheio_de_espinhos/tortuoso/difícil/sensitivo/multifatorial/labiríntico/convoluto/laborioso/cócegozo/desafiador/desconcertante/complicado/problemático/espinhoso/intrincado/colonial
delgado	tênue/esbelto/magro
crédulo	cândido
plenário	extenso/detalhado/amplo/abrangente/exaustivo
multilingue	bilíngüe/trilíngüe
evidente	definitivo/percebível/axiomático/franco/transparente/patente/demonstrável/obvio/óbvio/manifesto/evidente/que_se_pode_detectar
quinto	ordinal
gélido	frio
subseqüente	concomitante/posterior/conseqüente/anexado/ulterior/resultante/decorrente
alto	ensurdecedor/graduado/magestoso/mais_alto/alto_nível/derradeiro/empinado/acima/grande/vocal/disparado/avançado/capitanear/superior/alto/eminente/elevado/a_grande_altura
tranquilo	constituído
reto	direito/perpendicular/bom/justo
terno	jovem/árduo/queama/dolorido/doloroso/extenuante/doído/carinhoso/afectuoso/amoroso
punível	culpado
maçante	opaco
alucinatório	irreal/não_material
equivalente	precioso/parelho/mesmo/idêntico/igual/análogo/o_mesmo/valioso
para_o_nordeste	nórdico/nortista
intensivo	profundo/sensasional/forte/brutal/violento/esmero/severo/terrível/veemente/intenso/maior/feroz/horrível/intensivo
eqüidistante	parelho/idêntico/igual/análogo
escancarado	aberto
meigo	protector/queama/sentimental/carinhoso/afectuoso/amoroso
ad_hoc	específico
azul-petróleo	cromático
coral	cromático
integrante	intrínseco/intrínseca
cadavérico	tênue/esbelto/magro
decadente	indulgente
hereditário	herdável
insidioso	prejudicial/perigoso/nocivo/daninho/danoso
cossangüineo	relacionado
preemptivo	preventivo
brusco	repentina/íngrime/íngreme/súbito/abrupto/repentino
inativo	inerte
censurável	culpado
húmido	aquoso/nevoeirento/pluvioso/húmido/desleixado/pegajoso/encharcado/pesado/chuvoso/cafona/esnobe_e_barato/fajuto/de_mau_gosto/molhado/úmido
danoso	malicioso/difamatório/insidioso/deletério/prejudicial/fraudulento/catastrófico/mal/calunioso/abusivo/injuriante/infamante/perverso/maldoso/nocivo/daninho/danoso
ártica	polar
vigente	corrente/actual/atual
secreto	privado/esotérico
traseiro	mais_hindmost/posterior/traseiro/de_trás
principal	essencial/importante/primeiro
inapropriado	ruim/manco/incongruente/deficiente_físico/mole/aflito/deficiente/brando/estropiado/aleijado/fofo/flácido/perneta/coxo/capenga/frouxo
áspera	desagradável/arisco
longitudinal	de_duração
cedo	jovem/nítrico/antes_da_hora/de_antemão/mirim/contemporâneo/primitivo/incipiente/novo/primordial/primitiva/prematuro/anterior/o_mais_cedo/mais_cedo
amistoso	social/amável/afável
mimoso	refinado/cultivado/gentil
aliado	unido
demonstrativo	noticioso
inestimável	precioso/valioso
marcial	militar
sem_vida	semvida/vazio/morto
inutilizável	vão/inapto/inútil/impróprio
venenosa	tóxico
incógnito	anónimo/anônimo
testável	empírico
nobre	elevado/impressionante/imperial/impecável/aristocrata/brioso/senhorial/magnânimo/aristocrático/sublime/real
bendito	sagrada/feliz/santa/sagrado/santo/contente
rubicundo	colorido
envelhecido	desgastado
sem_tensão	lasso
sintomático	característico/caraterístico
vencido	que_não_foi_pago_na_data_certa/pagável/coletável
discontente	rebelde/descontente
cozinhado	queimado/gratinado/Saltear/assado/saltear
penitencial	penitente
respetivo	individual
ruivo	cromático
decoroso	próprio/precioso/digno/digno_de_nota/de_mérito/modelar/modelo/interessante/que_vale_a_pena/louvável/merecedor/exemplar/valioso/notável/adequado/conveniente
obediente	condescendente/aquiescente
recto	direito/bom/justo
covardemente	pusilânime
torto	escuso/assimétrico
apaixonado	queama/carinhoso/afectuoso/amoroso
brunícoma	bronzeado/escareado/escuro
esperável	esperado
coberto	rebocado/empoeirada/nevoso/encharcado/empoeirado
pragmático	prático/realístico
sem-abrigo	infortunoso/infeliz/miserável
inconformista	esquisito/bizzaro/alternativo/bizarro/estranho
dois	cardinal/cardeal
avaro	cobiçoso/sequioso
deteriorado	disfuncional
paralelo	síncrono/sincrônico
acídulo	cortante/ácido/adstringente/acerbo/picante/azedo
lucrável	próspero/bem-sucedido/bem_sucedido
minúsculo	pequeno
vizinho	próximo/contíguo/acalorado/quente/calmoso/junto/perto
inventivo	original/capaz/criativo/criador
atraente	irresistível/belo/interessante/fotogênico/carismática/linda/carismático/lindo/fotogénico/formoso/bonita/bonito/chamativo
avariado	enrugado/malcuidado/malcuidada/dilapidados/dilapidada/dilapidado/dilapidadas/quebrado
do_noroeste	nórdico/nortista
interior	interno
privado	secreto/pessoal/isolado/confidencial/esnobe/privado
abominoso	ofensivo
ligeiro	rápido/inteligente/ativo/rápida/veloz
condenado	maldita/maldito
excepcional	extraordinário/superior
preferível	desejável
antártico	polar
insuficiente	inadequado/insuficiente/escasso
presumido	insípido/pomposo
interativo	recíproca/recíproco/mútuo
poroso	permeável
supercrítico	crítico
tendencioso	parcial
fiável	testado/comprovado
defensável	invulnerável
virginal	puro/casta/casto/castiço
fusiforme	pontudo
comemorado	glorioso/sabido
reutilizável	útil
arcaico	antigo/velho
rígido	imóvel/inflexível
infamante	imoral/prejudicial/nocivo/daninho/danoso
habilitado	eficaz/capaz/eficiente
fracionário	fragmentário/meio/metade
abreviado	curto
alarmante	pesadelar/assustador/ameaçador/abominável/macabro/arriscado/horripilante/medonho/calamitoso/ominoso/terrível/temido/pavoroso/temível/cabeludo/horrível/atroz/perigoso
sapiente	erudito
detectável	percebível/que_se_pode_detectar
áureo	cromático/metálico
imaterial	espiritual/intangível
crítico	adoentado/discriminativo/supercrítico/essencial/fundamental/chicaneiro/perigoso/perigosa/decisivo/crítico/grave/trapaceiro/judicial/imprescindível/que_não_pode_ser_dispensado/indispensável/importante/crucial
daninho	difamatório/insidioso/deletério/prejudicial/fraudulento/catastrófico/mal/calunioso/abusivo/danoso/injuriante/infamante
espantoso	surpreendente
meridional	sulista
varonil	masculino/masculina/macho
entre_dois_extremos	intermédio
encarnado	cromático
ditoso	alegre/jubiloso/extático/festivo/jovial/feliz/contente/vívido
casadoiro	maturo/maduro
reluzente	radiante/vivído/brilhante/luminoso/claro
debilitado	débil
contínuo	repetitivo/perene/consecutivo/persistente/incessante/sem_paradas/constante/recorrente/perpétuo/ininterrupto/contínuo/insistente
errado	incorrecto/mentiroso/erróneo/falaz/errôneo/que_não_tem_razão
falador	comunicativo
brando	doce/inapropriado
ermo	triste
inacessível	isolado/distante/inacessível/não_adquirível/indisponível/que_não_pode_ser_acessado
astronômico	grande
defeituoso	anormal/imperfeito
estado-da-arte	progressivo
condescendente	obediente
primeiro	original/ordinal/arquetípico/inicial/principal/primeira/primeiro
bizzaro	inconformista/não_convencional
condicionado	tentativo/incerto/dependente/provisória/provisório/temporário/eventual
petimetre	erudito
quarenta	cardinal/cardeal
falaz	errado/incorreto
decimal	quantitativo
adquirível	disponível
envoltória_convexa	biconvexo
cautelosa	minucioso/consciensiosamente/elaborada/pormenorizado/circunstanciado/elaborado/consciencioso
canhoto	canhoto
intercambiável	substituível/simétrico
lácteo	opaco
determinado	explícito/unido
magnífico	bom/precioso/impressionante/superior/extraordinário/bonito/boa/valioso/formoso/lindo/belo
persistente	contínuo
habitável	habitável
refrigerante_(mecânica)	frio
rouquenho	cacofônico
de_mau_gosto	húmido/molhado/úmido
hesitante	perplexo
inocente	irrepreensível/que_não_causa_danos/irreprochável/inocente/inócuo/sem_culpa/inofensivo
antecipado	esperado
contente	_animador/bendito/afortunado/ditoso/deleitado/cheio_de_si/alegre/saciado/sorridente/divertido/radiante/risonho/convencido/feliz/presunçoso/vaidoso/satisfeito/animado/contente
súbito	escarpado/explosivo/fulminante/repentino/abrupto/brusco
económico	rendoso/parcimonioso/eficiente/lucrativo/proveitoso
sortuda	afortunado
exigente	cuidadoso/detalhista/exigente
inclinado	propenso/oblíqua/predisposto/enviesado/esguelhado/acidente-accident-prone/tendente
cento_e_sessenta	cardinal/cardeal
erróneo	errado/incorreto
sexto	ordinal
inóspito	desolado/inóspito/hostil/estéril/árido
_laico	profano
cinza	acromático
cinco	cardinal/cardeal
divergente	diferente
tinhoso	ávaro/ávido/tacanho
erótico	sensual/sexy
iconoclástico	destrutivo
retórico	poético/bombástico/forense/oratório/retórico
repentina	escarpado/explosivo/fulminante/repentino/abrupto/brusco
convoluto	complexo/intrincado
catastrófico	prejudicial/nocivo/daninho/danoso
resultante	subseqüente/subsequente/posterior/ulterior
estatutário	legal
cênico	bonito/formoso/lindo/belo
dilapidadas	avariado/danificado
relacional	relativo
puro	harmonioso/imaculado/intenso/puro/virginal/impoluto/pura/virgem/castiço
que_não_causa_danos	inócuo/inocente
activista	agencioso/ativo
inconsciente	involuntária
conotativo	intensional
incorrecto	repreensível/errado/mau/enganado
capitanear	alto
paranoico	insano
traiçoeiro	perigoso/infiel
anêmico	débil
Saltear	cozinhado
eriçado	caótico/muxibento/bagunçado/desmazelado/desordenado/mulambento
livre	autônoma/definido/autônomo/soberano/independente/autonômico
controvertido	árduo/difícil/foda/intrincado
acerbo	acídulo/arisco/fermentado/desagradável/azedo/desgradável
incônscio	involuntária
massivo	grande
digno_de_nota	decoroso/digno
serviçal	braço_direito/prestável/direito
arcaica	antigo/velho
pontudo	fusiforme/pontudo/piramidal/pontiagudo
em_exercício	temporário
tenaz	adesivo/teimoso/obstinado/teimosa
bucólico	rural
esquerdo	a_bombordo
coincidente	proporcionado/síncrono/sincrônico/congruente
manuscrito	escrito
imóvel	inerte/rígido/estacionário/estático/fixo/quedo
edematoso	doente/adoentado/doentio/insalubre
honrado	venerável/perpendicular/augusto/fio_de_prumo/vertical
que_não_se_pode_contestar	demonstrável/irrefutável
esquerdista	esquerdista/liberal/esquerda
célebre	sabido
atento	absorto/consciente/minucioso/atento/consciensiosamente/solícito/absorvido/elaborada/pormenorizado/circunstanciado/elaborado/consciencioso
cómodo	bom/oportuno
alisado	bidimensional
alado	aliforme/rápido/rápida/veloz
adormecido	com_sono/sonolento/dorminhoco
maior	grande/intenso/intensivo/maturo/maduro
em_chamas	passional
iluminado	aceso/fluorescente/fosforescente/incandescente/lívido/luminoso/iluminado
tangível	tátil/concreto/material
antropomórfico	humano
ceremonioso	titular/solene/convencional
extenso	grande/extenso/plenário/universal/súper/global/mundial/detalhado/amplo/abrangente/exaustivo
enganador	desonroso
isométrico	cúbico/tridimensional
Hollow_Man	ultravioleta/indetectável/escondida/infravermelho/escondido
centesimal	ordinal
cofidente	dependente
macabro	alarmante/inquietante
amigável	bem-intencionado/social/amável/favorável/afável
crónico	ordinário/degenerativo/costumeiro/genérico/comum/geral/usual/habitual
celebrado	glorioso
combinado	unido
idêntico	proporcionado/isotrópico/equidistante/mesmo/equivalente/co-igual/eqüidistante/o_mesmo/congruente
efetivo	impressionante
elegível	conveniente/adequado/apropriado/desejável/capaz
salvo	indene/indemne
lícito	legal/admissível
anictérico	salubre/são/saudável
ideológico	abstrato
concomitante	subseqüente/subsequente/posterior/ulterior
tácito	implícito
mais_recente	corrente/actual/atual
variado	diferente/heterogêneo/heterogênea
pré-histórico	passado
letal	nefasto/fatal
aceso	iluminado/ardente
pouco_conhecido	desconhecido
fio_de_prumo	vertical/honrado
punitivo	penal/penitenciário
calamitoso	inquietante/alarmante
nefando	maléfico/mau/má/ruim/maléfica/malvado
estático	imóvel
verbal	comunicativo
prolongado	de_duração/longo
milésima	ordinal
tempestivo	pontual
medíocre	normal/inferior/ruim/ordinário/comum/costumeiro/rotineiro
Professor_emérito	velho
sumário	sucinto/lacônico/conciso/lacónico
defendível	invulnerável
nono	ordinal
ácida	ácido/azeda
surpresa	estupefato
acreditável	suposto
viciado	alcoólico/dependente
ansioso	ávido
difamatório	prejudicial/nocivo/daninho/danoso
braço_direito	serviçal/prestável
embarcado	cercado/rodeado/delimitado
solícito	atento
periodico	mensal/cíclico/semanal/diário/anual/trienal/quinzenal/trianual
computável	calculável
não_confiável	errático
iridescente	radiante/colorido/vivído/brilhante/luminoso/claro
permissivo	indulgente
impraticável	romântico/impossível
materno	materno/maternal
cheio_de_espinhos	árduo/difícil/foda/intrincado
traumático	árduo/dolorido/doloroso/extenuante/doído
eterna	permanente/duradouro
insistente	contínuo
transsexual	homo/gay/homossexual
ótimo	melhor
viçoso	próspero/bem-sucedido/bem_sucedido
autônoma	livre/gratís
preexistente	antecedente
notório	mal_afamado
tirano	dominador
geral	disseminado/comum/crônico/usual/habituado/crónico/habitual/inveterado
incongruente	incompatível/discrepante/inapropriado
sólido	digno_de_confiança/bom/concreto/em_boas_condições/adequado/estado_sólido/boa
cuidadoso	detalhista/exigente
alcançável	possível
colorido	interessante/tricolor/fluorescente/multicolor/monocromático/ouro-colorido/ruão/vistoso/rubro/bicolor/iridescente/psicadélico/brilhante/pitoresco/ruidoso/policromático/vermelho/escarlate/rúbido/rúbeo/rubicundo/rússeo/rufo/multicor/pitoresca/multicolorido
derradeiro	alto
transitório	temporário
sangüíneo	ensanguentado/violento
superior	alto/brilhante/transcedente/o_maior/destacado/seleto/superior/magnífico/primordial/fino/excepcional/excelente/extraordinário/fabuloso/luzente/exímio/primeira_linha
intrínseca	inerente/interno/integrante/integral
remitente	reduzido
tagarela	tagarela/conversador/loquaz
irreversível	permanente
irresistível	atraente/esmagador/irresistível
hediondo	malvada/iniquo
ímpio	malvada/iniquo
gentil	grácil/afável/cortês/amável/gentil/mimoso
governamental	política
mortal	imisericordioso/virulento/nefasto/fatal/impiedoso
espontâneo	intuitivo/impulsivo
sensível	vivo/excitável/árduo/dolorido/doloroso/extenuante/doído
que_não_pode_ser_distinguido	mesmo/o_mesmo
ubíquo	presente
vaporoso	gasoso
estado_sólido	sólido
viçosa	gordo
louco	entusiasmado/tolo/insano/excitada/excitado
infreqüente	ocasional/raro
estonteante	surpreendente/extraordinário
antiácido	incompatível
freqüente	habitual/comum/predominante
maduro	adulto/maduro/outonal/casadoiro/maior/núbil/crescido/maturo
heróico	audacioso/impressionante/grande/valoroso/valente/afoito/arrojado/brava/audaz/bravo/destemido/corajoso
representativo	típico/alegórico/simbólico
carismática	atraente
comovente	comovente
soberano	livre/dominante/gratís
manipulável	dirigível/administrável/controlável/governável/gerenciável
tolo	carinho/risível/inane/insensato/louco/néscio/maluco/absurdo/demente
prateado	acromático/radiante/vivído/brilhante/luminoso/claro
eternos	permanente/duradouro
tortuoso	complexo/semicircular/sinusoidal/sinuoso/curvilíneo/intrincado
acalorado	perto/próximo/vizinho
incompleto	interminado/partido/nenhuma/parcial/metade/nenhum/nenhuma_pessoa
lascivo	sensual/sexy
fedorenta	ruim
numeroso	muito
esverdeado	cromático
disjunto	separado
cravado	cercado/rodeado/delimitado
semiprecioso	precioso/valioso
indeciso	débil
tradicional	convencional/ortodoxo
envolvente	próximo
brincalhão	irónico/sapeca/traquinas/sarcástico/irônico/bagunceiro
comedido	suave
clássico	clássico/neoclássico
hipócrita	religioso/piedoso
ágil	inteligente/ativo/jeitoso/engenhoso/astuto/genial/hábil
fútil	trivial/vão/frívolo/leviano/informal/tonto/inapto/inútil/impróprio
sujeito	responsável/afetado
loiro	arenoso/cor_de_linho
reservado	inexpressivo/reticente/inexpressível/sem_expressão
comprável	disponível
improvisado	temporário
biológica	natural
maldita	condenado/maldito/amaldiçoado
pálida	falta_de_esperança/desesperado
feito_em_módulos	padrão
inesperado	inesperado/não_previsto/imprevisto
esperado	previsto/esperável/antecipado/esperado
em_boas_condições	substancial/sólido
duro	endurecido/pobre/granítico/de_ferro
venial	perdoável
decisivo	definitivo/decisivo/crítico/conclusivo/fatídico/determinante/importante/crucial
preocupado	desassossegado
cheio_de_si	contente
incompetente	incapaz/inadequado/ruim
letárgico	apático/indiferente/lânguido
demente	tolo
desejável	preferível/elegível/invejável
hispanófono	comunicativo
copioso	verde/torrencial/abudante/lauto/fácil/farto/bastante/basto/copioso/abundante
Vernáculo	informal
incomensurável	incomparável
descontente	discontente
agravante	intensificador
exterior	externo
feudal	subalterno
repetitivo	contínuo/iterativo
usado	antigo/velho
jocoso	humorístico/engraçado
pedroso	áspero
Fenômenos_paranormais	psíquico
intermédio	entre_dois_extremos/meio_caminho/antepenúltimo/penúltimo/secundanista/metade_do_caminho/intermediário/secundarista
desabitado	derrelicto/solitário/derrelito/abandonado/derelito
inabitado	colonizado/derrelicto/povoado/populoso/solitário/derrelito/abandonado/derelito
ameaçado	vulnerável
automotor	movente
alveolada	celular
sério	importante/real/solene/sincero/genuíno/verdadeiro/grave
preferencial	favorável/profícuo/vantajoso/propício
paralítico	enfermo/doente
omnisciente	sábio
consciente	atento/evocador/nostálgico/sugestivo
enguiçado	destruído
relevante	pertinente/aplicável/procedente
indemne	incólume/intacto/salvo/ileso
consonante	harmonioso
busseta	humorístico/engraçado
à_prova_de_erros	infalível
colante	adesivo
divorciado	solteiro
supremo	dominante/definitivo
desnecessária	desnecessário/supérfluo/redundante/extra/reduntante/gratuito/excessivo
fofo	inapropriado/macio
conveniente	prático/elegível/próprio/capaz/favorável/bom/decoroso/vitoriano/útil/recatado_em_excesso/puritânico/apropriado/adequado/conveniente
fragmentário	parcial/fracionário
impagável	precioso/valioso
suplicante	importuno
furioso	bravo/tempestuoso/insano/zangado/raivosa/irado/irritado
bem	assintomático/satisfatório/recuperado/curado
tecnológico	científico/científica
estufado	cheio/pleno/lotado
fraudulento	prejudicial/nocivo/daninho/danoso
manejável	possível
rúbeo	colorido
ameaçador	alarmante/inquietante
encantador	desonroso
alta	ensurdecedor/grande/vocal
maleável	tratável
em_forma	são
explicativo	noticioso
batalhador	agressivo
tangencial	irrelevante
imenso	grande
descartável	líquido/usável/disponível/utilizável
desinteressante	dessecado/sem_brilho/sem_vitalidade
diabólico	maléfico/mau/má/ruim/maléfica/malvado
em_branco	vazio
rufo	colorido
protegido	guarnecido_com_ameias/fortificado
resistente	desafiador/caloso/endurecido
ocasional	imprevisível/infreqüente/raro/infrequente/infrequënte/casual/esporádico
religioso	piedoso/hipócrita/sagrado/devoto
muito	numeroso
esbelto	tênue/demasiado_educado/luxuriante/cadavérico/anoréxico/extenuado/luxuoso/esguio/delgado/franzino/fino/esbelto/magro
turístico	popular
especulativo	teórico
ampla	panorâmico
demasiado_educado	gracioso/esbelto/garboso/airoso/elegante
banal	desgastado/rotineiro/costumeiro/comum/ordinário/normal
tíbio	caloroso
preparado	imediato/rápido
cem_mil	cardinal/cardeal
randômico	confuso/sem_pé_nem_cabeça/atabalhoado/estocástico/aleatório
descorado	doente/adoentado/doentio/insalubre
lateral	lateral
intramural	interno
robusto	forte
franzino	tênue/esbelto/magro
frugal	parcimonioso
habituado	habituado/costumado/usual/geral/comum/habitual/genérico/costumeiro/ordinário
válido	fundamentado/lógico/legal
gorduroso	gordo/obeso
desobrigado	pagado
oco	acetabular/cavernoso/tubular/bicôncavo
rússeo	colorido
Veneráveis	velho
inane	tolo
aguado	ventilado
revolucionário	novo
vago	vazio/confuso/ter_muitos_significados/enigmático
circunflexo	semicircular/sinusoidal/sinuoso/curvilíneo
dessecado	desinteressante/seco/monótono/chato
falível	errante
verídico	típico
pré-adolescente	jovem
brutal	intenso/inumano/desumano/intensivo
sexagésimo	ordinal
perfido	infiel
denotativo	extensional
noventa_e_nove	cardinal/cardeal
lindíssimo	bonito/formoso/lindo/belo
obstinado	tenaz/porfiado/teimoso
que_tem_efeito_extraordinário	sobrenatural/sobrecomum
sinfônico	harmonioso
transparente	fino/evidente/obvio/óbvio
média	normal
mole	inapropriado/macio
enlouquecido	insano
assimétrico	desigual/torto
individual	único/separado/respetivo/idiossincrático/respectivo/singular
genuíno	verdadeiro/sério/autêntico/genuíno/legítimo
masculina	varão/viril/macho/varonil
nuclear	central
pardo	cromático
prestigioso	influente/emocionante/excitante
enjoado	triste
prolixo	difuso/de_duração/pleonástico/excessivo/supérfluo/desnecessário/tautológico/redundante
estrutural	construtivo/funcional
horizontal	plano/transversal
móvel	transportado_pelo_ar/portátil/movente
oposto	outro/malvado
integral	intrínseco/realizado/total/exaustivo/completo/absoluto/inteiro/inteira/intrínseca/completado/completa
piolhoso	sujo/suja/sujado
diagnosticável	identificável
esnobe_e_barato	húmido/molhado/úmido
tímida	timorato
centenário	velho
nervoso	tenso/entusiasmado/excitável/excitada/excitado
imponente	impressionante
delimitado	embarcado/inclusive/fechado/encrustrado/embutido/cravado/incluído
outro	oposto/díspar/diferente/outro
especular	meditabundo
escrito	manuscrito/gráfico
milionésima	ordinal
sem_razão	irracional
metafísico	teórico/sobrenatural/sobrecomum
automático	mecânico/semiautomático/involuntária/involuntário
modular	padrão
destinado	seguro/inevitável/certo
sortido	diferente/heterogêneo/heterogênea
colonizado	inabitado
elíptico	sucinto/lacônico/conciso/lacónico
que_está_por_vir	disponível
afirmativo	vantajoso/positivo
de_pouca_expressão	débil
extático	ditoso
desprezível	patético/maléfico/abjeto/miserável/mau/má/ruim/maléfica/malvado
venenoso	malicioso/tóxico/perverso/maldoso
setuagésimo	ordinal
estacionário	imóvel/fixado/fixo
prático	conveniente/acessível/pragmático/realístico/funcional/interoperável
único	individual/incomparável/inusual/desacompanhado/insólito/extraordinário/estranho
favorito	popular
sem_fundo	ilimitado/fundo/profundo
convulsivo	inseguro/violento/oscilante
insustancial	etéreo
guarnecido	adornado
nortista	para_o_nordeste/setentrional/do_noroeste/do_nordeste/nordestina/nordestino
recebido	corriqueiro/convencional
classudo	chique
aurífero	metálico
burguesa	classe_média
especial	primário/extraordinário/específico
boa	satisfatório/angelical/boa!/afortunado/favorável/magnífico/sólido/beatificação/aceitável/angélico/muito_bom/profícuo/vantajoso/propício
áurea	metálico
minimum	fronteiriça/simbólico/marginal
governável	manipulável
evangélico	entusiástico/entusiasta
pálido	sem_cor/incolor
fenomenal	extraordinário
mirabolante	insípido
linda	atraente
grávida	grávida/prenha/gestante
criativo	construtivo/original/inventivo/imaginativo/criativo/criador
esquecido	despercebido
instantâneo	rápido/rápida/veloz
fermentado	cortante/ácido/adstringente/acerbo/picante/azedo
que_causa_vertigem	doente/enfermo
polisintético	sintético
exequível	possível
proverbial	sabido
que_não_tem_preço	precioso/valioso
ruim	levado/destruído/inferior/maléfico/sinistro/vil/inapropriado/fedido/deplorável/incompetente/medíocre/desfavorável/fedida/atroz/apavorante/terrível/horrível/fedorenta/nefando/lamentável/fedorento/travesso/desprezível/infernal/abominável/diabólico/mau/má/ruim/maléfica/malvado
aferente	sensorial/centrípeto
microscópico	pequeno/visível
desonesto	corrupto
que_dá_preempção	preventivo
recôndito	esotérico
perversa	malicioso/perverso/maldoso
zangado	bravo/indignado/lívido/colérico/furioso/feroz/raivoso/furibundo/zangado/raivosa/irado/irritado
glamourosa	emocionante/excitante
patológico	doente/adoentado/doentio/insalubre
auto-confiante	confiante
selectivo	exclusivo/discriminatório
antiga	passado
intransmissível	inalienável
imediata	presente
morto_de_cansado	fatigado/cansado/cansada
didático	noticioso
resoluto	definitivo
comprimido	fechado/compressível
violento	antinatural/fulo/sangüíneo/convulsivo/feroz/bravo/intenso/afetado/intensivo/sangrento
polido	acabado/sofisticado/finalizado/terminado
interino	temporário
escuro	tenebroso/fuscícoma/triste/velho/crepuscular/negro/sombrio/marronícoma/brunícoma/de_cabelo_castanho/obscurícoma/morena/castanícoma/escuro
que_vai_acontecer	futuro
que_enxerga_longe	profético
moderna	sincrônico/síncrono
abstracto	esotérico
ártico	frio/polar
possante	influente
centésimo_primeiro	ordinal
moderado	modesto/médio/limitado/cauteloso/razoável/pequeno
controlável	manipulável
caucasóide	caucasiano/caucasiana
purulento	infectado/séptico
árido	seco/inóspito
modelo	decoroso/digno
preguisoço	lento/devagar
nevoeirento	húmido/nublado/molhado/úmido
calunioso	prejudicial/nocivo/daninho/danoso
que_dá_o_direito_de_preferência_na_compra	preventivo
barulhento	clamoroso
grave	crítico/sério
cortante	acídulo/fermentado/azedo/desgradável
discriminativo	discriminatório/crítico
ofendido	árduo/dolorido/doloroso/extenuante/doído
científico	tecnológico
lodoso	escorregadio
imperial	nobre
secundarista	intermédio
divisível	separável/divisível
carnal	físico
maravilhosa	extraordinário
repugnante	ofensivo
iniquo	monstruoso/malvado/ímpio/atroz/pecaminoso/hediondo
geado	opaco
empírico	confirmável/existencial/experimental/testável/capaz_de_ser_provado_como_falso
oitavo	ordinal
ineficiente	anti-econômico
misteriosa	esotérico/incompreensível/inexplicável
inferior	modesto/inferior/brega/comercial/espalhafatoso_e_mixuruca/lamentável/medíocre/comum/ruim/ignoto/humilde/mau/miserável/pequeno
métrico	ritmado/rítmico
flutuante	à_deriva
passível	culpado
fulo	violento
5	cardinal/cardeal
factível	possível
produtivo	próspero/fértil/cultivável/prolífico/arável/proveitoso/fecundo/frutífero/bem-sucedido/bem_sucedido
apropriado	atempado/elegível/próprio/capaz/adequado/conveniente
abusivo	prejudicial/nocivo/daninho/danoso
uno	cardinal/cardeal
longevo	de_duração
torcido	escuso
berrante	ensurdecedor/grande/vocal
anti-helmíntico	saudável
surpreendente	impressionante/surpreendente/estonteante/espantoso/assombroso
bicha	homo/gay/homossexual
questionável	solúvel
calmoso	perto/próximo/vizinho
cento_de_noventa	cardinal/cardeal
paciente	diligente/tolerante
vitorioso	próspero/bem-sucedido/bem_sucedido
mais_cedo	temporão/precoce/cedo
nulidade	vão/inapto/inútil/impróprio
isento	privilegiado/imune
ortostático	vertical
a_ser_lançado	disponível
movente	sem_descanço/cinético/semovente/móvel/chaminés_indústria/voador/autopropelido/chaminés_(indústria)/automotor/automotivo
desastroso	infortunoso/infeliz/miserável
parvenida	novo
púrpura	cromático
efervecente	fresco/recente
sujo	antipático/injusto/sórdido/encardido/obsceno/piolhoso/ranhoso/gordo/grudento/imunda/impudico/verde/horrível/suja/sujado/sujo
biodegradável	perecível
malvado	malvada/sinistro/contrário/malicioso/vil/atroz/agressivo/ruim/nefando/oposto/desprezível/infernal/beligerante/mau/abominável/diabólico/iniquo/perverso/maldoso
regional	territorial
ortogonal	perpendicular
misto	heterogêneo/heterogênea
convencional	ortodoxo/recebido/tradicional/ceremonioso/habitual/formal
má	sinistro/vil/atroz/ruim/nefando/desprezível/infernal/mau/abominável/diabólico
razoável	moderado
alongado	longo
vacante	vazio
doméstica	nacional/autárquico/municipal
translúcido	leve
sonolento	adormecido
castanho	cromático
vazio	cavernoso/em_branco/sem_vida/tubular/vago/refletivo/vacante/desocupado
simbiôntico	dependente
simplificado	fácil
susceptível	moldável/impressionável/vulnerável/alérgico/hipersensível
erétil	vertical
discutível	polêmico/plausível/contestável/controverso/polémico
dosado	tratado
escorregadio	lodoso/deslizante
real	sério/corrente/existente/nobre/actual/atual
veado	homo/gay/homossexual
manifesto	óbvio/obvio/evidente
inatacável	invulnerável
aflito	inapropriado
fluido	líquido/gracioso
teimoso	tenaz/porfiado/teimoso/obstinado/teimosa
o_maior	superior
tubular	vazio/oco
rápida	ligeiro/instantânea/expresso/alado/acelerado/instantâneo/célere/breve/veloz/rápido
trilíngüe	multilingue/multilíngue
o_mais_cedo	temporão/precoce/cedo
sonso	idiota/fátuo/burro/imbecil/estúpido
equidistante	parelho/idêntico/igual/análogo
estável	duradouro
argênteo	metálico/radiante/vivído/brilhante/luminoso/claro
assertivo	enérgico/enfático
não_comunicativo	inexpressivo/reticente/inexpressível/sem_expressão
polissílabo	longo
inaceitável	inadmissível/insuportável/intolerável/inaceitável
lacónico	elíptico/sentencioso/compêndio/sumário/sucinto/curto/lacônico/conciso/lacónico
nostálgico	consciente
nenhuma	incompleto
calma	constituído
foda	frustrante/complicada/ambicioso/controvertido/arduo/cheio_de_espinhos/difícil/sensitivo/laborioso/cócegozo/desafiador/desconcertante/complicado/problemático/espinhoso
íntimo	próximo/confortável
modal	normal
décima	ordinal
fugitivo	curto
desgastado	banal/picada_de_vermes/esfarrapado/envelhecido/sem-fim-comido
provinciano	provincial
indefinido	incerto/ter_muitos_significados/enigmático
enganoso	desonroso
perplexo	hesitante/desorganizado/nublado/perplexo
momentâneo	curto
relativo_ao_Apocalipse	profético
cativante	aprazível
malandro	corrupto
apetitoso	saboroso
cortês	gentil/sofisticado
usual	crônico/costumado/habituado/usual/geral/comum/crónico/habitual/genérico/costumeiro/ordinário/inveterado
divino	sagrado/celeste/glorioso
estranho	inusual/sobrenatural/inconformista/atrapalhado/artificial/fantástico/esquisito/singular/diferente/único/curioso/bizarro/desajeitado/exótico/assustador/estrangeiro/sobrecomum/não_convencional/insólito/extraordinário/estranho/gótico
veemente	forte/intensivo/intenso
parcimonioso	económico/frugal/econômico
com_mal-estar	doente/enfermo
risonho	_animador/animado/contente
respeitoso	honorífico/deferente
identificável	classificável/diagnosticável
refrigerado_a_ar	frio/fresco
cultivável	produtor/produtivo
ávido	ansiosa/entusiástico/cobiçoso/tinhoso/impaciente/ansioso/sequioso/entusiasta
inapto	sem_uso/nulidade/inutilizável/inútil/fútil/vão
sem_ouvido_musical	surdo
perto	vizinho/contíguo/acalorado/quente/calmoso/junto/próximo/perto
pecaminoso	malvada/iniquo
extraordinário	bonito/tremendo/superior/fenomenal/incomum/exótico/estranho/pirotécnico/especial/excepcional/formidável/misterioso/maravilhosa/fantástico/esquisito/notável/raro/singular/diferente/admirável/único/maravilhoso/curioso/estonteante/fabuloso/grande/bizarro/grandioso/assustador/magnífico/formoso/lindo/belo/horrível/gótico
aceitável	capaz/bom/admissível/boa/adequado
racista	racial
bem_acabado	meticulosa/meticuloso
terrível	ofensivo/intenso/ruim/desagradável/alarmante/inquietante/intensivo/arisco
percebível	observável/marcado/detectável/evidente
lógico	racional/válido/sem_remendos/sem_emenda/sem_improvisos
aziago	profético
absorvente	esponjoso/curisoso/interessante
por_toda_vida	de_duração
substancial	em_boas_condições/essencial/material/significativo/adequado
enérgico	peremptório/físico/infatigável/అత్యవసరం/vigoroso/inesgotável/incansável/assertivo/agressivo
sutil	humorístico/engraçado
musculoso	forte
periférico	circunferencial
imaginário	irreal/não_material
magnânimo	liberal/nobre
núbil	maturo/maduro
côncavo	acetabular/bicôncavo
adaptável	adaptativo/elástico/ajustável/variável/flexível
inopinado	staccato
ilegal	criminoso/extrajudicial/interdito/penal/ilegal/ilegítimo/ilícito/proibido/defeso/inelegível
observável	percebível/que_se_pode_detectar
sensasional	intenso/intensivo
congruente	idêntico/coincidente
sugestivo	indecente/consciente
extraconjugal	ilícito
analógico	figurativo
receoso	apreensivo/assustado/claustrofóbico/xenófobo/agoráfoba/apavorado/horrorizado/pasmo/agorafóbico/agoráfobo/espantado/pasmado/chocada/aterrorizado/chocado/amedrontado
esmero	intenso/intensivo
crônico	degenerativo/ordinário/costumeiro/genérico/comum/geral/usual/habitual
que_oferece_várias_aspectos	diverso/variável
luzente	superior
satírico	sarcástico
doidão	sensual/insano/sexy
bom	afortunado/boa!/próprio/respeitável/cómodo/intelectual/favorável/reto/angelical/satisfatório/magnífico/sólido/beatificação/oportuno/aceitável/angélico/muito_bom/adequado/conveniente/profícuo/vantajoso/propício/justo/eqüitativo/recto
binário	múltiplo
litorâneo	marítimo
educado	sofisticado
melhor	ótimo/óptimo
fanático	passional
municipal	domesticada/domesticado/doméstica
lamentável	inferior/infortunoso/desagradável/ruim/infeliz/miserável/arisco
chaminés_indústria	movente
esfomeada	faminta/faminto
_animador	contente/alegre/sorridente/radiante/risonho/animado/feliz
famigerado	mal_afamado
truncado	curto
psicotrópico	alucinogênico/psicadélico
laminado	fino
pequeno	microscópico/jovem/reduzido/moderado/inferior/menor/minúsculo/pequenito/esguio/anão/diminuto/nanico/pequeno/pequenino
costeiro	marítimo
fidedigno	responsável/testado/comprovado
temporão	jovem/nítrico/antes_da_hora/de_antemão/mirim/contemporâneo/primitivo/incipiente/novo/primordial/primitiva/prematuro/anterior/o_mais_cedo/mais_cedo
absorto	atento
cinzenta	acromático
aplicado	diligente/forense
fiel	exacto/justo/acurado/exato/preciso
cirúrgico	preciso/exato/acurado/justo/exacto
antitético	diferente
jubiloso	ditoso
carmim	cromático
sanitário	higiênico
evanescente	temporário
socialista	colectivizada/colectivo/coletivista/coletivo
fabulosa	aprazível
brega	inferior
interoperável	prático
antigo	passado/de_segunda_mão/antediluviano/amarelo/arcaica/arcaico/usado/segunda_mão
nonagésima	ordinal
sem_emenda	conseqüente/coerente/consequente/lógico
interno	interior/intramural/intrínseco/intrínseca
assustado	receoso/excitável
centésimo_quadragésimo_quinto	ordinal
purpúreo	cromático
simplístico	simples/singelo
quite	pagado
congelante	fresco/recente
profilático	saudável
aproximado	próximo
metafórico	figurativo
alimentário	saudável
indene	intacto/incólume/salvo/ileso
décimo_primeiro	ordinal
voador	movente
enfermo	que_causa_vertigem/frenético/delirante/nauseante/de_convalescência/paralítico/com_mal-estar/tísico/verdejante/diabético/vertiginoso/com_tontura/de_melhora/tonto/menstruada/indisposto
inverso	antônimo
unitário	unido
transportado_pelo_ar	móbil/móvel
chocante	staccato
de_cabelo_castanho	bronzeado/escareado/escuro
informativo	consultivo/aconselhador/consultor
picante	acídulo/fermentado/azedo/desgradável
brilhante	superior/colorido/inteligente/deslumbrante/reluzente/iridescente/prata/radiante/prateado/argênteo/refulgente/faiscante/argentino/vivído/brilhante/luminoso/claro
soturno	triste
substituível	intercambiável
numérico	quantitativo
polémico	discutível/conflituoso/polêmico/controverso/polémico
de_melhora	doente/enfermo
infinito	de_duração/absoluto/infinito/infinita/inesgotável/ilimitado/infindável/perfeito
dual	plural
produtor	fértil/cultivável/fecundo/prolífico/arável
idosa	velho
encrustrado	cercado/rodeado/delimitado
desordenado	eriçado/hirto
anti-econômico	ineficiente
mobilado	emestoque/encarregado/equipado
irónico	brincalhão/travesso/arteiro
sem_expressão	reservado/não_comunicativo
imprudente	precipitado/imprudente/indiscreto
odioso	ofensivo/abominável
autárquico	domesticada/domesticado/doméstica
físico	energético/corpóreo/material/natural/tátil/sensual/fisiológico/carnal/somático/enérgico
inconsolável	desolado
parelho	equidistante/equivalente/co-igual/eqüidistante
popular	democrático/turístico/da_moda/favorito/namoda/predileto
extensível	longo
desrespeitoso	insolente/escarnecedor/zombador
feio	grotesco/monstruoso
judiciário	legal
2	cardinal/cardeal
adoentado	crítico/asmático/caseoso/gangrenoso/patológico/mental/ictérico/inflamatório/espumoso/edematoso/artrítico/descorado/mórbido
anão	pequeno
variável	ajustável/que_oferece_várias_aspectos/volatile/volúvel/versátil/relativo_a_ou_característico_de_Proteus/regulável/extremamente_variável/variável/volátil/instável/adaptável/vário
brônzeo	metálico
elefantino	grande
néscio	tolo
deleitoso	aprazível
lutuoso	triste/pesaroso/destestável
distinguido	separado
vitoriano	próprio/adequado/conveniente
energético	físico/infatigável/అత్యవసరం/vigoroso/inesgotável/incansável
passageiro	temporário
grosso	caloso/baixo/gordo/grande/endurecido
sem_culpa	inocente
versátil	variável
súdito	subalterno
circundante	próximo
insípido	espalhafatoso/insípido/presumido/espalhafatoso_e_mixuruca/vistoso/mirabolante
meditabundo	especular
virtual	essencial/realístico
desaparecido	perdido
aborrecivel	ofensivo
infortunoso	abjeto/mendigo/lamentável/coitado/desastroso/miserável/lastimoso/azarado/triste/pobre/mendiga/sem-teto/sem-abrigo
claustrofóbico	receoso
ilegítimo	ilegal
orgíaco	embriagado/sensual/ébrio/bêbado/bêbedo/sexy
firme	imutável/fixado/fixo
fazível	possível
costumado	habituado/usual
hidrofóbico	passional
roliço	gordo
que_está_vindo	futuro
ilimitado	sem_fundo/infinito/dooceano
indiferente	desinteressado/imparcial/rotineiro/letárgico/costumeiro/comum/ordinário/normal
sórdido	sujo/suja/sujado
esférico	redondo/circular/arredondado
arrogante	orgulhoso
suprema	definitivo
miserável	abjeto/infortunoso/inferior/desprezível/mendigo/lamentável/coitado/desastroso/lastimoso/azarado/pobre/mendiga/sem-teto/sem-abrigo/infeliz/miserável/triste
desesperado	indefeso/impossível/deprimido/sombrio/escalvado/pálida
sísmico	instável/precário
amável	amigo/afável/benigno/benevolente/benévolo/bondoso/amigável/amistoso/amável/gentil/lhano
aparente	superficial
imutável	consistente/firme/fixo/invariável/imutável/inalterável
efervescente	espumoso/borbulhante
bem_bolado	Limpo
didáctico	noticioso
estreito	mesquinho/adelgaçado/estreita/dogmático/cónico/estreito
passional	em_chamas/colérico/ardente/fanático/devasso/furiosos/furiosas/flamejante/em_brasas/furiosa/hidrofóbico
universal	internacional/extenso/detalhado/amplo/abrangente/exaustivo
quadricular	quadrado
rebocado	coberto
abençoado	salvado
mero	específico/especificado
magestoso	alto
vão	sem_uso/nulidade/inutilizável/fútil/vão/inapto/inútil/impróprio
teimosa	tenaz/porfiado/teimoso
inesgotável	infinito/energético/enérgico
esponjoso	macio/hidrófilo/absorvente
adelgaçado	estreita/estreito
inquieto	psicadélico/histérico/emocional/frenético/transtornado/agitado/febril/perturbado/excitado
incompatível	antônimo/incongruente/antiácido/contraditório/inconsistente
amolgado	fino
nórdico	para_o_nordeste/setentrional/do_noroeste/do_nordeste/nordestina/nordestino
cor-de-laranja	cromático
frágil	delicado
inquebrantável	constante
opcional	facultativo
ardente	entusiástico/aceso/passional/entusiasta
flexível	elástico/dobrável/lasso/adaptável/ajustável
entusiasta	ardente/evangélico/ávido/zeloso/fervente/fervoroso
desgradável	cortante/ácido/adstringente/acerbo/picante/azedo
bondoso	amável
cor_de_avelã	cromático
menos	menos
caro	caro
térmico	quente/forgoso
adulto	maturo/maduro
corriqueiro	recebido/habitual
loquaz	tagarela
herdável	patrimonial/hereditário
exato	fiel/literal/certo/cirúrgico/rigoroso/justo/correto/textual/estrito/matemático
pouco_à_vontade	sem_conforto/azarado/irritante/desconfortável/doloroso
somático	físico
multilíngue	bilíngüe/trilíngüe
amarelado	cromático
alternativo	inconformista/secundário/não_convencional
vermelho	cromático/colorido
irregular	anormal/raro/imperfeito/casual/esporádico
casta	virgem/virginal
sem_comparação	incomparável
hipersensível	suscetível/susceptível
tendente	ter_queda_para/inclinado
falido	falido/quebrado
silenciosa	pacato
rubro	colorido
inválido	morta/expirado/nulo/inválido
entretido	curisoso/interessante
de_bronze	cromático
limpável	limpo
augusto	honrado
imediato	preparado/próximo/pronto/disposto/prestes
prazeroso	desempregado
não_previsto	inesperado/imprevisto
afetado	sujeito/artificioso/violento/impressionado/artificial/forçado
acre	saboroso/arisco/desagradável
afiado	afiado
utilizável	útil/prestativo/descartável
constrangedor	persuasivo/poderoso
enegésimo	ordinal
constante	inquebrantável/invariável/contínuo
desafiador	relutante/intrincado/resistente/foda/difícil/árduo
que_dá_direito_de_preferência_na_aquisição	preventivo
astuto	ladino/distorcido/ágil/precioso/ardiloso/astuto/Tricky/esperto/alerta/animado/bem_disposto/hábil
bem-intencionado	amigável
comunicável	comunicativo
sem_demora	pontual
polêmico	discutível/conflituoso/polêmico/controverso/polémico
demonstrável	que_não_se_pode_contestar/evidente/obvio/óbvio
épico	grande
de_ferro	dificil/dura/duro
comparável	mesmo/comparável/o_mesmo
meticulosa	bem_acabado/preciso/precisa
responsable	responsável
semovente	movente/dinâmico
mal_sucedido	que_não_realizou/desiludido/não_cumprido/não_realizado/não_satisfeito/frustrado
qüingentésimo	ordinal
recuperado	bem
arrojado	heróico/animoso/valente/destemido
constituído	calma/reconhecido/calmo/tranquilo/sereno/tranqüilo/sossegado/oficial
interessado	curioso
exausto	fatigado/cansado/cansada
cômodo	acessível
prospectivo	futuro/potencial
insone	desperto/alerta/acordado
desagradável	ofensivo/infernal/amargoso/áspera/lamentável/pavoroso/áspero/dolorido/acre/triste/amaro/virulento/terrível/acerbo/animal/horrível/amargo/cáustico/doloroso
memorável	inesquecível
fraco	impotente/débil
indistiguivel	mesmo/o_mesmo
indomável	inconquistável
limpado	Limpo
imatura	imaturo/infantil
argentino	radiante/vivído/brilhante/luminoso/claro
ondeante	tempestuoso
incrível	improvável/estarrecedor
despadronizado	desigual/cheio_de_remendos
lelé_da_cuca	insano
indispensável	necessário/crítico/vital/imprescindível/que_não_pode_ser_dispensado/indispensável/essencial
trivial	frívolo/fútil
desuniforme	desigual/cheio_de_remendos
centésimo_quinto	ordinal
fluente	gracioso
cósmico	grande
longo	longínquo/de_duração/estendido/polissílabo/extensível/estendível/extendível/alongado/distante/prolongado/prorrogável
terceiro	ordinal
doido	insano
débil	indeciso/vulnerável/manco/de_pouca_expressão/anémico/debilitado/capenga/débil/anêmico/enrolado/fraco
tátil	físico/tangível
metálico	dourado/argênteo/bimetálico/aurífero/brônzeo/de_ouro/áureo/bimetal/áurea
pacífico	pacífico
extensional	denotativo
talentoso	mestre/consumado/realizado/versado/cumplido/competente/hábil/cumprido/habilidoso/experiente
vulnerável	débil/suscetível/indefensável/jovem/inseguro/desabrigado/inerme/indefeso/susceptível/ameaçado
cômico	humorístico/engraçado
heterogêneo	misto/sortido/variado
desvinculado	separado
arduo	árduo/difícil/foda/intrincado
disseminado	geral
alimentar	saudável
marcado_pela_mudança_constante	dinâmico
positivo	afirmativo/favorável/construtivo/otimista/profícuo/vantajoso/propício
chique	elegante/actual/contemporâneo/do_balacobaco/classudo/inovador/chique/moderno/progressista
espalhafatoso_e_mixuruca	inferior/insípido
dolorido	desagradável/magoado/traumático/terno/sensível/ofendido/arisco
ansiosa	ávido
insignificante	inútil/sem_sentido/sem_significado
gracejador	humorístico/engraçado
escareado	castanícoma/morena/obscurícoma/de_cabelo_castanho/brunícoma/marronícoma/fuscícoma
igual	equidistante/equivalente/co-igual/eqüidistante
excitado	embriagado/sensual/inquieto/louco/nervoso/ébrio/bêbado/sexy
orgânico	estruturado/saudável/essencial
definido	livre/gratís
brava	heróico/animoso/valente/destemido
madrepérola	acromático
forense	aplicado/retórico
embutido	cercado/rodeado/delimitado
clamoroso	barulhento/ruidoso
social	amistoso/sociável/étnica/gregário/amigável/étnico/amigo/cultural/etnia
raivosa	indignado/lívido/colérico/furioso/irado/feroz/raivoso/zangado/furibundo
fátuo	imbecil/idiota/estúpido/sonso
compressível	comprimido
vulcânico	instável/precário
maluco	insano/tolo
episódico	temporário/imprevisível
sem_descanço	movente
enganado	incorrecto/que_não_tem_razão
nocivo	degradante/difamatório/pernicioso/insidioso/deletério/prejudicial/fraudulento/catastrófico/mal/calunioso/abusivo/danoso/injuriante/perniciosa/infamante
ufano	orgulhoso
Ad-hoc	específico
emrampa	gradual
cáustico	destrutivo/arisco/desagradável
deficiente	inapropriado
sem_significado	insignificante/insignificanta
apavorado	receoso
hierárquico	graduável
proporcionado	idêntico/coincidente
maneável	possível
inerme	vulnerável/indefeso
suscetível	impressionável/moldável/vulnerável/alérgico/hipersensível
azeda	ácida
bárbaro	inumano/desumano
múltiplo	denário/quíntupla/triplo/quádruplo/bigeminal/duplo/binário/quíntuplo/dúplice
simpático	agradecido/agradável/idílico/ameno/aprazível
embriagado	excitado/drogado/orgíaco/ligeiramente_embriagado/tocado/pedrado/excitada/entusiasmado/grogue
heráldico	comunicativo
espirituoso	humorístico/engraçado
arbitrária	absoluto
ladino	astuto
irritado	indignado/lívido/colérico/furioso/irado/feroz/raivoso/zangado/furibundo
maravilhoso	sobrenatural/extraordinário/bonito/sobrecomum/formoso/lindo/belo
empoeirada	coberto
administrável	manipulável
direito	reto/serviçal/prestável/justo/eqüitativo/recto
desocupado	vazio
graduado	alto
grotesco	feio/engraçado/humorístico/feia
misterioso	incompreensível/extraordinário/sobrenatural/esotérico/sobrecomum/inexplicável
instantânea	rápido/rápida/veloz
ridículo	engraçado/humorístico
abjeto	infortunoso/desprezível/infeliz/miserável
inteiro	completo/integral/total/inteira/inteiro
fácil	indolor/superficial/casual/simplificado/lauto/farto/bastante/basto/copioso/abundante
eradicável	obliterável
democrático	comum/parlamentar/da_república/popular/republicano
melancólico	triste
agrupado	classificado
tísico	doente/enfermo
hierárquica	graduável
ao_estrangeiro	alienígena/estrangeiro/extrangeiro
sangrento	ensanguentado/violento
extendível	longo
melodramático	dramático
assintomático	bem
famoso	sabido
saturnino	sarcástico
lento	mandrião/preguisoço
adornado	guarnecido/estofado
Tricky	astuto
inútil	insignificante/sem_uso/nulidade/inutilizável/fútil/vão/inapto/inútil/impróprio
ofensiva	injurioso
actual	chique/corrente/real/mais_recente/contemporâneo/ligado/em_curso/hodierno/último/moderno/em_linha/vigente/até_a_data/online/actual/atual
tratado	dosado
sereno	constituído
devagar	mandrião/preguisoço
indetectável	invisível/Hollow_Man/Hollow_man
confirmável	empírico
glamoroso	emocionante/excitante
territorial	regional/seccional
profético	preditivo/aziago/relativo_ao_Apocalipse/que_enxerga_longe/apocalíptico/difícil_de_compreender
cosmético	estético
metade	incompleto/parcial/fracionário
correto	exacto/perfeito/preciso/afinado/certo/exato
sexual	sensual/sexy
cinético	dinâmico/movente
inquietante	pesadelar/assustador/ameaçador/abominável/macabro/arriscado/horripilante/medonho/calamitoso/ominoso/terrível/temido/pavoroso/temível/cabeludo/horrível/atroz/perigoso
em_linha	corrente/actual/atual
incipiente	temporão/cedo
quadrado	quadricular
disposto	imediato/rápido
inconstante	volátil/artificial/caprichoso/instável/falso/volúvel
amaldiçoado	maldita/maldito
cercado	embarcado/inclusive/fechado/encrustrado/embutido/cravado/incluído
cálido	queama/carinhoso/afectuoso/amoroso
peculiar	específico
perniciosa	tóxico/nocivo
azul_claro	cromático
f''	biónico/artificial/falsificado/falso/sintético
falecido	semvida/morto
conclusivo	definitivo/decisivo
décimo_quarto	ordinal
enfático	peremptório/assertivo/agressivo
colateral	secundário
transcedente	superior
seleto	superior
malvada	monstruoso/malvado/ímpio/atroz/pecaminoso/hediondo
vivente	remanescente/realístico/existente
credível	convincente
festivo	ditoso
esguelhado	inclinado
com_clareza	perspicaz
doméstico	caseiro
burro	imbecil/idiota/estúpido/sonso
ortodoxo	convencional/canônico/tradicional
primordial	superior/temporão/dominante/precoce/cedo
benévolo	amável
perverso	perversa/danoso/malevolente/venenoso/malévolo/maldoso/calúnia/malvado
marítimo	litorâneo/costeiro
trigésima	ordinal
monocromático	colorido
abrangente	amplo/extenso/plenário/universal/súper/global/mundial
afoito	heróico/animoso/valente/destemido
anguloso	áspero
sulista	austral/sudoeste/sudeste/meridional
útil	reusável/funcional/sociável/conveniente/acessível/usável/utilizável/reutilizável/reciclável
vital	vivo/essencial/imprescindível/que_não_pode_ser_dispensado/indispensável
vigésimo_primeiro	ordinal
opaco	maçante/incompreensível/esbranquiçado/glauco/geado/lácteo
categorizado	classificado
rectilíneo	unidimensional
isotrópico	idêntico
simbólico	representativo/minimum/mínimo
cafona	húmido/molhado/úmido
denário	múltiplo
óptimo	melhor
provisório	condicionado
eternas	permanente/duradouro
elegante	chique/gracioso/demasiado_educado/luxuriante/luxuoso
domesticada	nacional/autárquico/municipal
conhecido	familiar
até_a_data	corrente/actual/atual
sagrada	sagrado/bendito/santo
não_convencional	esquisito/bizzaro/alternativo/bizarro/estranho
pétreo	cromático
desfavorável	negativo/ruim
mágico	sobrenatural/sobrecomum
completado	terminado/finalizado/acabado/completo/integral/totalizado
biconvexo	envoltória_convexa/convexo
grande	importante/astronômico/estrepitante/extraordinário/titânico/considerável/cósmica/épico/nacroscópico/elefântico/massudo/massivo/vasta/maior/colossal/tremendo/grande/muitogrande/cósmico/descomunal/elefantino/extenso/volumoso/imenso/galáctico/gigantesco/galático/enorme/grosso/heróico/vasto/amplo/alta/berrante/alto
extenuado	fatigado/tênue/esbelto/magro/cansado/cansada
impolido	grosseiro/malcriado/malcomportado/descortês/rude/mal-educado
tricúspide	angular/angulado
pagado	quite/desobrigado
danificado	enrugado/malcuidado/malcuidada/dilapidados/dilapidada/dilapidado/dilapidadas/quebrado
do_balacobaco	chique
intrínseco	inerente/interno/integrante/integral
triplo	múltiplo
silvestre	feroz/fero
unívoco	absoluto
lutador	agressivo
irreprochável	inocente
torrencial	lauto/farto/bastante/basto/copioso/abundante
antônimo	incompatível/complementar/contrário/contraditório/inverso
aquoso	líquido/húmido/diluído/molhado/úmido
simpática	empático/solidário
machucado	ferido
morena	bronzeado/escareado/escuro
volumoso	grande
incorreto	erróneo/falaz/errôneo
indefectível	verdadeiro
romântico	inviável/impraticável
incontestável	que_não_se_pode_negar/inegável
discrepante	incongruente/inconsistente
ter_queda_para	propenso/predisposto/acidente-accident-prone/tendente
irrepreensível	inocente
corporativo	organizado/corpóreo/solidário/corpórea
dimensional	multidimensional
intermediário	intermédio
contingente	definitivo
antes_da_hora	temporão/precoce/cedo
póstumo	tardio
colectivo	socialista
elefântico	grande
afectuoso	que_ama/queama/apaixonado/enfeitiçado/terno/cálido/meigo/enfatuado/afeiçoado/carinhoso/afectuoso/amoroso
incomparável	incomensurável/inigualável/incomparável/sem_comparação/único
gelatinoso	espesso/Família_de_Tyrogue
preventivo	proibitivo/saudável/obstrutivo/que_dá_preempção/que_dá_direito_de_preferência_na_aquisição/que_dá_o_direito_de_preferência_na_compra/preemptivo/impeditivo
expresso	explícito/rápido/rápida/veloz
atómico	central
glorioso	comemorada/bonito/sublime/incandescente/comemorado/celebrado/divino/formoso/lindo/belo
fascinante	curisoso/interessante
ilusório	irreal/desonroso/não_material
maléfica	sinistro/vil/atroz/ruim/nefando/desprezível/infernal/mau/abominável/diabólico
criador	criativo/inventivo/imaginativo
caucasiana	branco/branca/caucasóide/caucasiano/caucasiana
paradoxal	incompreensível/inexplicável
desconfortável	incômodo/sem_conforto/azarado/irritante/doloroso/incómodo/desconfortável/pouco_à_vontade
empresarial	empreendedor
discrionário	absoluto
rechonchudo	gordo
violeta	cromático
quíntupla	múltiplo
falso	f''/mentiroso/inconstante/artificial
posterior	concomitante/mais_hindmost/conseqüente/anexado/ulterior/resultante/decorrente/subsequente/subseqüente/posterior/rabo/traseiro/de_trás
ventoso	tempestuoso
atingido	disfuncional
amigo	social/amável/afável
porfiado	teimoso/obstinado/teimosa
rodeado	embarcado/inclusive/fechado/encrustrado/embutido/cravado/incluído
salvado	beato/abençoado
declarado	explícito
que_não_se_pode_negar	incontestável/irrefutável
caucasiano	branco/branca/caucasóide/caucasiano/caucasiana
descendente	relacionado/descendente
dooceano	ilimitado
veloz	ligeiro/instantânea/expresso/alado/acelerado/instantâneo/célere/breve/rápido/rápida/veloz
aprazível	fabulosa/simpático/cativante/deleitoso/gratificante/admirável/cheiroso/delicioso/agradável
rochoso	áspero
ajuizado	sábio
automotivo	movente
sublime	glorioso/sagrado/nobre
capaz	habilitado/elegível/aceitável/apto/engenhoso/desenvolto/habilidoso/apropriado/correspondente/capaz/conveniente/inventivo/competente/adequado
perigosa	crítico/perigoso
reticente	reservado/não_comunicativo
exacto	fiel/certo/cirúrgico/justo/correto
inicial	primeiro
belicoso	agressivo/militar
rúbido	colorido
dura	endurecido/granítico/de_ferro
timorato	tímida
vigésima	ordinal
falsificado	f''/artificial
engraçado	hilária/humorístico/ridículo/sutil/gracejador/irônico/busseta/espirituoso/jocoso/hilário/hilariante/cômico/divertido/grotesco/engraçado
promíscuo	sensual/sexy
convencido	orgulhoso/contente
habilidoso	capaz/mestre/consumado/realizado/versado/cumplido/competente/hábil/cumprido/habilidoso/experiente/talentoso
décimo	ordinal
longo_prazo	de_duração
surpreendido	estupefato
que_não_foi_pago_na_data_certa	vencido/devido
caipira	provincial
mentalmente_são	lúcido
nulo	nulo/inválido
vários	diferente
interminado	incompleto/pendente
indecente	ordinário/obsceno/sugestivo/sensual/sexy
desalentador	desencorajante
fero	silvestre/selvagem
quantitativo	numérico/quantificável/decimal
mensal	periódico/periodico
errático	não_confiável
artificial	_esquisito/f''/inconstante/afetado/artificioso/biónico/forçado/falsificado/falso/estranho/artificial/sintético
curado	bem
180	cardinal/cardeal
disfuncional	lesionado/atingido/deteriorado
folgado	frouxo/solto
querido	próximo
diverso	que_oferece_várias_aspectos/diferente/vário
atabalhoado	randômico/aleatório
bem_conhecido	sabido
forgoso	tropical/ígneo/térmico/termal
gráfico	realístico/explícito/escrito
não_material	ilusório/fantástico/fictício/mítico/alucinatório/imaginário/místico/lendário
escasso	escasso/exíguo/exígua/insuficiente
curto	lacónico/curto/curto_prazo/truncado/fugitivo/efêmero/momentâneo/conciso/fugaz/lacônico/breve/abreviado/efémero/sucinto
execrável	abominável
trienal	periódico/periodico
onze	cardinal/cardeal
lesto	ativo
cardinal	meia_dúzia/c/160/500/cem_mil/dez_mil/bilhão/quarenta/mil/trilhão/5/cento_de_noventa/uno/dois/duzentos/cento_e_oitenta/trezentos/noventa_e_nove/quatrocentos/onze/cento_e_sessenta/milhar/190/180/quinhentos/um_mil/1000/2/V/cinco
assexual	vegetativo
cheio_demais	cheio/pleno/lotado
pedra-inoperante	semvida/morto
oscilante	trêmulo/convulsivo
inconsiderado	desatento
precisa	meticulosa/meticuloso
anterior	passado/antecedente/temporão/precoce/cedo
coagulável	espesso/Família_de_Tyrogue
costumeiro	medíocre/assim_assim/crônico/cotidiano/banal/usual/habituado/quotidiano/crónico/indiferente/habitual/mais_ou_menos/inveterado
comunitário	comum
sortudo	afortunado
infindável	infinito/de_duração
circunferencial	periférico
remanescente	vivente
raivoso	bravo/tempestuoso/zangado/raivosa/irado/irritado
instruído	erudito
inviável	semvida/romântico/morto
verde	lauto/cromático/sensual/suja/farto/bastante/basto/copioso/abundante/sexy/sujo
alterno	cíclico
restrito	fechado
insano	esquizofrênico/paranoico/doido/certificável/maníaco/instável/louco/enlouquecido/doidão/lelé/possuído/pirado/demoníaco/sandeu/furioso/lelé_da_cuca/paranóico/maluco
aleijado	inapropriado
doentio	asmático/caseoso/gangrenoso/patológico/mental/ictérico/inflamatório/espumoso/edematoso/artrítico/descorado/mórbido
leviano	frívolo/fútil
parasita	dependente
bolorento	malcheiroso/fedorento
chamativo	atraente
angular	tricúspide/bicúspide/retangular/triangular/rectangular
agorafóbico	receoso
olivo	cromático
aprimorado	perfeito/sem_erros/idílico/ideal/impecável
_esquisito	atrapalhado/artificial/desajeitado
milionésimo	ordinal
Reconstructor	construtivo
sorridente	_animador/animado/contente
crespo	encaracolado/cacheado
derelito	inabitado/desabitado
análogo	equidistante/similar/equivalente/co-igual/eqüidistante
hábil	jeitoso/habilidoso/ágil/engenhoso/astuto/genial/alerta/animado/bem_disposto/hábil/talentoso
paroquial	provincial
venal	corrupto
entreaberto	aberto
narrativo	comunicativo
piedoso	devoto/hipócrita/religioso
obsceno	indecente/suja/sujo
junto	vizinho/próximo/perto
histórico	importante/passado/existente
rebelde	discontente
inalterável	fixo/invariável/imutável
civilizado	civil/humano
disparado	alto
ingénuo	cândido
torpe	desonroso/imoral
dúbio	ter_muitos_significados/enigmático
prestável	braço_direito/serviçal/obsequioso/direito/prestável
complexo	complexo/tortuoso/multifatorial/labiríntico/convoluto/complicado/colonial/intrincado
mórbido	doente/adoentado/doentio/insalubre
autopropelido	dinâmico/movente
vivaz	realístico
inerte	imóvel/inativo
ominoso	alarmante/inquietante
doído	magoado/traumático/terno/sensível/ofendido
metódico	organizado
aquática	marinho/subaquático
ouro-colorido	colorido
pedrado	embriagado/ébrio/bêbado/bêbedo
matando_cachorro_a_grito	sensual/sexy
intermitente	esporádico/casual/raro
oratório	retórico
corrupto	malandro/desonesto/venal/corruptível
sem_erros	aprimorado/perfeito
sandeu	insano
predeterminado	seguro/inevitável/certo
patrimonial	herdável
trabalhador	diligente
parcial	tendencioso/incompleto/fragmentário/meio/metade/parcial
elementar	basilar
nutritivo	saudável
A_sangue_frio	inumano/desumano
fabuloso	extraordinário/superior
ávaro	tinhoso
pleno	cheio_demais/intocado/estufado
recreativo	curisoso/interessante
habitual	frequente/corriqueiro/crônico/freqüente/habituado/crónico/ordinário/inveterado/costumeiro/genérico/comum/geral/usual/habitual/convencional
árduo	magoado/frustrante/complicada/ambicioso/controvertido/arduo/cheio_de_espinhos/traumático/difícil/sensitivo/laborioso/terno/cócegozo/sensível/desafiador/ofendido/desconcertante/complicado/problemático/espinhoso
comprovável	não_subjetivo/objetivo
fotogênico	atraente
amanteigado	obeso/gordo
desarmado	indefeso
impaciente	ávido
curto_prazo	curto
extraviado	perdido
encaracolado	tempestuoso/encaracolado/em_ondas/crespo/cacheado
basto	verde/torrencial/abundante/copioso/bastante/abudante/lauto/fácil
inflexível	intransigente/rígido/rígida/teso
adjunto	subordinada/subordinado
incomun	diferente
autonómico	involuntária/involuntário
castiço	puro/virginal/impoluto/pura/virgem
ictérico	doente/adoentado/doentio/insalubre
rançoso	fedorento/malcheiroso
terminado	polido/terminado/finalizado/completado/acabado/concluído
fajuto	húmido/molhado/úmido
febril	inquieto
natimorto	semvida/morto
domesticado	nacional/autárquico/municipal
compêndio	sucinto/lacônico/conciso/lacónico
tratável	maleável/dócil
tributário	secundário
lesionado	disfuncional
atenue	reduzido
detalhista	cuidadoso/detalhista/exigente
liso	aveludado/aerodinâmica/aerodinâmico
escarpado	repentina/súbito/abrupto/repentino
preponderante	dominante
modesto	moderado/inferior
extravagante	sobrenatural/sobrecomum
pançudo	gordo
branco	caucasiano/caucasiana
internacional	universal/alienígena/multinacional/global/mundial/estrangeiro/extrangeiro
estúpido	fátuo/burro/imbecil/idiota/sonso/estúpido
cor-cego	imparcial
delicioso	aprazível/saboroso
possível_financeiramente	barata/barato
cotidiano	rotineiro/costumeiro/comum/ordinário/normal
titular	ceremonioso/formal
ambíguo	ter_muitos_significados/enigmático
essencial	constitucional/necessário/biogênico/requerido/substancial/principal/virtual/forçoso/fundamental/preliminar/crítico/constituinte/orgânico/compulsório/obrigatório/substantivo/vital/que_não_pode_ser_dispensado/indispensável/essencial/imprescindível
heterogênea	misto/sortido/variado
descontrolado	maníaco/delirante/caótico/frenético
tropical	quente/equatorial/forgoso/figurativo
que_pode_ser_distinguido	diferenciável
vasta	grande
apreensivo	receoso/desassossegado
humanitário	humanitário/humano
sétima	ordinal
mesquinho	estreito/horrível/antipático
trianual	periódico/periodico
explícito	literal/expresso/inequívoco/gráfico/determinado/declarado/textual
ardiloso	astuto
maturo	maduro/adulto/outonal/casadoiro/maior/núbil/crescido
desassossegado	precário/preocupado/apreensivo
labiríntico	complexo/intrincado
coletável	devido/vencido
executável	possível
liberal	exuberante/progresista/esquerdista/generoso/magnânimo/grande_coração/liberal/progressista
saltear	cozinhado
poluente	infectado/séptico
federal	nacional/setentrional/do_norte/boreal
indignado	bravo/zangado/raivosa/irado/irritado
finalizado	polido/terminado/completado/acabado/concluído
incondicional	independente
degradante	tóxico/desonroso/nocivo/imoral
bidimensional	alisado
malcriado	indelicado/impolido
marronícoma	bronzeado/escareado/escuro
unificado	unido
gregário	social
maléfico	sinistro/vil/atroz/ruim/nefando/desprezível/infernal/mau/abominável/diabólico
morto	sem_vida/inviável/pedra-inoperante/natimorto/assassinado/falecido/semvida/morto
consciensiosamente	cuidadosa/cautelosa/prudente/atento
mendigo	infortunoso/infeliz/miserável
invencível	inconquistável/imbatível
ativo_em_excesso	ativo
cor_de_linho	loiro/flavo
frustrado	mal_sucedido/sem_sucesso
estudioso	erudito
ventilado	arejado/aguado/falhado/ralo
opulento	precioso/valioso
impoluto	castiço/puro
ignominioso	desonroso/imoral
patente	óbvio/obvio/evidente
comprovado	de_confiança/digno_de_confiança/confiável/fidedigno/fiável
vivo	ciente/vívido/sensível/realístico/viável/vital/informado
obrigatório	obrigatório/necessário/forçoso/compulsório/essencial/imprescindível
viável	vivo/possível
refutável	responsável
solúvel	lipófilo/questionável/hidrossolúvel
surpreendida	estupefato
profícuo	benéfico/preferencial/positiva/vantajoso/bom/positivo/boa/discriminatório
prolífico	fértil/produtor/produtivo/proveitoso/fecundo/frutífero
decorrente	subseqüente/subsequente/posterior/ulterior
simultâneo	síncrono/sincrônico
são	digno_de_confiança/lúcido/saudável/anictérico/em_forma
indutivo	implícito
insuportável	inaceitável/ofensivo/amargo/intolerável
psíquico	Fenômenos_paranormais/mental/paranormal
engenhoso	ágil/capaz/alerta/animado/bem_disposto/hábil
subtil	perspicaz
trilhão	cardinal/cardeal
cognato	relacionado
vil	maléfico/mau/má/ruim/maléfica/malvado
antinatural	violento
mendiga	infortunoso/infeliz/miserável
esporádico	isolada/ocasional/intermitente/irregular/periódico
incorporado	unido
transexual	homo/gay/homossexual
vigoroso	energético/enérgico
otimista	altista/vantajoso/alegre/de_ascensão/positivo
extenuante	magoado/traumático/terno/sensível/ofendido
gerenciável	manipulável
ambivalente	incerto/inseguro
cobiçoso	voraz/predatório/possessivo/cumulativo/avaro/ávido/ganancioso/acumulativo/predador
expirado	inválido
libertino	imoral
obliterável	eradicável
transmissível	infeccioso/contagioso
que_não_pode_ser_acessado	isolado/distante/inacessível
similar	semelhante/correspondente/análogo
conversador	tagarela
rural	bucólico/agrícola/agrário
mudado	alterado/transformado
filiado	relacionado
Família_de_Tyrogue	gelatinoso/coagulável/denso/viscoso
díspar	outro
meticuloso	bem_acabado/preciso/precisa
irritante	pouco_à_vontade/desconfortável/incómodo/incômodo
em_curso	corrente/actual/atual
hipotético	teórico
portátil	móvel
nenhuma_pessoa	incompleto
instável	insano/sísmico/inconstante/variável/vulcânico/seismico/mutável
inefável	sagrado
amarelento	cromático
axiomático	evidente/obvio/óbvio
puritânico	próprio/adequado/conveniente
versado	experiente/habilidoso/experimentado/talentoso
pesadelar	alarmante/inquietante
perneta	inapropriado
escarnecedor	desrespeitoso
viril	masculino/masculina/macho
presente	onipresente/imediata/existente/ubíquo/omnipresente
redundante	desnecessário/prolixo/desnecessária
fétido	fedorento/malcheiroso
favorável	conveniente/indulgente/amigável/benéfico/propício/preferencial/positiva/vantajoso/bom/positivo/partidário/boa/favorável/discriminatório
preciso	literal/meticulosa/certo/fiel/cirúrgico/rigoroso/justo/meticuloso/correto/textual/estrito/matemático
provisória	condicionado
luminoso	iluminado/deslumbrante/reluzente/iridescente/prata/radiante/prateado/argênteo/refulgente/faiscante/argentino/vivído/brilhante/luminoso/claro
assombroso	surpreendente
complicada	árduo/difícil/foda/intrincado
solitário	desacompanhado/inabitado/desabitado
bizarro	inusual/inconformista/sobrenatural/sobrecomum/não_convencional/insólito/extraordinário/estranho
estridente	cacofônico
povoado	inabitado
vocal	estrepitante/alta/berrante/alto
inviolável	sagrado/inalienável/invulnerável
independente	comutativa/livre/incondicional/autônomo/auto-suficiente/comutativo/involuntária/involuntário/gratís
sable	acromático
confidencial	próximo/privado
rítmico	métrico
quase_impalpável	perspicaz
experimental	empírico
infrequënte	ocasional/raro
baixo	grosso/suave/reduzido
matemático	possível/exato/preciso/correcto/certo
raro	infreqüente/extraordinário/isolada/ocasional/intermitente/irregular/periódico/infrequente/infrequënte
tentativo	condicionado
aborrecida	desinteressado
possessivo	cobiçoso/sequioso
tempestuoso	ventoso/ensurdecedor/encaracolado/ondeante/tempestuoso/furioso/feroz/raivoso
insignificanta	sem_sentido/sem_significado
mastigável	tenro/macio
frutado	saboroso
aditivo	incremental/cumulativo/extra/complementar/suplementar/adicional/aditivo
compatível	congenial/harmonioso
progresista	liberal
gorducho	gordo
elaborada	cuidadosa/cautelosa/prudente/atento
ordinário	indecente/informal/medíocre/assim_assim/crônico/cotidiano/banal/usual/habituado/quotidiano/crónico/indiferente/habitual/mais_ou_menos/inveterado
separado	desvinculado/isolado/diferente/separado/distinguido/distinto/individual/disjunto
infeliz	abjeto/mendigo/lamentável/coitado/desastroso/lastimoso/azarado/triste/miserável/pobre/mendiga/sem-teto/sem-abrigo
potencial	latente/prospectivo
sensitivo	árduo/difícil/foda/intrincado
transverso	transversal
gratinado	cozinhado
animoso	bravo/valoroso/valente/afoito/arrojado/brava/corajoso
tirante	cromático
seco	com_sede/árido/dessecado
adipose	obeso/gordo
inumano	desalmado/bestial/inumano/feroz/bárbaro/animal/cruel/A_Sangue_Frio/A_sangue_frio/brutal/desumano
duradoiro	prestativo
geoestacionário	fixado/fixo
desgostoso	ofensivo
imoral	devasso/desgraçado/infamante/degradante/libertino/ignominioso/torpe
desempregados	desempregado
frustrante	árduo/difícil/foda/intrincado
extrovertido	sociável
apressado	apressado/precipitado
majestoso	impressionante
involuntário	involuntária/vegetativo/autônomo/independente/autonômico/autonómico/automático
difícil	árduo/frustrante/complicada/ambicioso/controvertido/arduo/cheio_de_espinhos/sensitivo/laborioso/cócegozo/desafiador/desconcertante/complicado/problemático/espinhoso/difícil/foda/intrincado
infravermelho	invisível/Hollow_Man/Hollow_man
acolhedor	confortável
lépido	ativo
exemplar	decoroso/digno
piramidal	pontudo
imprevisível	ocasional/episódico
abrupto	íngrime/escarpado/repentina/explosivo/fulminante/brusco/íngreme/súbito/abrupto/repentino
distante	inacessível/longo/ulterior/mais_distante/remoto/distante/que_não_pode_ser_acessado/longe/longínquo
simples	austero/simplístico
circunstanciado	cuidadosa/cautelosa/prudente/atento
acertado	impressionante
fotogénico	atraente
moldável	susceptível/suscetível
surdo	surdo-mudo/sem_ouvido_musical
entusiástico	ardente/evangélico/ávido/zeloso/fervente/fervoroso
agressivo	enérgico/invasivo/malvado/ambicioso/predador/belicoso/truculento/competitivo/predatório/enfático/lutador/batalhador
corrosivo	sarcástico/destrutivo
granítico	dificil/dura/duro
varão	masculino/varão/fálico/masculina/macho
obscuro	incompreensível/invisível/esotérico
sensato	ciente/sábio/discreto/informado
continental	transcontinental
paranóico	insano
tépida	caloroso
octagésimo	ordinal
trapaceiro	crítico
inerente	implícito/intrínseco/intrínseca
central	atómico/importante/focal/central/nuclear/bifocal
descuidado	malfeito/desleixado
macio	aveludado/esponjoso/mastigável/lanoso/flácido/aerodinâmica/fofo/mole/aerodinâmico/fofa
desesperado(a)	perigoso
pitoresca	bonito/colorido/formoso/lindo/belo
esfomeado	faminta/faminto
afinado	certo/justo/correto
tremendo	extraordinário/grande
operativa	significativo/significante/importante
boa!	bom/boa
animado	jeitoso/_animador/alegre/sorridente/engenhoso/radiante/risonho/astuto/genial/feliz/hábil/animado/contente
impermeável	hidrófugo
arquetípico	primeiro
dourado	metálico/cromático
frequente	habitual/comum/predominante
falhado	ventilado
incansável	energético/enérgico
mecânico	mecânico/involuntária/automático/mecanizado
didática	noticioso
antropóide	humano
excitável	assustado/nervoso/sensível
desconhecido	sem_precedentes/desconhecido/pouco_conhecido
mau	incorrecto/sinistro/inferior/maléfico/vil/atroz/nefando/desprezível/infernal/abominável/diabólico/mau/má/ruim/maléfica/malvado/que_não_tem_razão
econômico	eficiente/parcimonioso/rendoso/lucrativo/proveitoso
distinto	digno/importante/diferente/separado
mercantil	comercial
renomado	sabido
digna_de_recordação	inesquecível
azulado	cromático
amorável	angélico/adorável/angelical
bêbedo	drogado/orgíaco/ligeiramente_embriagado/tocado/pedrado/grogue
pacato	quieto/silenciosa
longe	mais_distante/remoto/distante/longínquo
imbatível	imbatível/invencível
vasto	amplo/grande
frontal	dianteiro
sem_igual	desacompanhado
anual	periódico/periodico
benigno	amável
exígua	escasso
com_tontura	doente/enfermo
coitado	infortunoso/infeliz/miserável
avelaneira	cromático
móbil	transportado_pelo_ar
pernicioso	tóxico/nocivo
coxo	inapropriado
descalço	descalço/descalça
pobre	duro/infortunoso/indigente/infeliz/miserável
latente	possível/potencial
volúvel	variável/inconstante/mutável
impo	impressionante
nacional	público/doméstica/federal/domesticado/domesticada
airoso	demasiado_educado/luxuriante/luxuoso
contestável	discutível
descalça	descalço
parapsíquico	mental
sem_sucesso	que_não_realizou/desiludido/não_cumprido/não_realizado/não_satisfeito/frustrado
modularizado	padrão
branca	caucasiano/caucasiana
ralo	ventilado
corpórea	corporal/corporativo
policromático	colorido
curvilíneo	tortuoso/circunflexo/curvo
antárctico	polar
rechonchuda	gordo
dianteiro	frontal/avançado
subaquático	aquática/aquático
malcuidado	avariado/danificado
linear	unidimensional
radiante	contente/deslumbrante/reluzente/iridescente/prata/radiante/prateado/argênteo/refulgente/faiscante/argentino/animado/_animador/vivído/brilhante/luminoso/claro
fora_de_serviço	lasso
exuberante	liberal
implícito	indutivo/perfeito/inerente/tácito/implícito/absoluto
erudito	sábio/petimetre/estudioso/instruído/que_gosta_de_estudar/que_gosta_de_ler/sapiente/pedante
frutífero	prolífico/generoso/produtivo/fértil/farto/abudante
dependente	viciado/de_menor/condicionado/parasita/interdependente/dependente/cofidente/simbiôntico
multicor	colorido
realístico	gráfico/pragmático/vivo/virtual/vivaz/vivente/prático
que_não_pode_ser_dispensado	indispensável/crítico/essencial/vital
grandioso	importante/extraordinário
divertido	satisfeito/humorístico/curisoso/contente/interessante/engraçado
hiperativo	ativo
sob_medida	personalizado
fresco	refrigerado/original/congelante/crocante/estaladiço/efervecente/refrigerado_a_ar
injurioso	ofensiva/ofensivo
precioso	decoroso/astuto/semiprecioso/bonito/equivalente/magnífico/inestimável/impagável/sem_valor/que_não_tem_preço/precioso/opulento/valioso/formoso/lindo/belo/digno
ocioso	desempregado
cerúleo	cromático
visionário	utópico
rouco	cacofônico
destrutivo	negativo/iconoclástico/cáustico/esbanjador/corrosivo
titânico	grande
grácil	refinado/cultivado/gentil
apto	capaz/adequado
etéreo	insubstancial/insustancial
no_mesmo_nível	plano/nivelado
circunstancial	específico
classificável	identificável
sarcástico	corrosivo/brincalhão/saturnino/motejante/escarnificante/patético/satírico/sarcástico/travesso/arteiro
previsível	que_se_pode_prever/inevitável/inexorável/previsível
irado	bravo/indignado/lívido/colérico/furioso/feroz/raivoso/furibundo/zangado/raivosa/irado/irritado
genérico	crônico/usual/habituado/crónico/habitual/inveterado
dúplice	múltiplo
mais_distante	distante/longe/longínquo
estreita	adelgaçado/cónico/estreito
respeitável	bom
forte	alcoólico/veemente/intenso/pesado/poderoso/fortificado/robusto/musculoso/potente/intensivo
imaturo	juvenil/pubescente/pueril/imatura/infantil/imaturo
básico	importante
etnia	social
confederativo	unido
fértil	produtor/prolífico/generoso/fertilizável/farto/abudante/produtivo/proveitoso/fecundo/frutífero/fértil
espantado	receoso
predatório	cobiçoso/agressivo/sequioso
involuntária	maquinal/mecânico/involuntário/incônscio/inconsciente/vegetativo/autônomo/independente/autonômico/autonómico/automático
importante	operativa/perceptível/influente/conspícuo/monumental/o_máximo/histórico/grandioso/estratégico/distinto/sério/central/crucial/principal/decisivo/fundamental/crítico/básico/notável/proficiente/que_pode_ser_medido/grande/saliente/proeminente
alto_nível	alto
ritmado	métrico
analfabeto	semi-analfabeto
alegre	_animador/ditoso/optimista/otimista/animado/contente
deferente	respeitoso
acromático	madrepérola/esbranquiçado/nevoso/saibro/prateado/acinzentado/cinza/cinzento/gris/cinzenta/sable
arredondado	esférico/global
ineficaz	incapaz
quotidiano	rotineiro/costumeiro/comum/ordinário/normal
obstrutivo	preventivo
falta_de_esperança	indefeso/deprimido/sombrio/escalvado/pálida
cobarde	pusilânime
desperto	acordado/insone
gris	acromático
primitiva	temporão/cedo
cheiroso	aprazível/cheiroso/fragrante/aromática/perfumado
notável	significativo/extraordinário/sabido/decoroso/significante/importante/digno
traquinas	arteiro/travesso/brincalhão
zerésimo	ordinal
bimetal	metálico
pavoroso	desagradável/inquietante/alarmante/arisco
civil	civil/civilizado
apavorante	ruim
segunda_mão	antigo/velho
eventual	definitivo/possível/condicionado
reage	entusiasmado
colérico	passional/bravo/zangado/raivosa/irado/irritado
fino	pulvéreo/transparente/superior/laminado/diminuto/tênue/filiforme/diáfano/em_pó/esbelto/magro/amolgado/deprimido
escalvado	falta_de_esperança/desesperado
próprio	pessoal/específico/bom/decoroso/vitoriano/conveniente/adequado/recatado_em_excesso/puritânico/apropriado
cromático	rosa/pétreo/rosa_claro/rosado/amarelo/ambarino/baio/olivo/ruivo/coral/acastanhado/áureo/azul_celeste/laranja/verde/vermelho/cor_de_avelã/roxo/azul-petróleo/bronzeado/amarelento/sangue-vermelho/verde-azeitona/azul/avermelhado/cerúleo/cor-de-laranja/carmim/castanho/pardo/azulado/tirante/amarelado/esverdeado/marrom/de_bronze/purpúreo/avelaneira/moreno/cereja/violeta/dourado/lilás/encarnado/azul_claro/alaranjado/cor-de-rosa/púrpura/da_cor_do_bronze
infatigável	energético/enérgico
surpreso	estupefato
azul_celeste	cromático
pluvioso	húmido/molhado/úmido
pertinente	relevante/aplicável/procedente/pertinente
estendido	longo
literal	explícito/exato/verdadeiro/preciso/correcto/certo
indefeso	falta_de_esperança/inerme/vulnerável/desesperado/desarmado
ulterior	longínquo/concomitante/conseqüente/anexado/ulterior/resultante/decorrente/posterior/subsequente/subseqüente/distante
em_conformidade	consistente
milhar	cardinal/cardeal
a_ser_publicado	disponível
difícil_de_compreender	profético
proeminente	conspícuo/importante/ilustre/saliente/proeminente
combinatório	combinacional/combinável/combinatório
ígneo	quente/forgoso
gay	transexual/homo/lésbico/bicha/transsexual/veado/gay/homossexual
malfeito	descuidado/negligente
estarrecedor	incrível/inacreditável
doloroso	magoado/pouco_à_vontade/desagradável/traumático/terno/sensível/desconfortável/ofendido/incómodo/incômodo/arisco
parvenido	novo
acastanhado	cromático
comunicativo	falador/francófono/expressivo/verbal/hispanófono/anglófono/anedótico/narrativo/heráldico/comunicável/comunicativo/significativo
perspicaz	penetrante/quase_impalpável/com_clareza/arguto/subtil/incisivo
proveitoso	económico/prolífico/generoso/produtivo/rentável/fértil/lucrativo/farto/abudante/econômico
regular	cronometrado/padrão/oficial
pontiagudo	subagudo/pontudo
contraditório	inconsistente/antônimo/incompatível
equatorial	tropical
malcheiroso	bolorento/ofensivo/rançoso/fedorento/ranço/fétido/malcheiroso
abdominal	gordo
santa	sagrado/bendito/santo
esquerda	esquerdista
fortificado	forte/protegido
intuitivo	espontâneo
voluptário	sensual/sexy
saudável	curativo/antimicrobiano/profilático/saudável/anti-helmíntico/anictérico/orgânico/alimentar/preventivo/terapêutico/alimentário/salutar/nutritivo/são/salubre
sem-fim-comido	desgastado
monumental	importante/significante/significativo
espalhafatoso	insípido
combatente	militar
que_vale_a_pena	decoroso/digno
precipitado	imprudente/apressado
sofisticado	mundano/educado/inteligente/cortês/polido
irritável	tenso
ruão	colorido
cócegozo	árduo/difícil/foda/intrincado
agoráfoba	receoso
problemático	árduo/difícil/foda/intrincado
padrão	modular/regular/modularizado/feito_em_módulos
coalescente	unido
cíclico	heterocíclico/periódico/circular/alternante/alterno/alternativa/alternado/periodico
artificioso	artificial/afetado
suja	sórdido/encardido/obsceno/piolhoso/ranhoso/gordo/grudento/sujo/imunda/impudico/verde
reconhecido	estabelecido/agradecido/apreciativo/obrigado/constituído
inusual	exótico/estranho/fantástico/esquisito/singular/diferente/único/curioso/bizarro/assustador/gótico
sexy	voluptário/pornográfico/sexual/libidinoso/erótico/doidão/orgíaco/verde/matando_cachorro_a_grito/promíscuo/excitado/indecente/com_tesão/quente/devasso/lascivo
sem_idade	permanente/duradouro
péssimo	pior
espinhoso	árduo/difícil/foda/intrincado
competitivo	agressivo
distintivo	característico/caraterístico
inveterado	ordinário/costumeiro/genérico/comum/geral/usual/habitual
travesso	ruim/irónico/sapeca/traquinas/sarcástico/irônico/bagunceiro
deletério	prejudicial/nocivo/daninho/danoso
bagunçado	eriçado/hirto
triste	desagradável/triste/melancólica/pensativo/agridoce/trágico/horrendo/azarado/soturno/lúgubre/enjoado/nebuloso/horrível/lastimável/escuro/sombrio/lutuoso/ermo/entristecedor/melancólico/infortunoso/infeliz/miserável/destestável/arisco
intocado	cheio/pleno/lotado
assíncrono	anacrônico
cultivado	grácil/mimoso
enésimo	ordinal
imperioso	orgulhoso
desonroso	encantador/desgraçado/equivocado/degradante/enganador/ilusório/enganoso/ignominioso/torpe
encharcado	coberto/húmido/molhado/úmido
ranhoso	sujo/orgulhoso/suja/sujado
colectivizada	socialista
semi-analfabeto	analfabeto
explanatório	noticioso
satisfatório	bem/boa/bom
rigoroso	exato/preciso/correcto/certo
vivído	deslumbrante/reluzente/brilhante/iridescente/prata/radiante/prateado/argênteo/refulgente/luminoso/faiscante/argentino
sabido	bem_conhecido/proverbial/lendário/famoso/renomado/célebre/comemorado/notável/ilustre/legendário/de_renome
prenha	grávida
volatile	mutável/variável
morno	caloroso
esquentado	tórrido/sensual
acostumado	familiar
envergonhado	culpado
gigantesco	grande
sapeca	brincalhão/travesso/arteiro
usável	descartável/útil/prestativo
honorífico	respeitoso
interminável	permanente/de_duração/duradouro
Sfumato	irrecuperável
acetabular	côncavo/oco
saliente	proeminente/importante/ilustre
intelectual	racional/mental/bom/intelectual
remoto	longínquo/longe/distante
sfumato	irrecuperável
desnivelado	desigual/cheio_de_remendos
admissível	aceitável/lícito/admissível
pendente	interminado
desempregado	vadio/desempregados/prazeroso/preguiçoso/vagaroso/ocioso
explosivo	repentina/súbito/abrupto/repentino
acéfala	sem_cabeça
autonômico	livre/involuntária/involuntário/gratís
súper	extenso/detalhado/amplo/abrangente/exaustivo
ultravioleta	invisível/Hollow_Man/Hollow_man
persuasivo	constrangedor/coerente
incessante	contínuo/de_duração
exasperador	intensificador
omnipotente	poderoso
inofensivo	inócuo/inocente
em_ordem	Limpo
emblemático	típico
alternado	cíclico
extremamente_variável	variável
descortês	indelicado/impolido
nublado	nublado/confuso/perplexo/nevoeirento
acidentado	áspero
eclético	discriminatório
praticável	possível
propenso	ter_queda_para/inclinado
esquizofrênico	insano
pessoal	subjetivo/personalizado/próprio/privado
monstruoso	malvada/feio/iniquo/feia
legal	válido/judiciário/lícito/regulamentar/legítimo/estatutário/judicial
proibido	ilegal
ousado	audacioso/aventureiro/audaz/bravo/destemido/corajoso
outonal	maduro/maturo
líquido	descartável/aquoso/fluido
integrado	unido
irracional	sem_razão/supersticioso
sociável	social/útil/extrovertido/congenial
mais_hindmost	posterior/traseiro/de_trás
quieto	pacato/silencioso
meia_dúzia	cardinal/cardeal
inesquecível	memorável/digna_de_recordação
impróprio	sem_uso/nulidade/inutilizável/inútil/fútil/vão
da_república	democrático
qüinquagésimo	ordinal
desumano	desalmado/bestial/inumano/feroz/bárbaro/animal/cruel/A_Sangue_Frio/A_sangue_frio/brutal/desumano
fulminante	repentina/súbito/abrupto/repentino
delirante	selvagem/doente/descontrolado/enfermo
perecível	biodegradável
bestial	inumano/desumano
de_bom_aspecto	bonito/formoso/lindo/belo
calúnia	malicioso/perverso/maldoso
desajeitado	desengoçado/estranho/_esquisito
atual	real/corrente/mais_recente/contemporâneo/ligado/em_curso/hodierno/último/moderno/em_linha/vigente/até_a_data/online/actual/atual
lastimável	triste
aberto	público/escancarado/visível/entreaberto/aberto/entreaberta
coloquial	informal
repreensível	incorrecto/culpado/que_não_tem_razão
rendoso	económico/rentável/lucrativo/econômico
competente	habilidoso/eficaz/capaz/eficiente/talentoso
definitivo	conclusivo/eventual/decisivo/peremptório/supremo/final/evidente/contingente/decidido/suprema/resoluto
mal	prejudicial/nocivo/daninho/danoso
tocado	embriagado/ébrio/bêbado/bêbedo
incoveniente	bisonho/inábil/desastrado
medieval	passado
irrestrito	abandonado
dogmático	estreito
que_não_realizou	mal_sucedido/sem_sucesso
adaptativo	adaptável
defensivo	de_desculpa
