muito	numeroso
outro	oposto/díspar/diferente
dois	cardinal/cardeal
grande	importante/astronômico/extraordinário/titânico/considerável/épico/massudo/massivo/maior/colossal/tremendo/cósmico/descomunal/elefantino/extenso/volumoso/imenso/galáctico/gigantesco/enorme/grosso/heróico/vasto/amplo/alta/berrante/alto
primeiro	original/ordinal/arquetípico/inicial/principal/primeira
mesmo	equivalente/sinótico/correspondente/idêntico/comparável
novo	original/temporão/passado/virgem/revolucionário/recente/cedo
segundo	ordinal
público	nacional/comum/estadual/estatal
bom	afortunado/próprio/respeitável/cómodo/intelectual/favorável/reto/angelical/satisfatório/magnífico/sólido/beatificação/oportuno/aceitável/angélico/adequado/conveniente/profícuo/vantajoso/propício/justo/recto
último	passado/improvável/corrente/pior/actual/atual
mil	cardinal/cardeal
bem	assintomático/satisfatório
próximo	vizinho/confidencial/futuro/querido/envolvente/circundante/íntimo/aproximado/acalorado/imediato/apenso/contíguo/familiar/adjacente/quente/iminente/calmoso/junto/perto
próprio	pessoal/específico/bom/decoroso/vitoriano/conveniente/adequado/apropriado
passado	recente/vetusto/histórico/pré-histórico/anterior/antigo/último/medieval/novo/prévio
final	definitivo
pequeno	microscópico/jovem/reduzido/moderado/inferior/menor/minúsculo/pequenito/esguio/anão/diminuto/pequenino
nacional	público/federal
meio	parcial/fracionário
responsável	refutável/sujeito/fidedigno
partido	incompleto
alto	ensurdecedor/graduado/magestoso/derradeiro/empinado/acima/grande/vocal/avançado/capitanear/superior/eminente/elevado
único	individual/incomparável/inusual/desacompanhado/insólito/extraordinário/estranho
social	amistoso/sociável/gregário/amigável/étnico/amigo/cultural/etnia
direito	reto/serviçal/prestável/justo/recto
principal	essencial/importante/primeiro
possível	matemático/latente/eventual/atingível/praticável/factível/viável/maneável/executável/manejável/exeqüível/alcançável/realizável
actual	chique/corrente/real/contemporâneo/hodierno/último/moderno/vigente/online/atual
cinco	cardinal/cardeal
futuro	iminente/emergente/próximo
importante	perceptível/influente/conspícuo/monumental/histórico/grandioso/estratégico/distinto/sério/central/crucial/principal/decisivo/fundamental/crítico/básico/notável/proficiente/grande/saliente/proeminente
jovem	terno/pequeno/juvenil/cedo/infantil/pré-adolescente/temporão/tenro/vulnerável
política	governamental
antigo	passado/antediluviano/amarelo/arcaico/usado
económico	rendoso/parcimonioso/eficiente/lucrativo/proveitoso
certo	exacto/literal/rigoroso/justo/perfeito/preciso/correto/afinado/textual/exato/estrito/matemático
longo	longínquo/estendido/extensível/alongado/distante/prolongado/prorrogável
internacional	universal/alienígena/multinacional/global/mundial/estrangeiro
militar	belicoso/marcial/guerreiro/combatente
nenhum	incompleto
plano	horizontal
necessário	requerido/imprescindível/indispensável/obrigatório/essencial
anterior	passado/antecedente/temporão/precoce/cedo
vários	diferente
socialista	colectivo/coletivo
geral	comum/crônico/usual/habituado/habitual/inveterado
dirigente	poderoso
forte	alcoólico/veemente/intenso/pesado/poderoso/robusto/musculoso/potente/intensivo
junto	vizinho/próximo/perto
terceiro	ordinal
total	completo/inteiro/integral
mundial	internacional/extenso/amplo/abrangente/exaustivo
estrangeiro	externo/internacional/estranho/exótico
claro	deslumbrante/reluzente/brilhante/iridescente/prata/radiante/prateado/argênteo/refulgente/luminoso/faiscante/argentino
difícil	árduo/frustrante/ambicioso/controvertido/sensitivo/laborioso/desafiador/desconcertante/complicado/problemático/espinhoso/foda/intrincado
diverso	diferente/vário
contrário	antônimo/malvado
central	importante/focal/nuclear/bifocal
presente	onipresente/existente/ubíquo
oficial	formal/regular/autorizado/constituído
mal	prejudicial/nocivo/daninho/danoso
trabalhador	diligente
mau	incorrecto/sinistro/inferior/maléfico/vil/atroz/nefando/desprezível/infernal/abominável/diabólico/má/ruim/malvado
humano	antropóide/civilizado/humanitário/imperfeito/antropomorfo/antropomórfico
diferente	variado/separado/outro/anômalo/antitético/sortido/distinto/vários/diverso/divergente/estranho/inusual/insólito/extraordinário
especial	primário/extraordinário/específico
baixo	grosso/suave/reduzido
rápido	ativo/eficiente/preparado/ligeiro/expresso/alado/instantâneo/célere/breve/pronto/disposto/prestes/veloz
2	cardinal/cardeal
pessoal	subjetivo/personalizado/próprio/privado
privado	secreto/pessoal/confidencial
velho	antediluviano/senil/centenário/amarelo/venerável/arcaico/usado/escuro
preciso	literal/certo/fiel/cirúrgico/rigoroso/justo/meticuloso/correto/textual/estrito/matemático
recente	passado/novo/crocante/estaladiço
civil	civilizado
cultural	social
regional	territorial
perto	vizinho/contíguo/acalorado/quente/calmoso/junto/próximo
amigo	social/amável/afável
comercial	inferior/mercantil
bastante	confortável/suficiente/verde/torrencial/lauto/fácil/farto/basto/copioso/abundante
verdadeiro	indefectível/típico/legítimo/sério/genuíno/autêntico/literal
modelo	decoroso/digno
médio	moderado/normal
longe	remoto/distante/longínquo
interior	interno
grave	crítico/sério
livre	definido/autônomo/soberano/independente
comum	democrático/inferior/comunitário/medíocre/informal/crônico/cotidiano/público/banal/geral/usual/estatal/habituado/quotidiano/indiferente/habitual/freqüente/inveterado
histórico	importante/passado/existente
parlamentar	democrático
popular	democrático/turístico/favorito/predileto
natural	físico/biológico/normal
prático	conveniente/acessível/pragmático/realístico/funcional
particular	específico
capaz	habilitado/elegível/aceitável/apto/engenhoso/desenvolto/habilidoso/apropriado/correspondente/conveniente/inventivo/competente/adequado
material	físico/substancial/tangível
respectivo	individual
real	sério/corrente/existente/nobre/actual/atual
comunitário	comum
interno	interior/intrínseco
milhar	cardinal/cardeal
negro	escuro
simples	austero/simplístico
branco	caucasiano/caucasiana
positivo	afirmativo/favorável/construtivo/otimista/profícuo/vantajoso/propício
objetivo	comprovável/clínico/impessoal
imediato	preparado/próximo/pronto/disposto/prestes
tradicional	convencional/ortodoxo
5	cardinal/cardeal
fácil	indolor/superficial/casual/lauto/farto/bastante/basto/copioso/abundante
eventual	definitivo/possível
existente	vivente/presente/documental/histórico/real
crítico	adoentado/discriminativo/essencial/fundamental/chicaneiro/perigoso/decisivo/grave/trapaceiro/judicial/imprescindível/indispensável/importante/crucial
enorme	grande
relativo	relacional
morto	inviável/falecido
fundamental	crítico/basilar/essencial/importante/crucial
metade	incompleto/parcial/fracionário
curto	fugitivo/efêmero/momentâneo/conciso/fugaz/lacônico/breve/sucinto
independente	livre/incondicional/autônomo/auto-suficiente/comutativo/involuntário
suficiente	confortável/bastante
governamental	política
diário	periódico
doente	asmático/gangrenoso/frenético/patológico/mental/ictérico/inflamatório/espumoso/delirante/nauseante/artrítico/paralítico/descorado/tísico/verdejante/diabético/mórbido/vertiginoso/tonto/indisposto
vivo	ciente/vívido/sensível/realístico/viável/vital/informado
democrático	comum/parlamentar/popular/republicano
global	internacional/extenso/redondo/amplo/abrangente/exaustivo/circular/arredondado
significativo	comunicativo/monumental/notável/substantivo/substancial
igual	equivalente/eqüidistante
normal	medíocre/modal/típico/cotidiano/média/banal/natural/quotidiano/indiferente/médio
sério	importante/real/solene/sincero/genuíno/verdadeiro/grave
esquerda	esquerdista
disponível	descartável/comprável/adquirível/visível
negativo	destrutivo/desvantajoso/desfavorável
seguro	invulnerável
essencial	constitucional/necessário/requerido/substancial/principal/virtual/forçoso/fundamental/preliminar/crítico/constituinte/orgânico/compulsório/obrigatório/substantivo/vital/indispensável/imprescindível
familiar	informal/conhecido/próximo/acostumado
científico	tecnológico
legal	válido/judiciário/lícito/regulamentar/legítimo/estatutário/judicial
físico	energético/corpóreo/material/natural/sensual/fisiológico/carnal/somático/enérgico
animal	inumano/desagradável/arisco/desumano
semelhante	similar/relacionado
corrente	real/contemporâneo/actual/hodierno/último/moderno/vigente/atual/online
habitual	corriqueiro/crônico/freqüente/habituado/ordinário/inveterado/costumeiro/genérico/comum/geral/usual/convencional
vizinho	próximo/contíguo/acalorado/quente/calmoso/junto/perto
duro	pobre/granítico
evidente	definitivo/axiomático/franco/transparente/patente/demonstrável/óbvio/manifesto
acima	alto
elevado	nobre/alto
específico	especificado/circunstancial/ad_hoc/nominal/mero/especial/particular/avulso/ad-hoc/próprio/peculiar
produtor	fértil/cultivável/fecundo/prolífico/arável
colectivo	socialista
excelente	superior
profundo	intenso/intensivo
favorável	conveniente/indulgente/amigável/benéfico/propício/preferencial/vantajoso/bom/positivo/partidário/boa/discriminatório
alternativa	cíclico
pronto	imediato/rápido
breve	rápido/curto/veloz
média	normal
absoluto	inequívoco/inalienável/completo/infinito/implícito/unívoco/arbitrário/integral
exterior	externo
inicial	primeiro
externo	exterior/alienígena/estrangeiro
500	cardinal/cardeal
judicial	legal/crítico
religioso	piedoso/hipócrita/sagrado/devoto
surpresa	estupefato
verde	lauto/cromático/sensual/farto/bastante/basto/copioso/abundante/sexy/sujo
largo	panorâmico
concreto	sólido/tangível
alimentar	saudável
complexo	tortuoso/labiríntico/complicado/colonial/intrincado
original	primário/primeiro/criativo/fresco/inovador/novo/inventivo/nova/imaginativo
pobre	duro/indigente/infeliz/miserável
completo	total/exaustivo/absoluto/inteiro/integral
pleno	intocado/estufado
clássico	neoclássico
simultâneo	síncrono/sincrônico
ligeiro	rápido/inteligente/ativo/veloz
idêntico	proporcionado/mesmo/equivalente/eqüidistante/congruente
impossível	desesperado/impraticável
interessante	colorido/atraente/decoroso/recreativo/fascinante/intrigante/absorvente/entretido/divertido/digno
má	sinistro/vil/atroz/ruim/nefando/desprezível/infernal/mau/abominável/diabólico
estranho	inusual/sobrenatural/inconformista/atrapalhado/artificial/fantástico/esquisito/singular/diferente/único/curioso/bizarro/desajeitado/exótico/assustador/estrangeiro/insólito/extraordinário/gótico
avançado	precoce/alto/dianteiro
cheio	intocado/estufado
quinto	ordinal
anual	periódico
inferior	modesto/brega/comercial/lamentável/medíocre/comum/ruim/ignoto/humilde/mau/miserável/pequeno
decisivo	definitivo/crítico/conclusivo/fatídico/determinante/importante/crucial
moderno	corrente/progressivo/chique/contemporâneo/actual/atual
partidário	favorável
estratégico	importante
circular	cíclico/esférico/global
básico	importante
permanente	irreversível/indissolúvel/interminável/eterno/perene/perpétuo/imperecível/duradouro
nuclear	central
individual	único/separado/respetivo/idiossincrático/respectivo/singular
famoso	sabido
cedo	jovem/nítrico/mirim/contemporâneo/primitivo/incipiente/novo/primordial/primitiva/prematuro/anterior
falso	mentiroso/inconstante/artificial
provável	suposto
perigoso	crítico/alarmante/suicida/traiçoeiro/incerto/insidioso/arriscado/desesperador/inquietante
fraco	impotente/débil
efetivo	impressionante
visível	visual/disponível/microscópico
rico	afluente
definitivo	conclusivo/eventual/decisivo/peremptório/supremo/final/evidente/contingente/decidido/resoluto
elétrico	emocionante/excitante
concorrente	síncrono/sincrônico
secundário	auxiliar/subordinado/tributário/alternativo/colateral/adicional/suplementar
conforme	consistente
azul	setentrional/cromático/boreal
obrigatório	necessário/forçoso/compulsório/essencial/imprescindível
moral	casto/mental
masculino	varão/viril/macho/varonil
constante	inquebrantável/invariável/contínuo
puro	harmonioso/imaculado/intenso/virginal/impoluto/virgem/castiço
extraordinário	bonito/tremendo/superior/fenomenal/incomum/exótico/estranho/pirotécnico/especial/excepcional/formidável/misterioso/fantástico/esquisito/notável/raro/singular/diferente/admirável/único/maravilhoso/curioso/estonteante/fabuloso/grande/bizarro/grandioso/assustador/magnífico/formoso/lindo/belo/horrível/gótico
violento	antinatural/fulo/convulsivo/feroz/bravo/intenso/afetado/intensivo/sangrento
agrícola	rural
radical	basilar
constitucional	essencial
inteiro	completo/integral/total
passageiro	temporário
frio	glacial/frigorífico/gélido/gelado/polar/ártico
turístico	popular
sexual	sensual/sexy
artístico	estético
inevitável	inexorável/previsível
ilegal	criminoso/extrajudicial/interdito/penal/ilegítimo/ilícito/proibido/defeso/inelegível
raro	extraordinário/ocasional/intermitente/irregular/periódico/infrequente
exemplar	decoroso/digno
vermelho	cromático/colorido
eficaz	habilitado/impressionante/competente
interessado	curioso
titular	formal
liberal	exuberante/esquerdista/generoso/magnânimo/progressista
1º	ordinal
regular	cronometrado/padrão/oficial
imenso	grande
ideal	abstrato/aprimorado/perfeito
secreto	privado/esotérico
líquido	descartável/aquoso/fluido
patente	óbvio/evidente
vasto	amplo/grande
contemporâneo	chique/moderno/corrente/temporão/progressivo/síncrono/cedo/sincrônico/actual/atual
empresarial	empreendedor
óbvio	axiomático/franco/transparente/patente/demonstrável/manifesto/evidente
belo	extraordinário/cênico/atraente/esplêndido/lindíssimo/fantástico/glorioso/pitoresco/bonito/precioso/magnífico/deslumbrante/maravilhoso/formoso/lindo
feliz	ditoso/afortunado/animador/bendito/animado/contente
correspondente	similar/relacionado/mesmo/capaz/adequado
formal	oficial/literário/titular/solene/convencional
pesado	maciço/forte/húmido/molhado
justo	invulnerável/apertado/fiel/exacto/direito/reto/cirúrgico/perfeito/bom/preciso/afinado/certo/exato/recto
duplo	múltiplo
intelectual	racional/mental/bom
polêmico	discutível/conflituoso/controverso
poderoso	dirigente/forte/influente/constrangedor/potente/todo-poderoso/onipotente
intenso	puro/profundo/sensasional/forte/brutal/violento/esmero/severo/terrível/veemente/maior/feroz/horrível/intensivo
alternativo	inconformista/secundário
dramático	espetacular/impressionante/melodramático
útil	funcional/sociável/conveniente/acessível/usável/utilizável/reutilizável/reciclável
curioso	interessado/inusual/insólito/extraordinário/estranho
vazio	cavernoso/tubular/vago/refletivo/vacante/desocupado
franco	evidente/óbvio
sensível	vivo/excitável/árduo/dolorido/doloroso/extenuante/doído
correcto	literal/rigoroso/textual/estrito/matemático
fiel	exacto/justo/acurado/exato/preciso
mero	específico/especificado
aliado	unido
consecutivo	contínuo
indispensável	necessário/crítico/vital/imprescindível/essencial
infantil	jovem/juvenil/pueril/imaturo
paralelo	síncrono/sincrônico
federal	nacional/setentrional/boreal
republicano	democrático
exclusivo	privilegiado/seletivo
autônomo	independente/livre/involuntário
plenário	extenso/amplo/abrangente/exaustivo
autêntico	verdadeiro/genuíno/legítimo
notável	significativo/extraordinário/sabido/decoroso/significante/importante/digno
dependente	viciado/parasita/interdependente
célebre	sabido
favorito	popular
estatal	comum/público
perfeito	infinito/certo/idílico/ideal/implícito/justo/correto/aprimorado/impecável
amarelo	cromático/antigo/velho
bonito	extraordinário/cênico/atraente/esplêndido/lindíssimo/fantástico/glorioso/pitoresco/precioso/magnífico/deslumbrante/maravilhoso/formoso/lindo/belo
excessivo	prolixo/desnecessário
imóvel	inerte/rígido/estacionário/estático/quedo
sexto	ordinal
rural	bucólico/agrícola/agrário
mestre	habilidoso/talentoso
numeroso	muito
adjunto	subordinado
barato	pagável
resultante	subsequente/posterior/ulterior
escasso	exíguo/insuficiente
quente	tórrido/perto/tropical/ígneo/sensual/térmico/termal/próximo/vizinho/sexy
optimista	altista/alegre
literário	formal
tecnológico	científico
razoável	moderado
desempregado	vadio/preguiçoso/vagaroso/ocioso
adulto	maturo/maduro
c	cardinal/cardeal
sonoro	suave
lento	mandrião
onze	cardinal/cardeal
prévio	antecedente/passado
atento	absorto/consciente/minucioso/solícito/pormenorizado/circunstanciado/consciencioso
vão	nulidade/inutilizável/fútil/inapto/inútil/impróprio
humanitário	humano
contínuo	repetitivo/perene/consecutivo/persistente/incessante/constante/recorrente/perpétuo/ininterrupto/insistente
quotidiano	rotineiro/costumeiro/comum/ordinário/normal
primário	especial/original
parcial	tendencioso/incompleto/fragmentário/meio/metade
inesperado	imprevisto
alerta	insone/jeitoso/engenhoso/astuto/genial/hábil
típico	verídico/normal/característico/representativo/emblemático/verdadeiro
legítimo	genuíno/legal/autêntico/verdadeiro
mínimo	simbólico/marginal
triste	desagradável/pensativo/agridoce/trágico/horrendo/azarado/soturno/lúgubre/enjoado/nebuloso/horrível/lastimável/escuro/sombrio/lutuoso/ermo/entristecedor/melancólico/infeliz/miserável/arisco
estrutural	construtivo/funcional
psicológico	mental
clínico	objetivo
competitivo	agressivo
primeira	primeiro
simbólico	representativo/minimum/mínimo
educativo	noticioso
sólido	bom/concreto/adequado/boa
criminoso	ilegal/culpado
mensal	periódico
laranja	cromático
gráfico	realístico/explícito/escrito
rigoroso	exato/preciso/correcto/certo
amplo	espaçoso/panorâmico/grande/extenso/plenário/universal/global/vasto/mundial/abrangente/exaustivo
freqüente	habitual/comum/predominante
doméstico	caseiro
previsível	inevitável/inexorável
posterior	concomitante/ulterior/resultante/decorrente/subsequente/rabo/traseiro
mortal	virulento/nefasto/fatal/impiedoso
potencial	latente
étnico	social
discreto	prudente/judicioso/sensato
equivalente	precioso/parelho/mesmo/idêntico/igual/análogo/valioso
manifesto	óbvio/evidente
múltiplo	denário/triplo/quádruplo/duplo/binário/quíntuplo/dúplice
criador	criativo/inventivo/imaginativo
deficiente	inapropriado
brilhante	superior/colorido/inteligente/deslumbrante/reluzente/iridescente/prata/radiante/prateado/argênteo/refulgente/faiscante/argentino/luminoso/claro
marítimo	litorâneo/costeiro
surpreendente	impressionante/estonteante/espantoso/assombroso
representativo	típico/alegórico/simbólico
complementar	antônimo/aditivo
terminal	nefasto/fatal
temporário	episódico/evanescente/precário/efêmero/interino/transitório/passageiro
estreito	mesquinho/dogmático
considerável	grande/apreciável
teórico	especulativo/metafísico/hipotético
dominante	supremo/ascendente/preponderante/soberano/primordial/preeminente
ofensiva	injurioso
incapaz	impotente/incompetente/inadequado/ineficaz
ideológico	abstrato
sanitário	higiênico
louco	entusiasmado/tolo/insano/excitado
insuficiente	inadequado/escasso
padrão	modular/regular
distinto	digno/importante/diferente/separado
aparente	superficial
relevante	pertinente/aplicável/procedente
excepcional	extraordinário/superior
súbito	escarpado/explosivo/fulminante/repentino/abrupto/brusco
baixa	reduzido
absurdo	tolo
espetacular	dramático/impressionante
argentino	radiante/brilhante/luminoso/claro
digno	precioso/distinto/impecável/modelar/modelo/interessante/louvável/merecedor/exemplar/valioso/notável/decoroso
sétimo	ordinal
distante	inacessível/longo/ulterior/remoto/longe/longínquo
mútuo	bilateral/interactivo/interativo
tranqüilo	constituído
multinacional	internacional
firme	imutável
revolucionário	novo
escuro	tenebroso/triste/velho/crepuscular/negro/sombrio/morena
criminal	culpado
universal	internacional/extenso/amplo/abrangente/exaustivo
calmo	constituído
regulamentar	legal
estético	artístico/cosmético
produtivo	próspero/fértil/cultivável/prolífico/arável/proveitoso/fecundo/frutífero/bem-sucedido
exacto	fiel/certo/cirúrgico/justo/correto
modesto	moderado/inferior
agradável	agradecido/simpático/idílico/ameno/aprazível
gigantesco	grande
inteligente	racional/inato/sofisticado/ágil/brilhante/ligeiro
delicado	frágil
orgânico	saudável/essencial
confiante	segurado/presunçoso/auto-confiante
consciente	atento/evocador/nostálgico/sugestivo
nobre	elevado/impressionante/imperial/impecável/aristocrata/brioso/senhorial/magnânimo/aristocrático/sublime/real
mental	doente/intelectual/moral/psicológico/racional/psíquico/adoentado/doentio/insalubre
estável	duradouro
substancial	essencial/material/significativo/adequado
terrível	ofensivo/intenso/ruim/desagradável/alarmante/inquietante/intensivo/arisco
explícito	literal/expresso/inequívoco/gráfico/determinado/declarado/textual
gratuito	desnecessário
santo	bendito/sagrado
marginal	minimum/mínimo
vago	vazio/confuso/enigmático
válido	lógico/legal
semanal	periódico
singular	inusual/desacompanhado/individual/insólito/extraordinário/estranho
inclusive	cercado
competente	habilidoso/eficaz/capaz/eficiente/talentoso
vário	diverso/variável
intermédio	antepenúltimo/penúltimo/intermediário
visual	visível
agressivo	enérgico/invasivo/malvado/ambicioso/predador/belicoso/truculento/competitivo/predatório/enfático/lutador/batalhador
fresco	original/crocante/estaladiço
virtual	essencial/realístico
íntimo	próximo/confortável
explosivo	súbito/abrupto/repentino
imaginário	irreal
contraditório	inconsistente/antônimo/incompatível
devido	pagável
dez_mil	cardinal/cardeal
simpático	agradecido/agradável/idílico/ameno/aprazível
leve	translúcido
anônimo	incógnito/anónimo
fantástico	irreal/inusual/bonito/insólito/extraordinário/estranho/formoso/lindo/belo
auxiliar	secundário/subordinado
móvel	portátil/movente
esmagador	irresistível
determinante	decisivo
prata	radiante/brilhante/luminoso/claro
preventivo	proibitivo/saudável/obstrutivo/impeditivo
assistente	subordinado
extenso	grande/plenário/universal/global/mundial/amplo/abrangente/exaustivo
seco	árido
colonial	complexo/intrincado
trágico	triste
ridículo	engraçado/humorístico
ambicioso	compulsivo/intrincado/agressivo/foda/difícil/árduo
vital	vivo/essencial/imprescindível/indispensável
frágil	delicado
homossexual	transexual/lésbico/bicha/transsexual/veado/gay
bilateral	simétrico/recíproco/mútuo
precioso	decoroso/astuto/bonito/equivalente/magnífico/inestimável/impagável/opulento/valioso/formoso/lindo/belo/digno
suplementar	secundário/aditivo
progressivo	progressista/estado-da-arte/inovador/contemporâneo/moderno
adicional	secundário/aditivo
integral	intrínseco/total/exaustivo/completo/absoluto/inteiro
incómodo	azarado/irritante/desconfortável/doloroso
moderado	modesto/médio/limitado/cauteloso/razoável/pequeno
magnífico	bom/precioso/impressionante/superior/extraordinário/bonito/boa/valioso/formoso/lindo/belo
supremo	dominante/definitivo
artificial	esquisito/inconstante/afetado/artificioso/forçado/falso/estranho/sintético
suscetível	impressionável/moldável/vulnerável/alérgico/hipersensível
automático	mecânico/semiautomático/involuntário
criativo	construtivo/original/inventivo/imaginativo/criador
impressionante	efetivo/admirável/majestoso/palaciano/formidável/dramático/nobre/magnífico/fulgurante/heróico/imponente/formigueiro/impo/espetacular/surpreendente/eficaz/eficiente
territorial	regional
inocente	irrepreensível/inócuo/inofensivo
juvenil	infantil/jovem/imaturo
perdido	extraviado/sumido/desperdiçado/maldito/desaparecido
mágico	sobrenatural
envolvente	próximo
nulo	inválido
contente	animador/bendito/afortunado/ditoso/alegre/saciado/sorridente/divertido/radiante/risonho/convencido/feliz/presunçoso/vaidoso/satisfeito/animado
eterno	permanente/duradouro
oitavo	ordinal
indiferente	desinteressado/imparcial/rotineiro/letárgico/costumeiro/comum/ordinário/normal
ofensivo	injurioso/desgostoso/fedorento/insuportável/terrível/malcheiroso/nauseante/desagradável/nojento/repugnante/detestável/odioso/enjoativo
irônico	humorístico/brincalhão/engraçado/travesso/arteiro
controverso	discutível/conflituoso/polêmico
centenário	velho
experimental	empírico
aceitável	capaz/bom/admissível/boa/adequado
derradeiro	alto
acessível	compreensível/prático/cômodo/útil
mecânico	automático
espiritual	sagrado/imaterial
crucial	fundamental/importante/decisivo/crítico
pontual	tempestivo
genérico	crônico/usual/habituado/habitual/inveterado
grosso	caloso/baixo/gordo/grande
pior	péssimo/último
180	cardinal/cardeal
duvidoso	inseguro/incerto
nervoso	tenso/entusiasmado/excitável/excitado
terrestre	leigo/secular
fatal	nefasto/terminal/mortal/letal
romântico	inviável/impraticável
conhecido	familiar
inaceitável	inadmissível/insuportável/intolerável
calma	constituído
decorrente	subsequente/posterior/ulterior
lógico	racional/válido
inovador	original/progressivo/chique
encarnado	cromático
saudável	curativo/antimicrobiano/profilático/anti-helmíntico/orgânico/alimentar/preventivo/terapêutico/salutar/nutritivo/são/salubre
sujeito	responsável/afetado
ortodoxo	convencional/canônico/tradicional
nova	original
injusto	sujo
descendente	relacionado
maciço	pesado
preliminar	exploratório/essencial
classificado	categorizado
reconhecido	agradecido/apreciativo/obrigado/constituído
activista	ativo
solitário	desacompanhado/inabitado/desabitado
décimo	ordinal
irregular	anormal/raro/imperfeito/casual/esporádico
cego	invisual/desafiado/daltônico
precário	inseguro/desassossegado/sísmico/temporário/vulcânico
convencional	ortodoxo/recebido/tradicional/habitual/formal
triplo	múltiplo
confortável	suficiente/aliviar/acolhedor/íntimo/bastante
cem_mil	cardinal/cardeal
etnia	social
implícito	indutivo/perfeito/inerente/tácito/absoluto
informativo	consultivo/consultor
poético	retórico/figurativo
doce	brando
mítico	irreal
rosa	cromático
adequado	aceitável/elegível/próprio/substancial/bom/apto/decoroso/vitoriano/correspondente/sólido/capaz/apropriado/conveniente
biológico	natural
solidário	coletivo/cooperativo/corporativo
exigente	cuidadoso
oposto	outro/malvado
selvagem	feroz/maníaco/delirante/caótico/frenético/fero
preocupado	desassossegado
noticioso	consultivo/demonstrativo/educativo/explicativo/didático/explanatório/consultor
credível	convincente
compatível	congenial/harmonioso
lamentável	inferior/desagradável/ruim/infeliz/miserável/arisco
informal	ordinário/frívolo/familiar/vernáculo/comum/coloquial/oficioso/fútil
metálico	dourado/argênteo/aurífero/brônzeo/áureo
fabuloso	extraordinário/superior
característico	típico/sintomático/distintivo
sinistro	maléfico/mau/má/ruim/malvado
escrito	manuscrito/gráfico
organizado	corporativo/metódico
fechado	restrito/comprimido/cercado
influente	possante/importante/prestigioso/potente/poderoso
racista	racial
quadrado	quadricular
tóxico	degradante/pernicioso/virulento/venenoso
nono	ordinal
transparente	fino/evidente/óbvio
coerente	persuasivo/adesivo/racional
prestes	imediato/rápido
vocal	alta/berrante/alto
paciente	diligente/tolerante
misterioso	incompreensível/extraordinário/sobrenatural/esotérico/inexplicável
inútil	insignificante/nulidade/inutilizável/fútil/vão/inapto/impróprio
dinâmico	cinético
incrível	improvável/estarrecedor
espantoso	surpreendente
inequívoco	absoluto/explícito
rígido	imóvel/inflexível
periódico	raro/mensal/cíclico/semanal/diário/anual/trienal/quinzenal/trianual/casual/esporádico
fino	transparente/superior/laminado/diminuto/tênue/filiforme/diáfano/esbelto/magro/amolgado
cinzento	acromático
sujo	antipático/injusto/sórdido/encardido/obsceno/piolhoso/ranhoso/gordo/impudico/verde/horrível
cardeal	c/160/500/cem_mil/dez_mil/bilhão/quarenta/mil/trilhão/5/uno/dois/duzentos/cento_e_oitenta/trezentos/noventa_e_nove/quatrocentos/onze/cento_e_sessenta/milhar/190/180/quinhentos/um_mil/1000/2/v/cinco
ilícito	ilegal/extraconjugal
viável	vivo/possível
irreversível	permanente
contingente	definitivo
medieval	passado
inerente	implícito/intrínseco
variável	ajustável/volúvel/versátil/regulável/volátil/instável/adaptável/vário
confuso	nublado/desconcertante/vago/intrigante/aleatório
isento	privilegiado/imune
limpo	imaculado/asseado
desejável	preferível/elegível/invejável
infeliz	abjeto/mendigo/lamentável/coitado/desastroso/lastimoso/azarado/triste/miserável/pobre/mendiga/sem-teto/sem-abrigo
falecido	morto
emocional	inquieto/empolgante/sentimental/lírico/afetivo
brutal	intenso/inumano/desumano/intensivo
inverso	antônimo
combatente	militar
160	cardinal/cardeal
desfavorável	negativo/ruim
expressivo	comunicativo
consultor	noticioso/informativo
cúbico	tridimensional/isométrico
genuíno	verdadeiro/sério/autêntico/legítimo
generoso	fértil/liberal/proveitoso/fecundo/frutífero
monumental	importante/significante/significativo
penal	punitivo/ilegal
remoto	longínquo/longe/distante
cauteloso	moderado
solene	sério/formal
narrativo	comunicativo
aliviar	confortável
oportuno	propício/bom/cómodo
suave	sonoro/baixo/comedido/manso/harmonioso
abstracto	esotérico
cirúrgico	preciso/exato/acurado/justo/exacto
barroco	sobrenatural
animador	contente/alegre/sorridente/radiante/risonho/animado/feliz
tardio	póstumo/retardado
perverso	danoso/malevolente/venenoso/malévolo/maldoso/calúnia/malvado
imprescindível	necessário/obrigatório/indispensável/forçoso/crítico/compulsório/vital/essencial
doloroso	magoado/desagradável/traumático/terno/sensível/desconfortável/ofendido/incómodo/incômodo/arisco
intermediário	intermédio
penúltimo	intermédio
sangrento	ensanguentado/violento
elementar	basilar
crônico	degenerativo/ordinário/costumeiro/genérico/comum/geral/usual/habitual
longínquo	longo/ulterior/remoto/longe/distante
reduzido	baixo/pequeno/baixa
funcional	prestativo/prático/útil/estrutural
iminente	futuro/próximo
hostil	inóspito
definido	livre
privilegiado	exclusivo/isento
documental	existente
desastroso	infeliz/miserável
satisfatório	bem/boa/bom
insólito	exótico/estranho/fantástico/esquisito/singular/diferente/único/curioso/bizarro/assustador/gótico
costeiro	marítimo
lesionado	disfuncional
luminoso	iluminado/deslumbrante/reluzente/iridescente/prata/radiante/prateado/argênteo/refulgente/faiscante/argentino/brilhante/claro
lucrativo	rendoso/económico/rentável/proveitoso
eficiente	rápido/impressionante/habilitado/económico/competente
rítmico	métrico
convencido	orgulhoso/contente
prudente	minucioso/sábio/discreto/pormenorizado/circunstanciado/consciencioso
verbal	comunicativo
conveniente	prático/elegível/próprio/capaz/favorável/bom/decoroso/vitoriano/útil/apropriado/adequado
imprevisível	ocasional/episódico
resistente	desafiador/caloso
alcoólico	viciado/forte
similar	semelhante/correspondente/análogo
vigente	corrente/actual/atual
judiciário	legal
valioso	decoroso/equivalente/magnífico/inestimável/impagável/precioso/opulento/digno
ilustre	sabido/conspícuo/saliente/proeminente
propício	benéfico/preferencial/oportuno/vantajoso/bom/positivo/boa/favorável/discriminatório
quarenta	cardinal/cardeal
condenado	maldito
energético	físico/infatigável/vigoroso/inesgotável/incansável
primitivo	temporão/precoce/cedo
consistente	conforme/imutável
unido	confederativo/unitário/combinado/determinado/aliado
silencioso	quiet/quieto
frontal	dianteiro
rentável	rendoso/lucrativo/proveitoso
elegante	chique/gracioso/luxuriante/luxuoso
obscuro	incompreensível/invisível/esotérico
orgulhoso	satisfeito/convencido/imodesto/presunçoso/ranhoso/imperioso/egoísta/altivo/ufano/soberbo/arrogante
incerto	duvidoso/perigoso/indefinido/ambivalente
desagradável	ofensivo/infernal/amargoso/lamentável/pavoroso/áspero/dolorido/acre/triste/amaro/virulento/terrível/acerbo/animal/horrível/amargo/cáustico/doloroso
matemático	possível/exato/preciso/correcto/certo
prematuro	temporão/precoce/cedo
hipotético	teórico
extra	aditivo/desnecessário
maravilhoso	sobrenatural/extraordinário/bonito/formoso/lindo/belo
obrigado	agradecido/reconhecido/grato/gratidão
salvo	indene/indemne
incompatível	antônimo/incongruente/antiácido/contraditório/inconsistente
cinza	acromático
cansado	esfarrapado
cooperativo	solidário
sereno	constituído
v	cardinal/cardeal
continental	transcontinental
autoritário	dominador
surpreso	estupefato
amargo	saboroso/intolerável/pesaroso/arisco/desagradável/insuportável
culpado	envergonhado/censurável/punível/criminoso/criminal/reprovável/repreensível/culpável/passível
emblemático	típico
perpétuo	contínuo/permanente/duradouro
portátil	móvel
exaustivo	amplo/completo/extenso/plenário/universal/global/mundial/integral
amoroso	apaixonado/terno/cálido/meigo/enfatuado/carinhoso
potente	poderoso/forte/influente
alegre	animador/ditoso/optimista/otimista/animado/contente
subtil	perspicaz
peremptório	definitivo/enérgico/enfático
severo	intenso/intensivo
genial	ágil/alerta/animado/hábil
magro	tênue/cadavérico/anoréxico/esguio/delgado/franzino/fino/esbelto
cruel	inumano/desumano
insuportável	inaceitável/ofensivo/amargo/intolerável
poluente	séptico
experiente	habilidoso/versado/talentoso
1000	cardinal/cardeal
cênico	bonito/formoso/lindo/belo
desnecessário	prolixo/supérfluo/redundante/extra/gratuito/excessivo
seletivo	exclusivo/discriminatório
fascinante	interessante
preferível	desejável
problemático	árduo/difícil/foda/intrincado
pragmático	prático/realístico
desesperado	indefeso/impossível/sombrio/escalvado
racional	intelectual/mental/inteligente/lógico/coerente
tenso	nervoso/isotônico/esticado/irritável
apto	capaz/adequado
gay	transexual/homo/lésbico/bicha/transsexual/veado/homossexual
divino	sagrado/celeste/glorioso
comparável	mesmo
sudoeste	sulista
redondo	esférico/global
estúpido	fátuo/burro/imbecil/idiota/sonso
compreensível	acessível/abordável/entendível
persistente	contínuo
interino	temporário
espontâneo	intuitivo/impulsivo
estrito	exato/preciso/correcto/certo
transitório	temporário
feroz	silvestre/inumano/bravo/violento/tempestuoso/intensivo/intenso/desumano/zangado/irado/irritado/selvagem/impiedoso
pequenino	pequeno
gordo	sujo/gorducho/oleoso/pançudo/corpulento/rechonchudo/roliço/gordurento/grosso/gorduroso/espesso/obeso/abdominal/encorpado
cômico	humorístico/engraçado
caótico	eriçado/selvagem/descontrolado/hirto
inegável	incontestável/irrefutável
errado	incorrecto/mentiroso/falaz/errôneo
flexível	elástico/dobrável/lasso/adaptável/ajustável
erótico	sensual/sexy
ácido	desgradável/azedo/acídulo
exótico	inusual/estrangeiro/insólito/extraordinário/estranho
admirável	impressionante/aprazível/extraordinário
incompreensível	obscuro/misterioso/paradoxal/enigmático/impenetrável/opaco
indeciso	débil
interminável	permanente/duradouro
limitado	moderado
feio	grotesco/monstruoso
acordado	desperto/insone
afetivo	emocional
preferencial	favorável/profícuo/vantajoso/propício
racial	racista
afetado	sujeito/artificioso/violento/artificial/forçado
sábio	erudito/sagaz/ajuizado/sensato/prudente/onisciente
anormal	defeituoso/anômalo/aberrante/irregular
convincente	credível/crível
bizarro	inusual/inconformista/sobrenatural/insólito/extraordinário/estranho
integrante	intrínseco
ascendente	dominante
vulnerável	débil/suscetível/indefensável/jovem/inseguro/desabrigado/inerme/indefeso
marinho	aquático
aplicável	relevante/pertinente
atraente	irresistível/belo/interessante/fotogênico/linda/carismático/lindo/formoso/bonito/chamativo
proporcional	equilibrado
vitorioso	próspero/bem-sucedido
infinito	absoluto/inesgotável/ilimitado/infindável/perfeito
traseiro	posterior
consultivo	noticioso/informativo
imperial	nobre
ambíguo	enigmático
lendário	sabido/irreal
colorido	interessante/tricolor/fluorescente/multicolor/monocromático/ruão/vistoso/rubro/bicolor/iridescente/psicadélico/brilhante/pitoresco/ruidoso/policromático/vermelho/escarlate/rubicundo/rufo/multicor/multicolorido
prejudicial	difamatório/insidioso/deletério/fraudulento/catastrófico/mal/calunioso/abusivo/infamante/nocivo/daninho/danoso
soberano	livre/dominante
chocante	staccato
virgem	novo/casta/puro/casto/castiço
sintomático	característico
antecedente	preexistente/prévio/anterior
corajoso	ousado/animoso/valente/heróico/inconsequente/audaz/destemido/audacioso/temerário/intrépido
construtivo	criativo/vantajoso/estrutural/positivo
entusiasta	ardente/evangélico/ávido/zeloso/fervente/fervoroso
contíguo	vizinho/próximo/perto
tropical	quente/equatorial/figurativo
morno	caloroso
banal	rotineiro/costumeiro/comum/ordinário/normal
sombrio	triste/escuro/desesperado
invisível	obscuro/ultravioleta/indetectável/infravermelho/escondido/imperceptível
lírico	emocional
didático	noticioso
restrito	fechado
vertical	erétil/perpendicular/ortostático/honrado
efêmero	curto/temporário
manuscrito	escrito
atlético	ativo
maior	grande/intenso/intensivo/maturo/maduro
abusivo	prejudicial/nocivo/daninho/danoso
vantajoso	favorável/benéfico/afirmativo/construtivo/preferencial/bom/positivo/otimista/boa/discriminatório/profícuo/propício
passível	culpado
nominal	específico/especificado
horrível	extraordinário/triste/ruim/desagradável/sujo/intenso/mesquinho/alarmante/intensivo/inquietante/arisco
corporal	corpóreo
ordinário	indecente/informal/medíocre/crônico/cotidiano/banal/usual/habituado/quotidiano/indiferente/habitual/inveterado
incondicional	independente
terapêutico	saudável
catastrófico	prejudicial/nocivo/daninho/danoso
especulativo	teórico
suicida	perigoso
incluído	cercado
nórdico	setentrional/nordestino
gelado	frio
proibido	ilegal
tremendo	extraordinário/grande
usado	antigo/velho
instável	insano/sísmico/inconstante/variável/vulcânico/mutável
improvável	incrível/último/suposto/inacreditável
inadmissível	inaceitável
medíocre	normal/inferior/ruim/ordinário/comum/costumeiro/rotineiro
agitado	inquieto
incompleto	partido/parcial/metade/nenhum
abandonado	irrestrito/inabitado/desabitado
guerreiro	militar
secular	profano/mundano/terrestre
agrário	rural
hábil	jeitoso/habilidoso/ágil/engenhoso/astuto/genial/alerta/animado/talentoso
benéfico	favorável/profícuo/vantajoso/propício
duradouro	prestativo/estável/permanente/indissolúvel/interminável/eterno/perene/perpétuo/imperecível
protector	tenro/meigo
desaparecido	perdido
amigável	bem-intencionado/social/amável/favorável/afável
denso	espesso
ansioso	ávido
solteiro	divorciado
complicado	complexo/foda/difícil/árduo/intrincado
primordial	superior/temporão/dominante/precoce/cedo
bravo	ousado/indignado/violento/animoso/valente/heróico/lívido/inconsequente/colérico/furioso/irado/audaz/destemido/feroz/raivoso/audacioso/zangado/temerário/furibundo/intrépido
inquietante	assustador/ameaçador/abominável/macabro/arriscado/horripilante/medonho/calamitoso/ominoso/terrível/pavoroso/temível/cabeludo/horrível/atroz/perigoso
inesquecível	memorável
insignificante	inútil
caseiro	doméstico
invariável	constante/imutável/inalterável/invariante
discutível	polêmico/plausível/contestável/controverso
apaixonado	carinhoso/amoroso
sintético	artificial
arbitrário	absoluto
bicha	homo/gay/homossexual
encarregado	equipado
surdo	surdo-mudo
enérgico	peremptório/físico/infatigável/vigoroso/inesgotável/incansável/assertivo/agressivo
abundante	verde/torrencial/lauto/fácil/farto/bastante/basto/copioso
informado	sensato/vivo
emergente	futuro
usual	crônico/costumado/habituado/geral/comum/habitual/genérico/costumeiro/ordinário/inveterado
furioso	bravo/tempestuoso/insano/zangado/irado/irritado
corrupto	malandro/desonesto/venal/corruptível
esporádico	ocasional/intermitente/irregular/periódico
precoce	avançado/nítrico/primitivo/mirim/primordial/prematuro/anterior
sexta	ordinal
peculiar	específico
fanático	passional
sincero	sério
unitário	unido
dedicado	devotado
irresistível	atraente/esmagador
coral	cromático
fértil	produtor/prolífico/generoso/farto/produtivo/proveitoso/fecundo/frutífero
dourado	metálico/cromático
sudeste	sulista
frigorífico	frio
aquático	marinho/subaquático
assustador	alarmante/inusual/inquietante/insólito/extraordinário/estranho
sentimental	emocional/meigo/tenro
respeitável	bom
devagar	mandrião
anónimo	incógnito/anônimo
carismático	atraente
miserável	abjeto/inferior/desprezível/mendigo/lamentável/coitado/desastroso/lastimoso/azarado/pobre/mendiga/sem-teto/sem-abrigo/infeliz/triste
cor-de-rosa	cromático
minúsculo	pequeno
humilde	inferior
insistente	contínuo
oficioso	informal
épico	grande
involuntário	vegetativo/autônomo/independente/autonómico/automático
lindo	extraordinário/belo/cênico/atraente/esplêndido/lindíssimo/fantástico/formoso/glorioso/pitoresco/bonito/precioso/magnífico/deslumbrante/maravilhoso
centésimo	ordinal
constituído	calma/reconhecido/calmo/sereno/tranqüilo/sossegado/oficial
tendente	inclinado
sumário	sucinto/lacônico/conciso
confidencial	próximo/privado
estudioso	erudito
fugitivo	curto
luxuoso	gracioso/esbelto/garboso/airoso/elegante
sorridente	animador/animado/contente
laico	profano
inexplicável	misterioso/paradoxal
intensivo	profundo/sensasional/forte/brutal/violento/esmero/severo/terrível/veemente/intenso/maior/feroz/horrível
duzentos	cardinal/cardeal
místico	irreal/esotérico
recorrente	contínuo
coincidente	proporcionado/síncrono/sincrônico/congruente
intransigente	inflexível
pertinente	relevante/aplicável/procedente
erudito	sábio/estudioso/instruído/sapiente/pedante
quantitativo	numérico/quantificável/decimal
separado	desvinculado/diferente/distinto/individual/disjunto
aleatório	confuso/atabalhoado/estocástico
impotente	incapaz/fraco
emocionante	elétrico/glamouroso/glamoroso/prestigioso/eletrizante
desigual	desnivelado/assimétrico
civilizado	civil/humano
entusiástico	ardente/evangélico/ávido/zeloso/fervente/fervoroso
frenético	doente/inquieto/selvagem/descontrolado/enfermo
fictício	irreal
hierárquico	graduável
beligerante	malvado
glorioso	bonito/sublime/incandescente/divino/formoso/lindo/belo
casta	virgem/virginal
festivo	ditoso
burro	imbecil/idiota/estúpido/sonso
vigoroso	energético/enérgico
heróico	audacioso/impressionante/grande/valoroso/valente/afoito/arrojado/audaz/bravo/destemido/corajoso
subjetivo	pessoal/preconceituoso
admissível	aceitável/lícito
húmido	aquoso/pluvioso/desleixado/pegajoso/encharcado/pesado/chuvoso/cafona/molhado
conceptual	abstrato
castanho	cromático
sinfônico	harmonioso
abrangente	amplo/extenso/plenário/universal/global/mundial
interativo	recíproco/mútuo
patético	desprezível/sarcástico
nefasto	terminal/fatal/mortal/letal
celular	multicelular
especular	meditabundo
intrínseco	inerente/interno/integrante/integral
latente	possível/potencial
estatutário	legal
linear	unidimensional
equilibrado	simétrico/proporcional
instantâneo	rápido/veloz
horizontal	plano/transversal
irrelevante	tangencial
maduro	adulto/outonal/casadoiro/maior/núbil/crescido/maturo
impecável	virtuoso/aprimorado/digno/nobre/perfeito
vertiginoso	doente/enfermo
provincial	caipira/paroquial/provinciano/rústico
débil	indeciso/vulnerável/manco/anêmico/fraco
nostálgico	consciente
imprevisto	inesperado
numérico	quantitativo
intolerável	inaceitável/insuportável/amargo
imponente	impressionante
arrogante	orgulhoso
grosseiro	indelicado
ocasional	imprevisível/raro/infrequente/casual/esporádico
adjacente	próximo
acidentado	áspero
apreciável	considerável
cíclico	periódico/circular/alternante/alterno/alternativa/alternado
superficial	aparente/fácil
constituinte	essencial
inadequado	inelegível/insuficiente/incompetente/incapaz
brando	doce/inapropriado
subsequente	concomitante/posterior/ulterior/resultante/decorrente
tênue	cadavérico/anoréxico/magro/esbelto/esguio/delgado/franzino/fino
autonómico	involuntário
celeste	divino
ilegítimo	ilegal
corporativo	organizado/corpóreo/solidário
determinado	explícito/unido
enigmático	incompreensível/esotérico/indefinido/impreciso/ambíguo/vago/dúbio
bárbaro	inumano/desumano
fúnebre	pesaroso
impróprio	nulidade/inutilizável/inútil/fútil/vão
cuidadoso	exigente
plausível	argumentável/discutível
inquieto	psicadélico/histérico/emocional/frenético/transtornado/agitado/febril/perturbado/excitado
querido	próximo
tácito	implícito
afim	relacionado
grandioso	importante/extraordinário
memorável	inesquecível
inacreditável	improvável/estarrecedor
são	lúcido/saudável
alarmante	assustador/ameaçador/abominável/macabro/arriscado/horripilante/medonho/calamitoso/ominoso/terrível/pavoroso/temível/cabeludo/horrível/atroz/perigoso
indignado	bravo/zangado/irado/irritado
sugestivo	indecente/consciente
francófono	comunicativo
lacônico	elíptico/sentencioso/compêndio/sumário/curto/conciso/sucinto
incorreto	falaz/errôneo
ousado	audacioso/aventureiro/audaz/bravo/destemido/corajoso
prolongado	longo
circundante	próximo
misto	heterogêneo
ilimitado	infinito
carinho	tolo
materno	maternal
estadual	público
fraudulento	prejudicial/nocivo/daninho/danoso
diminuto	fino/pequeno
eufórico	expansivo
recreativo	interessante
perplexo	hesitante/nublado
aventureiro	arriscado/destemido/ousado/audaz/audacioso
sublime	glorioso/sagrado/nobre
ameaçador	alarmante/inquietante
árduo	magoado/frustrante/ambicioso/controvertido/traumático/difícil/sensitivo/laborioso/terno/sensível/desafiador/ofendido/desconcertante/complicado/problemático/espinhoso
pacato	quieto
recebido	corriqueiro/convencional
leigo	mundano/terrestre
excitante	elétrico/glamouroso/glamoroso/prestigioso/eletrizante
difuso	prolixo
hipócrita	religioso/piedoso
viciado	alcoólico/dependente
alta	ensurdecedor/grande/vocal
brusco	íngreme/súbito/abrupto/repentino
marcial	militar
ineficaz	incapaz
tributário	secundário
volumoso	grande
psíquico	mental/paranormal
pornográfico	sensual/sexy
dianteiro	frontal/avançado
190	cardinal/cardeal
fulgurante	impressionante
analfabeto	semi-analfabeto
assíduo	diligente
aplicado	diligente/forense
xenófobo	receoso
delicioso	aprazível/saboroso
esquisito	atrapalhado/artificial/desajeitado
esquisito	inusual/sobrenatural/inconformista/insólito/extraordinário/estranho
sensato	ciente/sábio/discreto/informado
melancólico	triste
elegível	conveniente/adequado/apropriado/desejável/capaz
próspero	produtivo/vitorioso/triunfante/viçoso/ganhador/bem-sucedido
harmonioso	puro/compatível/sinfônico/consonante/suave
populoso	inabitado
panorâmico	largo/amplo
rude	indelicado
recíproco	bilateral/interactivo/interativo
forçado	afetado/artificial
inseguro	vulnerável/precário/duvidoso/ambivalente/convulsivo
caloroso	tépido/morno/tíbio
paradoxal	incompreensível/inexplicável
macho	masculino/varão/fálico/viril/varonil
póstumo	tardio
progressista	progressivo/chique/liberal
intocável	invulnerável
astronômico	grande
imaginativo	original/criativo/criador
indefinido	incerto/enigmático
divergente	diferente
avulso	específico
grotesco	feio/engraçado/humorístico
agravante	intensificador
rabo	posterior
temível	inquietante/alarmante
minucioso	prudente/atento
perceptível	importante
torto	escuso/assimétrico
plural	dual
delirante	selvagem/doente/descontrolado/enfermo
evangélico	entusiástico/entusiasta
consumado	habilidoso/talentoso
incansável	energético/enérgico
discriminatório	discriminativo/favorável/eclético/seletivo/profícuo/vantajoso/propício
animado	jeitoso/animador/alegre/sorridente/engenhoso/radiante/risonho/astuto/genial/feliz/hábil/contente
quinhentos	cardinal/cardeal
subordinado	auxiliar/secundário/adjunto/assistente
veemente	forte/intensivo/intenso
ruidoso	colorido/clamoroso
soberbo	orgulhoso
saboroso	gostoso/acre/amargo/salgado/agridoce/apetitoso/delicioso
apreensivo	receoso/desassossegado
utópico	visionário
coeso	adesivo
comprimido	fechado/compressível
onipresente	presente
branca	caucasiano/caucasiana
lúcido	são/sadio
receoso	apreensivo/assustado/claustrofóbico/xenófobo/apavorado/pasmo/agorafóbico/espantado/pasmado/amedrontado
imperioso	orgulhoso
sinuoso	tortuoso/circunflexo
mole	inapropriado/macio
invejável	desejável
compulsivo	ambicioso
superior	alto/brilhante/destacado/seleto/magnífico/primordial/fino/excepcional/excelente/extraordinário/fabuloso/luzente/exímio
aderente	adesivo
inofensivo	inócuo/inocente
indisponível	inacessível
exuberante	liberal
apropriado	atempado/elegível/próprio/capaz/adequado/conveniente
predominante	freqüente
afirmativo	vantajoso/positivo
assado	cozinhado
imune	isento
drogado	embriagado/ébrio/bêbado/bêbedo
envergonhado	culpado
fluido	líquido/gracioso
enganado	incorrecto
incompetente	incapaz/inadequado/ruim
análogo	similar/equivalente/eqüidistante
térmico	quente
veloz	ligeiro/expresso/alado/instantâneo/célere/breve/rápido
maldito	perdido/condenado
ávido	entusiástico/cobiçoso/tinhoso/impaciente/ansioso/sequioso/entusiasta
elástico	adaptável/flexível/ajustável
conclusivo	definitivo/decisivo
sísmico	instável/precário
estático	imóvel
montanhoso	áspero
formidável	impressionante/extraordinário
loiro	arenoso
inacessível	distante/indisponível
rubro	colorido
sofisticado	mundano/educado/inteligente/cortês/polido
sagrado	inviolável/espiritual/inefável/divino/bendito/sublime/religioso/santo
farto	fértil/verde/torrencial/abundante/copioso/bastante/lauto/proveitoso/fecundo/frutífero/fácil
equipado	encarregado
incontestável	inegável
mentiroso	falso/errado
nocivo	degradante/difamatório/pernicioso/insidioso/deletério/prejudicial/fraudulento/catastrófico/mal/calunioso/abusivo/danoso/infamante
sensual	físico/esquentado/pornográfico/sexual/libidinoso/erótico/doidão/orgíaco/verde/promíscuo/excitado/indecente/devasso/lascivo/quente
incipiente	temporão/cedo
tolerante	paciente
lícito	legal/admissível
sem-abrigo	infeliz/miserável
queimado	cozinhado
exíguo	escasso
entusiasmado	embriagado/louco/nervoso/ébrio/bêbado
terciário	ordinal
preparado	imediato/rápido
cômodo	acessível
adormecido	sonolento/dorminhoco
variado	diferente/heterogêneo
cósmico	grande
irritante	desconfortável/incómodo/incômodo
irracional	supersticioso
esquecido	despercebido
nulidade	vão/inapto/inútil/impróprio
grato	agradecido/apreciativo/obrigado
gótico	estranho/extraordinário/insólito/inusual
desconcertante	confuso/árduo/difícil/foda/intrincado
louvável	decoroso/digno
trezentos	cardinal/cardeal
vistoso	colorido/insípido
sulista	austral/sudoeste/sudeste/meridional
infernal	desagradável/maléfico/mau/má/ruim/malvado/arisco
reservado	inexpressivo/reticente
virtuoso	impecável
austero	simples
pálido	incolor
lutador	agressivo
deslumbrante	radiante/bonito/brilhante/luminoso/claro/formoso/lindo/belo
ciente	sensato/vivo
apertado	justo/invulnerável
voador	movente
repetitivo	contínuo/iterativo
espesso	gordo/gelatinoso/denso/viscoso
inviável	romântico/morto
monstruoso	feio
ofendido	árduo/dolorido/doloroso/extenuante/doído
ameno	simpático/agradável
cosmopolita	viajado
menor	pequeno
imbatível	invencível
idiota	retardado/fátuo/burro/imbecil/sonso/estúpido
desumano	desalmado/bestial/inumano/feroz/bárbaro/animal/cruel/brutal
escondido	invisível
divertido	satisfeito/humorístico/contente/interessante/engraçado
paroquial	provincial
apocalíptico	profético
díspar	outro
preponderante	dominante
macabro	alarmante/inquietante
rústico	provincial
humorístico	ridículo/sutil/irônico/engraçado/espirituoso/jocoso/hilário/hilariante/cômico/divertido/grotesco
dominador	mandão/tirano/autoritário/opressivo/ditatorial/opressor
talentoso	mestre/consumado/versado/competente/hábil/habilidoso/experiente
obsceno	indecente/sujo
impiedoso	feroz/mortal
afluente	rico
satisfeito	orgulhoso/contente/divertido
milagroso	sobrenatural
arcaico	antigo/velho
cromático	rosa/pétreo/rosado/amarelo/ambarino/baio/olivo/ruivo/coral/acastanhado/áureo/laranja/verde/vermelho/roxo/azul-petróleo/bronzeado/amarelento/verde-azeitona/azul/avermelhado/cerúleo/cor-de-laranja/carmim/castanho/pardo/azulado/tirante/amarelado/esverdeado/marrom/purpúreo/avelaneira/moreno/cereja/violeta/dourado/lilás/encarnado/alaranjado/cor-de-rosa/púrpura
irrepreensível	inocente
decadente	indulgente
sênior	ancião
incisivo	perspicaz
imoral	devasso/desgraçado/infamante/degradante/libertino/ignominioso/torpe
visionário	utópico
autorizado	oficial
ditatorial	dominador
imparcial	indiferente
combinado	unido
modelar	decoroso/digno
infindável	infinito
maluco	insano/tolo
eminente	alto
explicativo	noticioso
arrojado	heróico/animoso/valente/destemido
inexorável	inevitável/previsível
lindíssimo	bonito/formoso/lindo/belo
transversal	horizontal/transverso
vulcânico	instável/precário
figurativo	tropical/metafórico/poético/analógico
retórico	poético/bombástico/forense/oratório
degradante	tóxico/desonroso/nocivo/imoral
hesitante	perplexo
predador	agressivo/cobiçoso/sequioso
estéril	inóspito/infértil/improdutivo
incomparável	incomensurável/inigualável/único
subaquático	aquático
irritado	indignado/lívido/colérico/furioso/irado/feroz/raivoso/zangado/furibundo
esquerdista	liberal/esquerda
meridional	sulista
anacrônico	assíncrono
inesgotável	infinito/energético/enérgico
letal	nefasto/fatal
metafísico	teórico/sobrenatural
existencial	empírico
ardente	entusiástico/passional/entusiasta
mesquinho	estreito/horrível/antipático
incessante	contínuo
assustado	receoso/excitável
amável	amigo/afável/benigno/benevolente/benévolo/bondoso/amigável/amistoso/gentil/lhano
colossal	grande
honrado	venerável/perpendicular/augusto/vertical
gratidão	agradecido/apreciativo/obrigado
saliente	proeminente/importante/ilustre
indefeso	inerme/vulnerável/desesperado/desarmado
fugaz	curto
interdito	ilegal
interactivo	recíproco/mútuo
ininterrupto	contínuo
diabólico	maléfico/mau/má/ruim/malvado
pré-histórico	passado
proeminente	conspícuo/importante/ilustre/saliente
frustrante	árduo/difícil/foda/intrincado
abrupto	escarpado/explosivo/fulminante/brusco/íngreme/súbito/repentino
calúnia	malicioso/perverso/maldoso
tridimensional	cúbico/multidimensional/isométrico
aflito	inapropriado
egoísta	orgulhoso
volátil	inconstante/mutável/variável
inflexível	intransigente/rígido/teso
inócuo	inocente/inofensivo
divorciado	solteiro
célere	rápido/veloz
singelo	simplístico
torrencial	lauto/farto/bastante/basto/copioso/abundante
incólume	indene/indemne
exímio	superior
profano	secular/laico
milésimo	ordinal
parasita	dependente
distintivo	característico
ileso	indene/indemne
metafórico	figurativo
metódico	organizado
incorrecto	repreensível/errado/mau/enganado
penitenciário	punitivo
ilusório	irreal/desonroso
bilíngüe	multilingue
ágil	inteligente/ativo/jeitoso/engenhoso/astuto/genial/hábil
impaciente	ávido
transmissível	contagioso
punível	culpado
literal	explícito/exato/verdadeiro/preciso/correcto/certo
reticente	reservado
corrosivo	sarcástico/destrutivo
estupefato	surpreso/surpresa
educado	sofisticado
defeso	ilegal
perturbado	inquieto
triunfante	próspero/bem-sucedido
substantivo	significativo/essencial
áureo	cromático/metálico
higiênico	sanitário
hilariante	humorístico/engraçado
bêbado	drogado/excitado/orgíaco/tocado/pedrado/entusiasmado/grogue
momentâneo	curto
trivial	frívolo/fútil
empreendedor	empresarial/diligente
desinteressado	indiferente/apático
valente	bravo/heróico/animoso/destemido/valoroso/afoito/arrojado/corajoso
macio	aveludado/esponjoso/mastigável/flácido/aerodinâmica/fofo/mole/aerodinâmico/fofa
gratificante	aprazível
acolhedor	confortável
enganoso	desonroso
declarado	explícito
coitado	infeliz/miserável
povoado	inabitado
eclético	discriminatório
polar	antártico/frio/antárctico/ártico
extravagante	sobrenatural
contagioso	transmissível
vitoriano	próprio/adequado/conveniente
decidido	definitivo
anômalo	anormal/diferente
salutar	saudável
nordestino	nórdico/nortista
alegórico	representativo
impraticável	romântico/impossível
supérfluo	desnecessário/prolixo
pitoresco	colorido/bonito/formoso/lindo/belo
picante	acídulo/azedo/desgradável
cobarde	pusilânime
desgraçado	desonroso/imoral
deplorável	ruim
fatídico	decisivo
irreal	ilusório/fantástico/fictício/mítico/alucinatório/imaginário/místico/lendário
suposto	crível/improvável/provável
provinciano	provincial
cosmético	estético
aristocrático	nobre
aberrante	anormal
uno	cardinal/cardeal
maligno	canceroso
canceroso	maligno
atempado	apropriado
áspero	abrasivo/arisco/montanhoso/anguloso/rochoso/acidentado/desagradável/pedroso/pedregoso
quinzenal	periódico
esperto	astuto
preguiçoso	desempregado
conflituoso	controverso/polêmico
risonho	animador/animado/contente
heterogêneo	misto/sortido/variado
roxo	cromático
escorregadio	lodoso/deslizante
todo-poderoso	poderoso
devoto	piedoso/religioso
punitivo	penal/penitenciário
demonstrativo	noticioso
traumático	árduo/dolorido/doloroso/extenuante/doído
ganhador	próspero/bem-sucedido
repentino	escarpado/explosivo/fulminante/brusco/íngreme/súbito/abrupto
espantado	receoso
manso	dócil/suave
destrutivo	negativo/iconoclástico/cáustico/esbanjador/corrosivo
liso	aveludado/aerodinâmica/aerodinâmico
dúbio	enigmático
rotineiro	medíocre/cotidiano/banal/quotidiano/indiferente
aristocrata	nobre
exeqüível	possível
inerte	imóvel/inativo
imperceptível	invisível
identificável	classificável/diagnosticável
coberto	encharcado/empoeirado
quieto	pacato/silencioso
zangado	bravo/indignado/lívido/colérico/furioso/feroz/raivoso/furibundo/irado/irritado
defeituoso	anormal/imperfeito
empírico	confirmável/existencial/experimental/testável
analógico	figurativo
terno	jovem/árduo/dolorido/doloroso/extenuante/doído/carinhoso/amoroso
termal	quente
robusto	forte
doentio	asmático/gangrenoso/patológico/mental/ictérico/inflamatório/espumoso/artrítico/descorado/mórbido
sórdido	sujo
anão	pequeno
engenhoso	ágil/capaz/alerta/animado/hábil
circunstancial	específico
desarmado	indefeso
tenebroso	escuro
personalizado	pessoal
inestimável	precioso/valioso
histérico	inquieto
relutante	desafiador
satírico	sarcástico
inconsequente	audacioso/audaz/bravo/destemido/corajoso
levado	ruim
nebuloso	triste
simétrico	bilateral/equilibrado/intercambiável
molhado	aquoso/pluvioso/húmido/desleixado/pegajoso/encharcado/pesado/chuvoso/cafona
venenoso	malicioso/tóxico/perverso/maldoso
austral	sulista
apático	letárgico/desinteressado
acabado	polido/terminado
imperfeito	humano/defeituoso/irregular
inalterável	invariável/imutável
mundano	leigo/sofisticado/secular
pernicioso	tóxico/nocivo
ultravioleta	invisível
enganador	desonroso
azedo	desgradável/cortante/ácido/adstringente/acerbo/picante/acídulo
vencido	pagável
afável	amigo/amigável/amistoso/amável/gentil/lhano
rochoso	áspero
procedente	relevante/pertinente
traiçoeiro	perigoso/infiel
desonesto	corrupto
passional	colérico/ardente/fanático/devasso/flamejante/furiosa
rudimentar	basilar
teimoso	tenaz/porfiado/obstinado
esforçado	diligente
permeável	poroso
pomposo	presumido
precipitado	imprudente/apressado
esotérico	arcano/enigmático/abstracto/obscuro/místico/abstruso/misterioso/abstrato/oculto/secreto/recôndito/cabalístico
anedótico	comunicativo
espinhoso	árduo/difícil/foda/intrincado
reto	direito/perpendicular/bom/justo
proverbial	sabido
salgado	saboroso
radiante	contente/deslumbrante/reluzente/iridescente/prata/prateado/argênteo/refulgente/faiscante/argentino/animado/animador/brilhante/luminoso/claro
tortuoso	complexo/semicircular/sinusoidal/sinuoso/curvilíneo/intrincado
fulminante	súbito/abrupto/repentino
verídico	típico
diabético	doente/enfermo
espaçoso	amplo
sobrenatural	maravilhoso/barroco/metafísico/mágico/estranho/esquisito/misterioso/extravagante/milagroso/miraculoso/bizarro
brioso	nobre
fecundo	produtor/prolífico/generoso/farto/produtivo/fértil
apressado	precipitado
labiríntico	complexo/intrincado
proveitoso	económico/prolífico/generoso/produtivo/rentável/fértil/lucrativo/farto
indefectível	verdadeiro
assombroso	surpreendente
mendigo	infeliz/miserável
barulhento	clamoroso
psicadélico	inquieto/colorido/psicotrópico
remanescente	vivente
exploratório	preliminar
árido	seco/inóspito
bombástico	retórico
cronometrado	regular
vigésimo	ordinal
chuvoso	húmido/molhado
intrigante	confuso/interessante
fervoroso	entusiástico/entusiasta
empolgante	emocional
iluminado	fluorescente/fosforescente/incandescente/lívido/luminoso
barata	pagável
imaculado	puro/limpo
desconfortável	incômodo/azarado/irritante/doloroso/incómodo
profético	preditivo/aziago/apocalíptico
cáustico	destrutivo/arisco/desagradável
moreno	cromático
tirano	dominador
patológico	doente/adoentado/doentio/insalubre
fortuito	afortunado
quatrocentos	cardinal/cardeal
idílico	aprimorado/simpático/perfeito/agradável
crível	convincente/suposto
mórbido	doente/adoentado/doentio/insalubre
altista	optimista/otimista
tenro	mastigável/protector/jovem/sentimental
mercantil	comercial
acrobático	ativo
chique	elegante/actual/contemporâneo/inovador/moderno/progressista
vadio	desempregado
infravermelho	invisível
inativo	inerte
melodramático	dramático
cortante	acídulo/azedo/desgradável
durável	prestativo
sarcástico	corrosivo/brincalhão/saturnino/patético/satírico/travesso/arteiro
zeloso	entusiástico/entusiasta
requerido	necessário/essencial
fútil	trivial/vão/frívolo/leviano/informal/tonto/inapto/inútil/impróprio
malandro	corrupto
forçoso	obrigatório/essencial/imprescindível
dogmático	estreito
opaco	incompreensível/esbranquiçado/glauco/lácteo
odioso	ofensivo/abominável
feudal	subalterno
leviano	frívolo/fútil
destacado	superior
incógnito	anónimo/anônimo
esférico	redondo/circular/arredondado
invencível	inconquistável/imbatível
encantador	desonroso
repugnante	ofensivo
piedoso	devoto/hipócrita/religioso
insensato	tolo
ancião	sênior
febril	inquieto
casual	fácil/ocasional/intermitente/irregular/periódico
diagonal	oblíquo
imbecil	fátuo/burro/idiota/sonso/estúpido
beatificação	bom/boa
fisiológico	físico
oco	cavernoso/tubular
permissivo	indulgente
impeditivo	preventivo
episódico	temporário/imprevisível
comedido	suave
insuperável	inconquistável
majestoso	impressionante
antepenúltimo	intermédio
merecedor	decoroso/digno
subalterno	feudal/subserviente
extensível	longo
recôndito	esotérico
infiel	adulterino/pérfido/traiçoeiro
redundante	desnecessário/prolixo
arriscado	alarmante/aventureiro/perigoso/inquietante
pardo	cromático
binário	múltiplo
palaciano	impressionante
intuitivo	espontâneo
intermitente	esporádico/casual/raro
triangular	angular
aprazível	simpático/cativante/deleitoso/gratificante/admirável/cheiroso/delicioso/agradável
irrefutável	inegável
obediente	condescendente/aquiescente
terminado	polido/acabado
indiscreto	imprudente
imutável	consistente/firme/invariável/inalterável
perene	contínuo/permanente/duradouro
predileto	popular
caprichoso	inconstante
versátil	variável
auto-suficiente	independente
meticuloso	preciso
inválido	nulo
obeso	oleoso/gordo/gordurento/gorduroso
delgado	tênue/esbelto/magro
engraçado	humorístico/ridículo/sutil/irônico/espirituoso/jocoso/hilário/hilariante/cômico/divertido/grotesco
esplêndido	bonito/formoso/lindo/belo
fluente	gracioso
laborioso	intrincado/diligente/foda/difícil/árduo
desprezível	patético/maléfico/abjeto/miserável/mau/má/ruim/malvado
ensurdecedor	tempestuoso/alta/berrante/alto
sexy	pornográfico/sexual/libidinoso/erótico/doidão/orgíaco/verde/promíscuo/excitado/indecente/quente/devasso/lascivo
modular	padrão
gentil	grácil/afável/cortês/amável/mimoso
doido	insano
tangencial	irrelevante
inventivo	original/capaz/criativo/criador
enésimo	ordinal
habilidoso	capaz/mestre/consumado/versado/competente/hábil/experiente/talentoso
cândido	crédulo
atroz	maléfico/alarmante/mau/má/ruim/malvado/inquietante
tonto	frívolo/doente/fútil/enfermo
dócil	manso/tratável
décima	ordinal
comunicativo	falador/francófono/expressivo/verbal/hispanófono/anglófono/anedótico/narrativo/heráldico/comunicável/significativo
desajeitado	estranho/esquisito
inalienável	intransmissível/absoluto/inviolável
perpendicular	vertical/ortogonal/retangular/honrado/reto/íngreme
fidedigno	responsável
expresso	explícito/rápido/veloz
embriagado	excitado/drogado/orgíaco/tocado/pedrado/entusiasmado/grogue
setentrional	nórdico/azul/federal/nortista
benigno	amável
facultativo	opcional
opressivo	dominador
frouxo	folgado/inapropriado
jocoso	humorístico/engraçado
audacioso	aventureiro/ousado/heróico/inconsequente/temerário/intrépido/audaz/bravo/destemido/corajoso
ruivo	cromático
detestável	ofensivo/abominável
indecente	ordinário/obsceno/sugestivo/sensual/sexy
formoso	extraordinário/cênico/atraente/esplêndido/lindíssimo/fantástico/glorioso/pitoresco/bonito/precioso/magnífico/deslumbrante/maravilhoso/lindo/belo
opcional	facultativo
negligente	malfeito/desleixado
estendido	longo
ad_hoc	específico
estonteante	surpreendente/extraordinário
prestigioso	influente/emocionante/excitante
microscópico	pequeno/visível
enfático	peremptório/assertivo/agressivo
errante	falível
fragmentário	parcial/fracionário
truculento	agressivo
invisual	cego/daltônico
tolo	carinho/risível/inane/insensato/louco/néscio/maluco/absurdo/demente
ermo	triste
cereja	cromático
demoníaco	insano
veado	homo/gay/homossexual
vil	maléfico/mau/má/ruim/malvado
violeta	cromático
impreciso	enigmático
faminto	esfomeado/desnutrido
esfomeado	faminto
oratório	retórico
canônico	ortodoxo
íngreme	perpendicular/abrupto/repentino/brusco
obstinado	tenaz/porfiado/teimoso
compêndio	sucinto/lacônico/conciso
incandescente	glorioso/iluminado
cativante	aprazível
massivo	grande
vetusto	passado
gracioso	elegante/luxuriante/fluente/luxuoso/fluido
inefável	sagrado
casto	moral/virgem/virginal
reprovável	culpado
calunioso	prejudicial/nocivo/daninho/danoso
profícuo	benéfico/preferencial/vantajoso/bom/positivo/boa/discriminatório
bucólico	rural
medonho	inquietante/alarmante
alérgico	suscetível
gasoso	vaporoso
airoso	luxuriante/luxuoso
proibitivo	preventivo
amistoso	social/amável/afável
paranóico	insano
tenaz	adesivo/teimoso/obstinado
difamatório	prejudicial/nocivo/daninho/danoso
aerodinâmico	liso/macio
diligente	paciente/aplicado/empreendedor/esforçado/operoso/laborioso/trabalhador/assíduo
angular	retangular/triangular
assimétrico	desigual/torto
extrovertido	sociável
inóspito	desolado/hostil/estéril/árido
benevolente	amável
questionável	solúvel
solícito	atento
inato	inteligente
desgostoso	ofensivo
aditivo	incremental/cumulativo/extra/complementar/suplementar/adicional
granítico	duro
honorífico	respeitoso
maldoso	malicioso/danoso/malevolente/venenoso/malévolo/calúnia/malvado/perverso
fenomenal	extraordinário
franzino	tênue/esbelto/magro
pirotécnico	extraordinário
capitanear	alto
impermeável	hidrófugo
libertino	imoral
estacionário	imóvel
irado	bravo/indignado/lívido/colérico/furioso/feroz/raivoso/furibundo/zangado/irritado
justificável	desculpável
abominável	alarmante/execrável/maléfico/odioso/detestável/mau/má/ruim/malvado/inquietante
desordenado	eriçado/hirto
conciso	elíptico/sentencioso/compêndio/sumário/sucinto/curto/lacônico
cercado	inclusive/fechado/embutido/incluído
retangular	angular/perpendicular
desperto	acordado/insone
malicioso	danoso/malevolente/venenoso/malévolo/maldoso/calúnia/malvado
homo	transexual/lésbico/bicha/transsexual/veado/gay
ulterior	longínquo/concomitante/resultante/decorrente/posterior/subsequente/distante
altivo	orgulhoso
respeitoso	honorífico/deferente
destemido	aventureiro/ousado/heróico/inconsequente/audacioso/temerário/intrépido/valoroso/valente/afoito/arrojado/audaz/bravo/corajoso
maníaco	descontrolado/insano/selvagem
rosado	cromático
inconciliável	inconsistente
errôneo	errado/incorreto
impenetrável	incompreensível
bêbedo	drogado/orgíaco/tocado/pedrado/grogue
controlável	manipulável
desnivelado	desigual
nortista	setentrional/nordestino
inconsistente	contraditório/inconciliável/incompatível/discrepante
relacionado	afim/correspondente/descendente/semelhante
tórrido	esquentado/quente
virulento	mortal/arisco/tóxico/desagradável
sucinto	elíptico/sentencioso/compêndio/sumário/curto/lacônico/conciso
oblíquo	diagonal
senhorial	nobre
neoclássico	clássico
esguio	pequeno/tênue/esbelto/magro
eqüidistante	parelho/idêntico/igual/análogo
textual	explícito/exato/preciso/correcto/certo
segurado	confiante
cortês	gentil/sofisticado
incomensurável	incomparável
vaidoso	contente
condescendente	obediente
horrendo	triste
coxo	inapropriado
clamoroso	barulhento/ruidoso
avariado	enrugado
tendencioso	parcial
abdominal	gordo
abjeto	desprezível/infeliz/miserável
desatento	inconsiderado
inigualável	incomparável
possante	influente
inviolável	sagrado/inalienável/invulnerável
agradecido	simpático/apreciativo/reconhecido/grato/obrigado/gratidão/agradável
maternal	materno
gélido	frio
varão	masculino/fálico/macho
miraculoso	sobrenatural
insidioso	prejudicial/perigoso/nocivo/daninho/danoso
caucasiano	branco/branca/caucasiana
excitado	embriagado/sensual/inquieto/louco/nervoso/ébrio/bêbado/sexy
temerário	audacioso/audaz/bravo/destemido/corajoso
enfermo	frenético/delirante/nauseante/paralítico/tísico/verdejante/diabético/vertiginoso/tonto/indisposto
expansivo	eufórico
viril	masculino/macho
colateral	secundário
tempestuoso	ventoso/ensurdecedor/encaracolado/ondeante/furioso/feroz/raivoso
maleável	tratável
defensável	invulnerável
indefensável	vulnerável
brincalhão	traquinas/sarcástico/irônico
carinhoso	apaixonado/terno/cálido/meigo/enfatuado/amoroso
quádruplo	múltiplo
significante	monumental/notável
experimentado	versado
antipático	sujo/mesquinho
instruído	erudito
descontrolado	maníaco/delirante/caótico/frenético
calamitoso	inquietante/alarmante
maléfico	sinistro/vil/atroz/ruim/nefando/desprezível/infernal/mau/abominável/diabólico
recto	direito/bom/justo
voraz	cobiçoso/comilão/guloso/sequioso
cultivado	grácil/mimoso
anglófono	comunicativo
propenso	inclinado
improdutivo	estéril/infértil
inveterado	ordinário/costumeiro/genérico/comum/geral/usual/habitual
lesto	ativo
indigente	pobre
antárctico	polar
indomável	inconquistável
lésbico	homo/gay/homossexual
venerável	honrado/velho
sonolento	adormecido
benévolo	amável
fluorescente	iluminado/colorido
espirituoso	humorístico/engraçado
insípido	espalhafatoso/presumido/vistoso/mirabolante
meigo	protector/sentimental/carinhoso/amoroso
prolixo	difuso/pleonástico/excessivo/supérfluo/desnecessário/tautológico/redundante
impessoal	objetivo
injurioso	ofensiva/ofensivo
pormenorizado	prudente/atento
demorado	retardado
convulsivo	inseguro/violento/oscilante
afortunado	bom/sortudo/fortuito/contente/feliz/boa
penetrante	perspicaz
reciclável	útil
apetitoso	saboroso
corriqueiro	recebido/habitual
afoito	heróico/animoso/valente/destemido
jovial	ditoso
amarelado	cromático
ventoso	tempestuoso
costumeiro	medíocre/crônico/cotidiano/banal/usual/habituado/quotidiano/indiferente/habitual/inveterado
arável	produtor/produtivo
forense	aplicado/retórico
descuidado	malfeito/desleixado
curativo	saudável
arenoso	loiro
carnal	físico
luxuriante	gracioso/esbelto/garboso/airoso/elegante
senil	velho
infatigável	energético/enérgico
monocromático	colorido
desperdiçado	perdido
incongruente	incompatível/discrepante/inapropriado
inconstante	volátil/artificial/caprichoso/instável/falso/volúvel
esfarrapado	cansado
castiço	puro/virginal/impoluto/virgem
basilar	fundamental/radical/elementar/rudimentar
soturno	triste
adesivo	coesivo/aderente/tenaz/viscoso/coerente/coeso/colante
prateado	acromático/radiante/brilhante/luminoso/claro
guloso	voraz
utilizável	útil/prestativo/descartável
claustrofóbico	receoso
daninho	difamatório/insidioso/deletério/prejudicial/fraudulento/catastrófico/mal/calunioso/abusivo/danoso/infamante
aproximado	próximo
magnânimo	liberal/nobre
inatacável	invulnerável
relacional	relativo
milionésimo	ordinal
opressor	dominador
malcriado	indelicado
apenso	próximo
verdejante	doente/enfermo
frívolo	trivial/leviano/informal/tonto/fútil
malévolo	malicioso/perverso/maldoso
absorvente	esponjoso/interessante
audaz	ousado/aventureiro/heróico/inconsequente/audacioso/temerário/intrépido/bravo/destemido/corajoso
persuasivo	constrangedor/coerente
praticável	possível
impoluto	castiço/puro
perspicaz	penetrante/arguto/subtil/incisivo
habilitado	eficaz/capaz/eficiente
descomunal	grande
insolente	desrespeitoso
titânico	grande
inconsolável	desolado
sadio	lúcido
impulsivo	espontâneo
elíptico	sucinto/lacônico/conciso
lotado	intocado/estufado
transexual	homo/gay/homossexual
pérfido	infiel
paralítico	enfermo/doente
astuto	ladino/ágil/precioso/ardiloso/esperto/alerta/animado/hábil
berrante	ensurdecedor/grande/vocal
cozinhado	queimado/assado/saltear
intocado	cheio/pleno/lotado
supersticioso	irracional
imprudente	precipitado/indiscreto
extrajudicial	ilegal
adaptável	adaptativo/elástico/ajustável/variável/flexível
promíscuo	sensual/sexy
realizável	possível
diáfano	fino
lácteo	opaco
execrável	abominável
falível	errante
seleto	superior
inclinado	propenso/oblíqua/predisposto/enviesado/tendente
conversador	tagarela
malvado	sinistro/contrário/malicioso/vil/atroz/agressivo/ruim/nefando/oposto/desprezível/infernal/beligerante/mau/abominável/diabólico/perverso/maldoso
bondoso	amável
arguto	perspicaz
crepuscular	escuro
frutífero	prolífico/generoso/produtivo/fértil/farto
sossegado	constituído
censurável	culpado
coloquial	informal
impagável	precioso/valioso
lúgubre	pesaroso/triste
hirto	caótico/desmazelado/desordenado
abrasivo	áspero
azarado	incômodo/infeliz/miserável/triste/incómodo/desconfortável
tangível	concreto/material
lastimável	triste
corpulento	gordo
equatorial	tropical
aerodinâmica	liso/macio
demente	tolo
prolífico	fértil/produtor/produtivo/proveitoso/fecundo/frutífero
outonal	maduro/maturo
espalhafatoso	insípido
imaterial	espiritual/intangível
prestável	serviçal/obsequioso/direito
inapropriado	ruim/manco/incongruente/mole/aflito/deficiente/brando/estropiado/aleijado/fofo/flácido/perneta/coxo/frouxo
online	corrente/actual/atual
vernáculo	informal
exasperante	intensificador
morena	bronzeado/escuro
regulável	variável/mutável
esbelto	tênue/luxuriante/cadavérico/anoréxico/luxuoso/esguio/delgado/franzino/fino/magro
pasmo	receoso
ensanguentado	sangrento
desocupado	vazio
trigésimo	ordinal
despercebido	esquecido
ocioso	desempregado
extenuante	magoado/traumático/terno/sensível/ofendido
falador	comunicativo
formigueiro	impressionante
acastanhado	cromático
imaturo	juvenil/pueril/infantil
viscoso	adesivo/espesso
nojento	ofensivo
degenerativo	crônico
cumulativo	cobiçoso/aditivo/sequioso
reluzente	radiante/brilhante/luminoso/claro
bendito	feliz/sagrado/santo/contente
incomum	extraordinário
artificioso	artificial/afetado
desenvolto	capaz
cor-de-laranja	cromático
sequioso	voraz/predatório/possessivo/cumulativo/avaro/ávido/ganancioso/acumulativo/predador
ambivalente	incerto/inseguro
opulento	precioso/valioso
risível	tolo
ruim	levado/inferior/maléfico/sinistro/vil/inapropriado/deplorável/incompetente/medíocre/desfavorável/atroz/apavorante/terrível/horrível/nefando/lamentável/fedorento/travesso/desprezível/infernal/abominável/diabólico/mau/má/malvado
métrico	rítmico
valoroso	heróico/animoso/valente/destemido
asmático	doente/adoentado/doentio/insalubre
translúcido	leve
vagaroso	desempregado
subserviente	subalterno/servil
duodécimo	ordinal
silvestre	feroz/fero
crescido	maturo/maduro
indissolúvel	permanente/duradouro
impo	impressionante
extraconjugal	ilícito
ad-hoc	específico
onipotente	poderoso
mirabolante	insípido
fofo	inapropriado/macio
bestial	inumano/desumano
piramidal	pontudo
contestável	discutível
preconceituoso	subjetivo
oscilante	convulsivo
inumano	desalmado/bestial/feroz/bárbaro/animal/cruel/brutal/desumano
aziago	profético
avermelhado	cromático
atrapalhado	estranho/esquisito
tricolor	colorido
efervescente	espumoso/borbulhante
surdo-mudo	surdo
unívoco	absoluto
intrépido	audacioso/audaz/bravo/destemido/corajoso
psicotrópico	psicadélico
glacial	frio
torpe	desonroso/imoral
corpóreo	físico/corporal/corporativo
inapto	nulidade/inutilizável/inútil/fútil/vão
alienígena	externo/internacional
multicolor	colorido
cabeludo	alarmante/inquietante
colérico	passional/bravo/zangado/irado/irritado
gostoso	saboroso
arredondado	esférico/global
ébrio	excitado/drogado/orgíaco/tocado/pedrado/entusiasmado/grogue
intransmissível	inalienável
inexpressivo	reservado
presumido	insípido/pomposo
pesaroso	agoniado/fúnebre/lúgubre/amargo/lutuoso
predisposto	inclinado
constrangedor	persuasivo/poderoso
tocado	embriagado/ébrio/bêbado/bêbedo
nutritivo	saudável
anêmico	débil
raivoso	bravo/tempestuoso/zangado/irado/irritado
alado	rápido/veloz
lilás	cromático
ártico	frio/polar
deslizante	escorregadio
pueril	imaturo/infantil
pedregoso	áspero
crédulo	cândido
escarpado	súbito/abrupto/repentino
interdependente	dependente
gorduroso	gordo/obeso
pequenito	pequeno
refinado	grácil/mimoso
dual	plural
paranormal	psíquico
desafiador	relutante/intrincado/resistente/foda/difícil/árduo
tirante	cromático
desculpável	justificável
danoso	malicioso/difamatório/insidioso/deletério/prejudicial/fraudulento/catastrófico/mal/calunioso/abusivo/infamante/perverso/maldoso/nocivo/daninho
folgado	frouxo/solto
pensativo	triste
amedrontado	receoso
inconformista	esquisito/alternativo/bizarro/estranho
concomitante	subsequente/posterior/ulterior
policromático	colorido
polido	acabado/sofisticado/terminado
fétido	fedorento/malcheiroso
vegetativo	involuntário/assexual
verificável	determinável
púrpura	cromático
acre	saboroso/arisco/desagradável
fotogênico	atraente
magoado	árduo/dolorido/doloroso/extenuante/doído
bronzeado	cromático/morena
arquetípico	primeiro
trienal	periódico
acídulo	cortante/ácido/adstringente/acerbo/picante/azedo
desabitado	solitário/abandonado
voluptuoso	indulgente
esticado	tenso
sortido	diferente/heterogêneo
resoluto	definitivo
travesso	ruim/traquinas/sarcástico/irônico
circunstanciado	prudente/atento
séptico	poluente/purulento
fálico	varão/macho
manipulável	dirigível/administrável/controlável/governável
bem-intencionado	amigável
indolor	fácil
ganancioso	cobiçoso/sequioso
adorável	amorável
indisposto	doente/enfermo
intangível	imaterial
angélico	amorável/bom/boa
perfumado	cheiroso/fragrante
alternado	cíclico
estufado	cheio/pleno/lotado
copioso	verde/torrencial/lauto/fácil/farto/bastante/basto/abundante
quantificável	quantitativo
indulgente	favorável/permissivo/decadente/voluptuoso
sagaz	sábio
basto	verde/torrencial/abundante/copioso/bastante/lauto/fácil
biodegradável	perecível
lânguido	letárgico
sétima	ordinal
pavoroso	desagradável/inquietante/alarmante/arisco
rectilíneo	unidimensional
desolado	inóspito/inconsolável
bem-sucedido	produtivo/vitorioso/próspero/triunfante/viçoso/ganhador
galáctico	grande
graduado	alto
transtornado	inquieto
desleixado	húmido/descuidado/negligente/molhado
mal-educado	indelicado
volúvel	variável/inconstante/mutável
ardiloso	astuto
cheiroso	aprazível/fragrante/perfumado
desvantajoso	negativo
belicoso	agressivo/militar
bidimensional	alisado
sortudo	afortunado
saibro	acromático
qüinquagésimo	ordinal
eletrizante	emocionante/excitante
perecível	biodegradável
absorto	atento
frugal	parcimonioso
esmero	intenso/intensivo
amolgado	fino
garboso	luxuriante/luxuoso
esverdeado	cromático
cálido	carinhoso/amoroso
retardado	demorado/idiota/tardio
agridoce	triste/saboroso
alcançável	possível
prorrogável	longo
encharcado	coberto/húmido/molhado
nítrico	temporão/precoce/cedo
nublado	confuso/perplexo
lascivo	sensual/sexy
jeitoso	ágil/alerta/animado/hábil
azulado	cromático
avaro	cobiçoso/sequioso
asseado	limpo
rendoso	económico/rentável/lucrativo
encorpado	gordo
solúvel	questionável
batalhador	agressivo
compulsório	obrigatório/essencial/imprescindível
desencorajador	desencorajante
inquebrantável	constante
insalubre	asmático/gangrenoso/patológico/mental/ictérico/inflamatório/espumoso/artrítico/descorado/mórbido
lastimoso	infeliz/miserável
pasmado	receoso
angelical	bom/amorável/boa
gorducho	gordo
boa	satisfatório/angelical/afortunado/favorável/magnífico/sólido/beatificação/aceitável/angélico/profícuo/vantajoso/propício
ufano	orgulhoso
infértil	estéril/improdutivo
tacanho	tinhoso
tépido	caloroso
libidinoso	sensual/sexy
afinado	certo/justo/correto
enjoativo	ofensivo
alterno	cíclico
cinético	dinâmico/movente
lívido	bravo/iluminado/zangado/irado/irritado
oleoso	gordo/obeso
renomado	sabido
cabalístico	esotérico
quíntuplo	múltiplo
sociável	social/útil/extrovertido/congenial
alaranjado	cromático
chamativo	atraente
mutável	volúvel/regulável/volátil/instável
servil	subserviente
inelegível	inadequado/ilegal
proporcionado	idêntico/coincidente
aleijado	inapropriado
modal	normal
enrugado	avariado
consciencioso	prudente/atento
ladino	astuto
atabalhoado	aleatório
encaracolado	tempestuoso/crespo
poroso	permeável
possessivo	cobiçoso/sequioso
insano	doido/maníaco/instável/louco/doidão/lelé/demoníaco/sandeu/furioso/paranóico/maluco
consonante	harmonioso
extraviado	perdido
incolor	pálido
disposto	imediato/rápido
embutido	cercado
pontiagudo	pontudo
desacompanhado	solitário/singular/único
virginal	puro/casta/casto/castiço
gregário	social
arcano	esotérico
pedante	erudito
acinzentado	acromático
entendível	compreensível
cavernoso	oco/vazio
transsexual	homo/gay/homossexual
péssimo	pior
adoentado	crítico/asmático/gangrenoso/patológico/mental/ictérico/inflamatório/espumoso/artrítico/descorado/mórbido
teso	inflexível
decimal	quantitativo
ajustável	elástico/adaptável/variável/flexível
estropiado	inapropriado
indetectável	invisível
pegajoso	húmido/molhado
viçoso	próspero/bem-sucedido
malcheiroso	bolorento/ofensivo/rançoso/fedorento/ranço/fétido
tubular	vazio/oco
antropomórfico	humano
bolorento	malcheiroso/fedorento
substituível	intercambiável
anoréxico	tênue/esbelto/magro
primitiva	temporão/cedo
idiossincrático	individual
empoeirado	coberto
alucinatório	irreal
invasivo	agressivo
judicioso	discreto
multilingue	bilíngüe
extático	ditoso
aveludado	liso/macio
esbranquiçado	acromático/opaco
viajado	cosmopolita
venal	corrupto
indelicado	grosseiro/malcriado/malcomportado/descortês/rude/mal-educado
esbanjador	destrutivo
estaladiço	fresco/recente
rechonchudo	gordo
pusilânime	covardemente/covarde/cobarde
glamoroso	emocionante/excitante
assintomático	bem
erétil	vertical
escarlate	colorido
unidimensional	rectilíneo/linear
acalorado	perto/próximo/vizinho
inflamatório	doente/adoentado/doentio/insalubre
alongado	longo
acerbo	acídulo/arisco/desagradável/azedo/desgradável
equivocado	desonroso
atingível	possível
dúplice	múltiplo
inusual	exótico/estranho/fantástico/esquisito/singular/diferente/único/curioso/bizarro/assustador/gótico
letárgico	apático/indiferente/lânguido
duradoiro	prestativo
dirigível	manipulável
evanescente	temporário
devasso	imoral/passional/sensual/sexy
abstruso	esotérico
saciado	contente
pedrado	embriagado/ébrio/bêbado/bêbedo
torcido	escuso
inopinado	staccato
onisciente	sábio
pré-adolescente	jovem
loquaz	tagarela
enjoado	triste
flamejante	passional
irrestrito	abandonado
anguloso	áspero
ranhoso	sujo/orgulhoso
tratável	maleável/dócil
invulnerável	seguro/justo/intocável/defensável/apertado/inatacável/inviolável
impudico	sujo
assimilável	digerível
parcimonioso	económico/frugal
madrepérola	acromático
penitente	penitencial
fosforescente	iluminado
daltônico	invisual/cego
dolorido	desagradável/magoado/traumático/terno/sensível/ofendido/arisco
tagarela	conversador/loquaz
descartável	líquido/usável/disponível/utilizável
musculoso	forte
disfuncional	lesionado
enviesado	inclinado
impressionável	suscetível
apavorado	receoso
ajuizado	sábio
repreensível	incorrecto/culpado
divisível	separável
legendário	sabido
conspícuo	proeminente/importante/ilustre
presunçoso	confiante/orgulhoso/contente
brega	inferior
fátuo	imbecil/idiota/estúpido/sonso
inutilizável	vão/inapto/inútil/impróprio
adaptativo	adaptável
mimoso	refinado/cultivado/gentil
multicolorido	colorido
devotado	dedicado
fulo	violento
quadragésimo	ordinal
oculto	esotérico
ignominioso	desonroso/imoral
sensitivo	árduo/difícil/foda/intrincado
desonroso	encantador/desgraçado/equivocado/degradante/enganador/ilusório/enganoso/ignominioso/torpe
multidimensional	dimensional/tridimensional
boreal	azul/federal
furibundo	bravo/zangado/irado/irritado
lodoso	escorregadio
comilão	voraz
horripilante	alarmante/inquietante
executável	possível
desrespeitoso	insolente/escarnecedor
versado	experiente/habilidoso/experimentado/talentoso
néscio	tolo
moldável	suscetível
furiosa	passional
síncrono	coexistente/concorrente/paralelo/sincrônico/contemporâneo/coincidente/simultâneo
sabido	proverbial/lendário/famoso/renomado/célebre/notável/ilustre/legendário
manco	inapropriado/débil
nefando	maléfico/mau/má/ruim/malvado
relaxado	lasso
rançoso	fedorento/malcheiroso
heráldico	comunicativo
evocador	consciente
aurífero	metálico
fervente	entusiástico/entusiasta
infamante	imoral/prejudicial/nocivo/daninho/danoso
governável	manipulável
predatório	cobiçoso/agressivo/sequioso
sentencioso	sucinto/lacônico/conciso
estarrecedor	incrível/inacreditável
especificado	específico/nominal/mero
augusto	honrado
flácido	macio/inapropriado
classificável	identificável
transcontinental	continental
fedorento	ofensivo/bolorento/ruim/rançoso/ranço/fétido/malcheiroso
antitético	diferente
suplicante	importuno
fracionário	fragmentário/meio/metade
preexistente	antecedente
cultivável	produtor/produtivo
covarde	pusilânime
aquoso	líquido/húmido/molhado
somático	físico
semiautomático	automático
lauto	verde/torrencial/fácil/farto/bastante/basto/copioso/abundante
invariante	invariável
encardido	sujo
arisco	infernal/amargoso/lamentável/pavoroso/áspero/dolorido/acre/triste/amaro/virulento/terrível/acerbo/animal/horrível/amargo/cáustico/doloroso
quadricular	quadrado
esponjoso	macio/absorvente
grogue	embriagado/ébrio/bêbado/bêbedo
linda	atraente
sumido	perdido
sexagésimo	ordinal
imperecível	permanente/duradouro
desassossegado	precário/preocupado/apreensivo
reutilizável	útil
ignoto	inferior
lasso	relaxado/flexível
serviçal	prestável/direito
mandão	dominador
jubiloso	ditoso
sincrônico	síncrono/coexistente/concorrente/paralelo/contemporâneo/coincidente/simultâneo
orgíaco	embriagado/sensual/ébrio/bêbado/bêbedo/sexy
ditoso	alegre/jubiloso/extático/festivo/jovial/feliz/contente/vívido
ubíquo	presente
deletério	prejudicial/nocivo/daninho/danoso
fero	silvestre/selvagem
cómodo	bom/oportuno
antinatural	violento
curvilíneo	tortuoso/circunflexo
entretido	interessante
antártico	polar
laminado	fino
convexo	biconvexo
habituado	costumado/usual/geral/comum/habitual/genérico/costumeiro/ordinário
incremental	aditivo
eriçado	caótico/desmazelado/desordenado
sapiente	erudito
gelatinoso	espesso
espumoso	doente/efervescente/adoentado/doentio/insalubre
separável	divisível
noventa_e_nove	cardinal/cardeal
comunicável	comunicativo
alternante	cíclico
pleonástico	prolixo
hipersensível	suscetível
enfatuado	carinhoso/amoroso
deferente	respeitoso
intrincado	frustrante/complexo/ambicioso/controvertido/tortuoso/difícil/sensitivo/labiríntico/laborioso/desafiador/desconcertante/complicado/problemático/espinhoso/colonial
faiscante	radiante/brilhante/luminoso/claro
desalmado	inumano/desumano
venial	perdoável
desencorajante	desencorajador/desalentador
roliço	gordo
saltear	cozinhado
irritável	tenso
tísico	doente/enfermo
vaporoso	gasoso
borbulhante	efervescente
digerível	assimilável
trapaceiro	crítico
focal	central
pétreo	cromático
mandrião	devagar/lento
adstringente	acídulo/azedo/desgradável
pagável	devido/barata/vencido/barato
costumado	habituado/usual
incômodo	azarado/irritante/desconfortável/doloroso
ortogonal	perpendicular
acumulativo	cobiçoso/sequioso
agoniado	pesaroso
discrepante	incongruente/inconsistente
tempestivo	pontual
casadoiro	maturo/maduro
ziguezagueante	escuso
vivente	remanescente/realístico/existente
parelho	equivalente/eqüidistante
indemne	incólume/salvo/ileso
correto	exacto/perfeito/preciso/afinado/certo/exato
congruente	idêntico/coincidente
semicircular	tortuoso/circunflexo
décimo_segundo	ordinal
cento_e_oitenta	cardinal/cardeal
tíbio	caloroso
realístico	gráfico/pragmático/vivo/virtual/vivaz/vivente/prático
constatável	determinável
ominoso	alarmante/inquietante
obstrutivo	preventivo
hodierno	corrente/actual/atual
comprovável	objetivo
glauco	opaco
empinado	alto
tautológico	prolixo
antônimo	incompatível/complementar/contrário/contraditório/inverso
grácil	refinado/cultivado/gentil
vivaz	realístico
perdoável	venial
preditivo	profético
bicolor	colorido
traquinas	arteiro/travesso/brincalhão
crespo	encaracolado
movente	cinético/móvel/voador
staccato	chocante/inopinado
lépido	ativo
inabitado	povoado/populoso/solitário/abandonado
carmim	cromático
adornado	estofado
desmazelado	eriçado/hirto
decoroso	próprio/precioso/digno/modelar/modelo/interessante/louvável/merecedor/exemplar/valioso/notável/adequado/conveniente
argênteo	metálico/radiante/brilhante/luminoso/claro
apavorante	ruim
verde-azeitona	cromático
importuno	suplicante
abstrato	ideológico/esotérico/ideal/conceitual/conceptual
vívido	ditoso/vivo
deleitoso	aprazível
cadavérico	tênue/esbelto/magro
sonso	idiota/fátuo/burro/imbecil/estúpido
multicor	colorido
axiomático	evidente/óbvio
bilhão	cardinal/cardeal
tinhoso	ávido/tacanho
abordável	compreensível
imodesto	orgulhoso
pançudo	gordo
dimensional	multidimensional
ranço	fedorento/malcheiroso
escuso	torcido/torto/ziguezagueante
demonstrável	evidente/óbvio
mendiga	infeliz/miserável
nonagésimo	ordinal
desafiado	cego
animoso	bravo/valoroso/valente/afoito/arrojado/corajoso
colante	adesivo
quedo	imóvel
factível	possível
desabrigado	vulnerável
insone	desperto/alerta/acordado
desnutrido	faminto
corruptível	corrupto
solto	friável/folgado
filiforme	fino
massudo	grande
descortês	indelicado
cobiçoso	voraz/predatório/possessivo/cumulativo/avaro/ávido/ganancioso/acumulativo/predador
rufo	colorido
décimo_primeiro	ordinal
categorizado	classificado
confederativo	unido
glamouroso	emocionante/excitante
décimo_terceiro	ordinal
circunflexo	semicircular/sinusoidal/sinuoso/curvilíneo
proficiente	importante
amaro	arisco/desagradável
décimo_quarto	ordinal
antropóide	humano
cento_e_sessenta	cardinal/cardeal
manejável	possível
determinável	constatável/verificável
piolhoso	sujo
assíncrono	anacrônico
dorminhoco	adormecido
ígneo	quente
controvertido	árduo/difícil/foda/intrincado
adquirível	disponível
descorado	doente/adoentado/doentio/insalubre
baio	cromático
nauseante	doente/ofensivo/enfermo
caipira	provincial
semi-analfabeto	analfabeto
discriminativo	discriminatório/crítico
obsequioso	prestável
pluvioso	húmido/molhado
cardinal	c/160/500/cem_mil/dez_mil/bilhão/quarenta/mil/trilhão/5/uno/dois/duzentos/cento_e_oitenta/trezentos/noventa_e_nove/quatrocentos/onze/cento_e_sessenta/milhar/190/180/quinhentos/um_mil/1000/2/v/cinco
inane	tolo
assertivo	enérgico/enfático
indene	incólume/salvo/ileso
usável	descartável/útil/prestativo
isotônico	tenso
profilático	saudável
inconsiderado	desatento
sem-teto	infeliz/miserável
malevolente	malicioso/perverso/maldoso
foda	frustrante/ambicioso/controvertido/difícil/sensitivo/laborioso/desafiador/desconcertante/complicado/problemático/espinhoso
intensificador	exasperante/agravante
multicelular	celular
atual	real/corrente/contemporâneo/hodierno/último/moderno/vigente/online/actual
trianual	periódico
refulgente	radiante/brilhante/luminoso/claro
salubre	saudável
indutivo	implícito
coexistente	síncrono/sincrônico
magestoso	alto
purulento	séptico
comprável	disponível
amorável	angélico/adorável/angelical
varonil	masculino/macho
rubicundo	colorido
acurado	fiel/cirúrgico
apreciativo	agradecido/reconhecido/grato/gratidão
fragrante	perfumado/cheiroso
penitencial	penitente
alisado	bidimensional
desvinculado	separado
artrítico	doente/adoentado/doentio/insalubre
porfiado	teimoso/obstinado
antiácido	incompatível
refutável	responsável
infrequente	ocasional/raro
meditabundo	especular
hidrófugo	impermeável
assexual	vegetativo
amarelento	cromático
excitável	assustado/nervoso/sensível
mirim	temporão/precoce/cedo
falaz	errado/incorreto
quiet	silencioso
maturo	maduro/adulto/outonal/casadoiro/maior/núbil/crescido
elefantino	grande
conceitual	abstrato
antropomorfo	humano
argumentável	plausível
intercambiável	substituível/simétrico
pedroso	áspero
inconquistável	invencível/indomável/insuperável
inerme	vulnerável/indefeso
octagésimo	ordinal
culpável	culpado
auto-confiante	confiante
simplístico	simples/singelo
doído	magoado/traumático/terno/sensível/ofendido
entristecedor	triste
ativo	atlético/activista/rápido/lépido/lesto/ligeiro/ágil/acrobático
maneável	possível
acostumado	familiar
dobrável	flexível
ambarino	cromático
disjunto	separado
purpúreo	cromático
ruão	colorido
comutativo	independente
perneta	inapropriado
lelé	insano
gangrenoso	doente/adoentado/doentio/insalubre
malfeito	descuidado/negligente
estado-da-arte	progressivo
olivo	cromático
vacante	vazio
lutuoso	triste/pesaroso
fusiforme	pontudo
vigésima	ordinal
iconoclástico	destrutivo
prestativo	duradouro/funcional/utilizável/durável/usável/duradoiro
hilário	humorístico/engraçado
confirmável	empírico
estofado	adornado
gordurento	gordo/obeso
escalvado	desesperado
refletivo	vazio
malcomportado	indelicado
temporão	jovem/nítrico/mirim/contemporâneo/primitivo/incipiente/novo/primordial/primitiva/prematuro/anterior
arteiro	traquinas/sarcástico/irônico
chicaneiro	crítico
brônzeo	metálico
pontudo	fusiforme/piramidal/pontiagudo
ondeante	tempestuoso
marrom	cromático
estocástico	aleatório
vigésimo_primeiro	ordinal
saturnino	sarcástico
um_mil	cardinal/cardeal
minimum	simbólico/marginal
covardemente	pusilânime
gris	acromático
diagnosticável	identificável
friável	solto
lhano	afável/amável
aprimorado	perfeito/idílico/ideal/impecável
luzente	superior
operoso	diligente
anti-helmíntico	saudável
desalentador	desencorajante
desesperador	perigoso
escarnecedor	desrespeitoso
caloso	resistente/grosso
congenial	sociável/compatível
doidão	sensual/insano/sexy
testável	empírico
denário	múltiplo
fofa	macio
iterativo	repetitivo
hispanófono	comunicativo
cerúleo	cromático
avelaneira	cromático
azul-petróleo	cromático
sutil	humorístico/engraçado
preeminente	dominante
antimicrobiano	saudável
cafona	húmido/molhado
respetivo	individual
sinusoidal	tortuoso/circunflexo
litorâneo	marítimo
ordinal	octagésimo/sexta/oitavo/décima/décimo_quarto/vigésimo_primeiro/vigésimo/décimo_terceiro/terciário/duodécimo/centésimo/1º/sétimo/nono/trigésimo/sexagésima/segundo/décimo_primeiro/quinto/nonagésimo/trigésima/milionésimo/quadragésimo/qüinquagésimo/sexto/sexagésimo/milésimo/sétima/vigésima/décimo_segundo/décimo/primeiro/terceiro/enésimo
adulterino	infiel
antediluviano	antigo/velho
oblíqua	inclinado
transverso	transversal
sable	acromático
aquiescente	obediente
explanatório	noticioso
amargoso	arisco/desagradável
compressível	comprimido
agorafóbico	receoso
isométrico	cúbico/tridimensional
coesivo	adesivo
otimista	altista/vantajoso/alegre/positivo
bifocal	central
iridescente	radiante/colorido/brilhante/luminoso/claro
sandeu	insano
biconvexo	convexo
trigésima	ordinal
núbil	maturo/maduro
mastigável	tenro/macio
exato	fiel/literal/certo/cirúrgico/rigoroso/justo/correto/textual/estrito/matemático
caucasiana	branco/branca/caucasiano
desgradável	cortante/ácido/adstringente/acerbo/picante/azedo
coletivo	solidário/socialista
ictérico	doente/adoentado/doentio/insalubre
sexagésima	ordinal
sinótico	mesmo
sensasional	intenso/intensivo
calmoso	perto/próximo/vizinho
administrável	manipulável
cotidiano	rotineiro/costumeiro/comum/ordinário/normal
esquentado	tórrido/sensual
ortostático	vertical
crocante	fresco/recente
graduável	hierárquico
acromático	madrepérola/esbranquiçado/saibro/prateado/acinzentado/cinza/cinzento/gris/sable
trilhão	cardinal/cardeal
