discussão	debate/querela/controvérsia/batalha/questão/porfia/certame/arena/demanda/ataque/refrega/discurso/pleito/sabatina/argumentação/parlenga/peleja
aparência	aspecto/cara/ar/pinta/exterior/catadura/expressão/parecer/cor/fisionomia/capa/fachada/superfície/véu/presença/perspectiva/forma/espécie/mostrança/pretexto/rosto/face/antojo/sombra/maneira
chegada	vinda/advento/acesso/aproximação/abordo/chegamento/fim/conclusão/entrada
depoimento	testemunho/declaração/deposição
modo	maneira/jeito/sistema/meio/via/guisa/modalidade/laia/termo/caminho
ajuda	auxílio/socorro/adjutório/apoio/recurso/colaboração/suporte/demão/achego
perigo	risco/transe/ventura/xeque/lance/cachopo/ameaça/escolho/cheque
ferida	ferimento/mazela/mágoa
rosto	face/vulto/focinho/venta/fronte
narrativa	história
começo	início/princípio/aurora/entrada/abertura/embrião/intróito/nascença/desencadeamento/incoação/berço/nascimento/incunábulo/limiar/oriente/introito/infância/alvorada
falta	carência/omissão/deficiência/lacuna/escassez/delito/erro/nudez/queda/míngua/fome/desvio/descuido/destituição/pouquidade/exiguidade/negação/lapso/ofensa/necessidade/carestia/pobreza/vaga/infração
ausência	falta/vaga/deficiência/eclipse
espectro	fantasma/aparição/assombração/avejão/sombra/abantesma/alma/avantesma
entrada	ingresso/acesso/admissão/introdução/limiar/ádito/ombreira/ingressão/umbral/entrança/abordo/antepasto/introito
rapaz	moço/cachopo/menino/mancebo/muchacho/filho/adolescente/criança/miúdo/guri/gaiato/pequeno/petiz
incêndio	fogo/ardor
assunto	tema/matéria/questão/objecto/coisa/ponto/conteúdo/argumento/contexto/objeto/pasto/terreno/tese/artigo/fundo
luta	briga/contenda/combate/conflito/disputa/batalha/guerra/discórdia/rixa/prélio/refrega/colisão/lide/choque/rota/altercação/liça/pendência/quibeto/guerreia/justa/transe/ação/certame/testilha/luita/desavença/competição
bandeira	pendão/lábaro/signa/auriflama/vexilo
sabor	gosto/paladar
marinheiro	marujo/marítimo/matalote/navegador/nauta/navegante/mareante/embarcadiço
combate	peleja/contenda/briga/pugna/certame/batalha/recontro/transe/rixa/ação/refrega/rota/lide/prélio/confronto/discrime/ataque/desavença/justa/pendência/certâmen/demanda/requesta
imagem	figura/retrato/estampa/ícone/traslado/efígie/vulto/fotografia/ilustração/desenho/simulacro/ideia/afiguração/translado/transunto/reflexo/foto
fonte	nascente/manancial/origem/matriz/teta/primórdio/têmpora/fontana/raiz/procedência/nasceiro/manadeira/princípio
