ser	estar/ir/haver/dar/passar/ficar/existir/referir/sair/tornar/representar/ocorrer/resultar/valer/relacionar/residir/operar/originar/derivar/subsistir/emanar/concernir/ocasionar/sobrevir/promanar/defluir/dimanar/efetuar
ter	ser/estar/fazer/haver/dar/saber/apresentar/levar/receber/existir/manter/criar/contar/tomar/aceitar/atingir/vencer/obrigar/dispor/usar/sofrer/trazer/precisar/deter/julgar/compreender/alimentar/conter/interpretar/gerar/crer/sujeitar/forçar/vestir/consistir/arranjar/conceber/englobar/subordinar/dobrar/pisar/usufruir/torcer/envergar/desfrutar/sacar/coibir/perfilhar/granjear/trajar/professar/domar/procriar/manutenir/amolgar/entrajar/adotar/expugnar/abichar/avezar/avassalar
dizer	fazer/apresentar/falar/contar/propor/demonstrar/apostar/celebrar/ferir/protestar/proferir/relatar/expressar/mencionar/comprovar/articular/atestar/narrar/certificar/exteriorizar/soletrar/palrear
dar	fazer/ir/dizer/deixar/considerar/encontrar/levar/falar/abrir/pôr/explicar/contar/terminar/participar/decorrer/servir/apontar/morrer/cumprir/entregar/trazer/indicar/resultar/dedicar/tocar/suceder/prestar/prender/distribuir/proceder/transmitir/ceder/conceder/interpretar/emitir/investir/gerar/concentrar/submeter/operar/meter/deitar/inspirar/dispensar/devolver/relatar/absorver/despedir/render/expressar/combinar/emprestar/formular/deparar/sagrar/adjudicar/arrumar/subordinar/aludir/enunciar/ajustar/findar/plantar/induzir/demarcar/facultar/despender/infiltrar/brindar/sintonizar/legar/derramar/tributar/impregnar/vergar/engendrar/presentear/outorgar/reputar/ocasionar/deputar/abonar/imbuir/trespassar/franquear/impingir/devotar/prontificar/cambiar/entranhar/abastar/prodigalizar/prodigar/encasquetar/lascar/comissionar/atinar/acercar/desfechar/efetuar
ver	ser/estar/saber/considerar/encontrar/concluir/reconhecer/entender/achar/olhar/assistir/recordar/surpreender/apanhar/conceber/localizar/comemorar/reparar/deparar/adivinhar/examinar/diferenciar/antever/induzir/presumir/presenciar/reconstituir/reviver/pressentir/ressentir/revisitar/pilhar/visualizar/descortinar/refletir/mirar/intuir/discernir/adicar/lobrigar/memorar/conjeturar
vir	ser/ter/chegar/apresentar/tornar/andar/valer/carregar/coincidir/originar/conservar/derivar/volver/avizinhar/suprir/redundar/acudir/remediar/retornar/providenciar/fluir/prover/verter/manar/promanar/marejar
querer	tentar/aceitar/gostar/determinar/precisar/mandar/desejar/concordar/reclamar/necessitar/subscrever/assentar/requerer/convir/experimentar/decretar/arder/apetecer/carecer/aspirar/cobiçar/ansiar/meditar/dignar/matutar/anuir/maquinar/anelar/bem-querer
saber	dar/conhecer/anunciar/reconhecer/olhar/julgar/conceber/antecipar/adivinhar/decorar/pressentir/prenunciar/prognosticar/profetizar/auspiciar/farejar
continuar	levar/seguir/avançar/prosseguir/permanecer/enveredar/esticar/alongar/perseverar
começar	chegar/partir/abrir/entrar/pôr/iniciar/estabelecer/inaugurar/estrear/travar/originar/puxar/romper/encetar/principiar/entabular/abrolhar/empeçar/incoar/debutar
conseguir	ter/haver/saber/realizar/atingir/obter/adquirir/alcançar/arranjar/colher/vingar/lograr/sacar/pilhar/granjear/abichar/abiscoitar
apresentar	fazer/dar/pôr/tomar/propor/aparecer/entregar/trazer/oferecer/produzir/manifestar/informar/introduzir/expor/exibir/vestir/enunciar/revestir/afigurar/aventar/presentar/aduzir/adotar/oferendar
acabar	passar/ficar/deixar/perder/terminar/concluir/faltar/cair/gastar/completar/extinguir/apagar/enterrar/falecer/descansar/cessar/liquidar/findar/consumar/ultimar/expirar/cerrar/sucumbir/exaurir/exterminar/perecer/trancar/arrematar/aviar/finar/fenecer/desfolhar/esfarelar/desfechar
partir	deixar/retirar/crescer/dividir/fugir/investir/arrancar/comer/remeter/carregar/consumir/despedir/assaltar/romper/desfazer/largar/rebentar/provir/estalar/afligir/derramar/compartilhar/atormentar/ausentar/arribar/martirizar/retalhar/acometer/rachar/despedaçar/noscar/trincar/seccionar/escachar/confranger/escavacar/fissurar/arremeter/descabelar/fender/estroncar/esfacelar/fracionar
permitir	dar/deixar/admitir/sofrer/conceder/suportar/aceder/facultar/aturar/franquear
receber	haver/conseguir/levar/conhecer/ganhar/tomar/reconhecer/admitir/perceber/adquirir/tirar/alcançar/casar/acolher/arranjar/unir/colher/experimentar/cobrar/absorver/angariar/auferir/padecer/acomodar/sacar/embolsar/aposentar/nupciar/abichar/abiscoitar/consorciar/recepcionar/agasalhar
existir	haver/viver/permanecer/durar
prever	ver/saber/anunciar/pensar/esperar/contar/sentir/achar/antecipar/calcular/desconfiar/pressupor/antever/cheirar/presumir/pressentir/augurar/prognosticar/entrever/conjecturar/bacorejar/futurar/fadar/pressagiar/conjeturar
realizar	ser/fazer/dar/passar/criar/cumprir/construir/ocorrer/efectuar/causar/suceder/proceder/elaborar/satisfazer/praticar/concretizar/desempenhar/executar/operar/atender/consumar/advir/empreender/rolar/perpetrar/resgatar/materializar/efectivar/sobrevir/efetivar/efeituar/obrar
manter	ficar/vir/continuar/levar/seguir/aceitar/confirmar/trazer/permanecer/alimentar/conter/sustentar/obedecer/reter/persistir/segurar/subsistir/quedar/manutenir
acontecer	ser/ir/haver/dar/passar/vir/realizar/sair/decorrer/aparecer/ocorrer/cair/produzir/suceder/proceder/operar/coincidir/acertar/calhar/emergir/advir/rolar/ocasionar/avir/acaecer/efetuar
voltar	vir/chegar/partir/tornar/apontar/mudar/avançar/recorrer/alterar/apelar/atirar/agredir/modificar/converter/abalar/contrapor/reiterar/remover/reverter/reaparecer/restituir/volver/retornar/reembolsar/reanimar/revolver/reiniciar/acometer/cambiar/repostar/objetar/rezingar/vivificar/desengatilhar/respingar/saltear/reparecer/revidar/repontar/arremeter/revirar/retrucar/revir/fuçar
criar	fazer/dar/estabelecer/organizar/formar/elaborar/compor/alimentar/sustentar/gerar/imaginar/desenhar/buscar/erguer/instaurar/manipular/plantar/edificar/forjar/instruir/erigir/parir/nutrir/brotar/adolescer/idear
seguir	ter/tomar/aceitar/acompanhar/dispor/andar/avançar/abandonar/conduzir/prosseguir/aguardar/confessar/atirar/processar/escutar/enveredar/acatar/trilhar/resguardar/professar/rastejar
tentar	provocar/desafiar/experimentar/estimular/seduzir/atentar/excitar/envidar/apetitar/reptar/ensejar
referir	dizer/dar/propor/apontar/declarar/atribuir/tocar/relacionar/expor/remeter/relatar/mencionar/referenciar/reportar/concernir/desfiar/arrogar/irrogar
decidir	dispor/destinar/julgar/optar/animar/inventar/traçar/deliberar/ousar/solucionar/absolver/comover/arbitrar/dirimir/deslindar/cismar
contar	referir/incluir/comunicar/noticiar/calcular/notificar/narrar/desfiar/numerar/historiar/desembuchar/computar/quantiar/enarrar
viver	ser/passar/levar/ocupar/assistir/suportar/demorar/sobreviver/habitar/respirar/subsistir/aposentar/experienciar/estanciar
garantir	dizer/pretender/preparar/assegurar/prometer/apostar/armar/cobrir/reservar/guardar/preservar/segurar/testemunhar/jurar/certificar/creditar/resguardar/anteparar/acoitar/premunir/custodiar
pretender	ter/fazer/dizer/dar/querer/considerar/sentir/procurar/assegurar/alegar/provar/desejar/apostar/crer/requerer/tencionar/cobrar/testemunhar/apetecer/meditar/intentar/asseverar/reputar/intencionar/pretextar/projetar/vindicar/requestar
colocar	apresentar/pôr/propor/situar/fixar/submeter/meter/localizar/assentar/implantar/inverter/depor/plantar/encaixar/pousar/poisar/botar/injetar/prantar
mostrar	dar/passar/apresentar/parecer/pôr/marcar/sair/colocar/surgir/revelar/acusar/apontar/aparecer/oferecer/indicar/descobrir/manifestar/provar/demonstrar/denunciar/assinalar/designar/ensinar/expressar/testemunhar/ostentar/desvendar/denotar/espelhar/indigitar/descortinar/aduzir/franquear/escancarar/desvelar/ressurtir/transverberar/desembuçar/desencobrir/amostrar/desenfardar/patentizar
constituir	ser/deixar/criar/pôr/representar/formar/compor/nomear/erguer/instituir/instaurar/plantar
incluir	ter/registar/encerrar/possuir/compreender/conter/meter/enquadrar/englobar/incorporar/fundir/numerar/registrar
lançar	dar/jogar/mandar/emitir/introduzir/atirar/deitar/depositar/despedir/largar/arrumar/despejar/descarregar/sacudir/desembocar/emanar/vibrar/cuspir/impelir/raiar/botar/radiar/espargir/projetar/luzir/arremeter
acrescentar	pôr/integrar/aumentar/desenvolver/juntar/agrupar/sobrepor/adicionar/agregar/adir/engrandecer/enxertar/ajuntar/apender/apensar/integralizar
revelar	passar/sair/surgir/representar/acusar/apontar/aparecer/entregar/indicar/demonstrar/traduzir/exprimir/evidenciar/testemunhar/retratar/trair/desvendar/cheirar/desenterrar/estampar/transpirar/descortinar/refletir/franquear/escancarar/inculcar/dedar/desvelar/ressurtir/transverberar/malsinar/desembuçar/desencobrir/alcaguetar/transluzir/assoalhar/desenfardar/patentizar
escrever	fazer/pôr/publicar/compor/gravar/assentar/traçar/redigir/lavrar/esculpir/alistar/grafar/ziguezaguear/entalhar
representar	fazer/apresentar/actuar/interpretar/traduzir/exibir/descrever/exprimir/reproduzir/retratar/simbolizar/encarnar/configurar/denotar/afigurar/debuxar
acusar	denunciar/notar/arguir/responsabilizar/culpar/censurar/incriminar/inculpar/repreender/invectivar/redarguir/delatar/objurgar/achacar/acriminar/criminar/amostrar/recriminar/increpar
terminar	deixar/sair/concluir/vencer/morrer/fechar/encerrar/parar/completar/rematar/extinguir/romper/desfazer/cessar/findar/consumar/ultimar/finalizar/perfazer/expirar/delimitar/cerrar/desembocar/desaguar/inteirar/trancar/arrematar/proscrever/finar/aprontar/desfechar
ouvir	sentir/entender/perceber/distinguir/escutar
utilizar	tomar/servir/aplicar/praticar/gastar/empregar/socorrer
decorrer	ser/ir/haver/passar/vir/realizar/andar/correr/ocorrer/operar/rodar/derivar/provir/advir/rolar/volver/escoar/discorrer/perpassar/sobrevir/transcursar/transcorrer/efetuar
provocar	fazer/dar/produzir/levantar/causar/convidar/solicitar/acordar/desencadear/desafiar/despertar/puxar/captar/fomentar/incitar/atentar/insultar/aliciar/picar/afrontar/excitar/instigar/acometer/atiçar/acotovelar/concitar/carrear/ativar/ensejar/peguilhar/peguinhar/açular/aferroar/reptar/esporar/acarrear/eriçar/negacear
concluir	fazer/fechar/tirar/apurar/completar/rematar/complementar/consumar/ultimar/finalizar/perfazer/cerrar/inteirar/arrematar/coligir/aprontar/desfechar/dessumir/epilogar
obter	ter/fazer/haver/chegar/levar/receber/ganhar/atingir/retirar/adquirir/tirar/apanhar/arranjar/colher/vingar/lograr/angariar/auferir/lucrar/sacar/pilhar/mamar/abichar/abiscoitar
confirmar	dizer/afirmar/garantir/pretender/aprovar/estabelecer/assegurar/apoiar/sustentar/contestar/reafirmar/constatar/consolidar/ratificar/testemunhar/firmar/atestar/esforçar/corroborar/radicar/sancionar/homologar/positivar/referendar/revalidar/abonar/roborar/robustecer/asselar/solidar
aprovar	deixar/permitir/aceitar/gostar/subscrever/festejar/firmar/consentir/louvar/sancionar/simpatizar/outorgar/abonar/assentir/placitar
