partido	imcompleto/com_imperfeições/imperfeito/ferido/danificado/avariado
nacional	domesticado/doméstica/domesticada
são	saudável/bom/bem/racional/saudável/em_forma
mesmo	similar/semelhante/igual/idêntico/análogo/parelho/igual/idêntico/análogo/parelho
novo	moderno/contemporâneo/recente/fresco/atual/actual/corrente
primeiro	primário/original/precoce/temporão/cedo/dianteiro
outro	separado
social	social/sociável/gregário/social/amistoso/amigo/amigável/amistoso/amigo/amigável
público	explícito/aberto
direito	destro
democrático	eleito
liberal	esquerdista/liberal/liberal/caridoso
próprio	certo/correto/justo/apropriado
plano	imutável/liso/macio
privado	pessoal/esotérico
santa	sagrado/dedicado
geral	impreciso/detalhado/exaustivo/extenso/abrangente/amplo/comum
estrangeiro	internacional
industrial	progressivo
bem	saudável/salubre/são/saudável/em_forma
favorável	proveitoso/rendoso/lucrativo/cómodo/propício/oportuno/bom/gratís/propício/afirmativo
importante	precioso/valioso/significativo/importante/significante/significativo/importante/essencial/essencial/decisivo/crítico
direto	honesto/sincero/honesta/sincera
branco	claro
alto	alto/ruidoso/barulhento/grande/alto/audível
internacional	alienígena/estrangeiro/extrangeiro
superior	melhor
responsável	prudente/sensato/judicioso
grosso	amplo/largo/forte/gordo/vivido/experimentado/experiente
alegre	contente/animado/animador
antigo	desgastado/passado
santo	sagrado/dedicado
belo	aprazível/gracioso/atraente
prestes	preparado
interno	central
pessoal	privado
bom	digno/decoroso/digno/nobre/virtuoso/eqüitativo/recto/reto/justo/respeitável/obediente/moral/saudável/salubre/são/bom/boa/bom/saudável/em_forma/favorável/melhor/melhor
necessário	indispensável/que_não_pode_ser_dispensado/essencial/imprescindível/essencial/imprescindível/obrigatório/essencial
forte	duro/resistente/grosso/poderoso
amplo	amplo/largo/espesso/grosso/geral/detalhado/exaustivo/extenso/abrangente/amplo/totalizado/completo/integral
permanente	estável/inalterável/imutável
júnior	subalterno/nao-maduro/jovem
posterior	posterior/traseiro/de_trás/rabo/posterior/traseiro
ordinário	genérico/habitual/geral/ordinário/costumeiro/usual/comum/comum/comum
efetivo	útil/poderoso/potente/eficiente/eficiente/eficaz
atual	novo/moderno/contemporâneo
socialista	esquerdista
corrente	novo/moderno/contemporâneo
possível	realístico/prático/provável
primário	original/primeiro/essencial
conjunto	unido/partilhado/integrado/comum/colectivo/coletivo
indireto	torto/escuso
legal	legítimo/lícito
coletivo	unido/conjunto/solidário
conservador	ortodoxo
livre	independente
salgado	saboroso
futuro	prospectivo
existente	realístico/genuíno/legítimo/autêntico/existente/remanescente/existente/concreto
intenso	profundo/entranhado
amigo	cálido/social/sociável/social/amigável/útil/congenial
intelectual	erudito/mental
produtor	próspero/bem_sucedido/bem-sucedido/proveitoso/rendoso/lucrativo/proveitoso/frutífero/fértil/fecundo/fecundo/fértil/criativo/criador/original
obrigatório	necessário/essencial
ativo	enérgico/energético/vívido
humano	compassivo/misericordioso/humano/civilizado
jovem	júnior/novo/imaturo
produtivo	próspero/bem_sucedido/bem-sucedido/proveitoso/rendoso/lucrativo/proveitoso/frutífero/fértil/fecundo/fecundo/fértil/criativo/criador/original
crítico	erudito/sarcástico/desfavorável/essencial/decisivo/crítico/crucial/importante/crítico
válido	razoável/legítimo
comum	conjunto/solidário/normal/costumeiro/comum/rotineiro/ordinário/genérico/habitual/geral/ordinário/costumeiro/usual/comum/genérico/habitual/geral/ordinário/costumeiro/usual/comum/comum/comum
extraordinário	superior/impressionante/incomparável/insólito/inusual/incomun/extraordinário
material	substancial
capaz	satisfatório/competente/habilitado/apropriado
certo	verdadeiro/conveniente/adequado/próprio/previsível/que_se_pode_prever/precisa/preciso/bem_acabado/perfeito/aprimorado/literal/textual/preciso/exacto/justo/exato/acurado/preciso/exacto/justo/exato/acurado
independente	separado/livre
bastante	rica/rico
definitivo	explícito/inconfundível
religioso	digno/nobre/virtuoso/sagrado/devoto/religioso/piedoso/religioso
velho	desgastado/sênior/passado/maturo/maduro/vivido/experimentado/experiente
preto	escuro
claro	cândido/alvo/branco
violento	malvado
significativo	significativo/importante/significante/significativo/importante
alvo	claro
específico	precisa/preciso/bem_acabado
leal	leal/patriótico/leal/fiel
natural	natural/natural/natural
regular	sistemático/sistémico/simétrico/ritmado/rítmico
indispensável	necessário/essencial
normal	padrão/mentalmente_sadio/mentalmente_são/são/sadio/sã/genérico/habitual/geral/ordinário/costumeiro/usual/comum/comum
negro	escuro
verdadeiro	honesto/sincero/honesta/sincera/genuíno/legítimo/autêntico/certo/correto/justo
físico	perceptível/concreto
familiar	sabido
baixo	inferior/deprimido
decisivo	crítico/crucial/importante/conclusivo
constante	invariável/estável/inalterável/imutável
seguro	invulnerável/previsível/que_se_pode_prever/indemne/indene/inofensivo/que_não_causa_danos/inócuo
ilegal	desonesto/corrupto/ilegítimo/ilegal/fora_da_lei/ilegal
individual	separado
fiel	leal/patriótico
doce	saboroso/doce/doce/açucarado
moderno	novo/tardio/atual/actual/corrente
profundo	erudito/intenso/intensivo
direita	destro
integral	detalhado/exaustivo/extenso/abrangente/amplo/totalizado/completo/integral/integral/inteiro
irregular	partidário
difícil	intratável/desobediente/não_governável/desobediente/duro/desafiador
justo	digno/decoroso/digno/nobre/virtuoso/verdadeiro/conveniente/adequado/próprio/precisa/preciso/bem_acabado/imparcial/moral/lícito/inocente/honesto/sincero/honesta/sincera/bom/boa/preciso/certo/exato/correcto/certo/correto/justo/preciso/exacto/justo/exato/acurado
disposto	preparado
moral	digno/nobre/virtuoso/eqüitativo/recto/reto/justo/honroso/honrado/bom/boa/casto/casta
duro	cabeçudo/forte/imisericordioso/impiedoso/vivido/experimentado/experiente/árduo/intrincado/difícil
diferente	vário/que_oferece_várias_aspectos/diferente/diferente/desigual/incompatível
cândido	crédulo/claro
preocupado	problemático/atento
completo	detalhado/exaustivo/extenso/abrangente/amplo/integral/inteiro
original	produtivo/produtor/primário/original/primeiro/criativo/criador/original/não_usual
energético	empreendedor/dinâmico/vívido/ativo
simples	singelo/simples/despretensioso/simples/fácil
rápido	apressado/abrupto/súbito/repentina/repentino
complexo	composto/árduo/intrincado/difícil
essencial	primário/necessário/essencial/necessário/essencial/necessário/essencial/intrínseca/intrínseco/importante/indispensável/que_não_pode_ser_dispensado/essencial/imprescindível/indispensável/que_não_pode_ser_dispensado/essencial/imprescindível/essencial/imprescindível/obrigatório/essencial/crítico/crucial/importante
semelhante	mesmo/o_mesmo
formal	retórico/formal/ceremonioso/formal/corriqueiro/convencional
mau	iniquo/malvada/errado/que_não_tem_razão/incorrecto/ofensivo/imoral/ruim
voluntário	consciente
concreto	tangível/físico/existente/prático
progressivo	industrial/de_frente/na_frente/fronteiro/dianteiro
passado	dinheiro_tradicional/antigo/velho/extrovertido
positivo	optimista/otimista/construtivo/afirmativo
alta	ruidoso/barulhento/audível
padrão	normal
preciso	precisa/preciso/bem_acabado/precisa/preciso/bem_acabado/perfeito/aprimorado/literal/textual/específico/preciso/certo/exato/correcto/preciso/certo/exato/correcto/inconfundível/certo/correto/justo/preciso/exacto/justo/exato/acurado/preciso/exacto/justo/exato/acurado
poderoso	forte/potente/eficiente/eficaz/efetivo
largo	espesso/grosso/detalhado/exaustivo/extenso/abrangente/amplo
falso	desonroso/errado/incorreto
autêntico	verdadeiro/existente/honesto/sincero/honesta/sincera
vago	dúbio/ambíguo/confuso
adequado	satisfatório/certo/correto/justo/apropriado/apropriado
inferior	baixo/baixa/deprimido/subordinada/subordinado/pior
paralelo	simétrico/comparável
preventivo	proteccionista
prudente	sábio/responsável/prudente/sensato/judicioso/diligente/cauto/cauteloso/prudente/atento/cautelosa/cuidadosa/prudente/atento/cautelosa/cuidadosa/prudente/atento
doente	doente/enfermo/adoentado/doente/doentio/insalubre/inapropriado/inapropriado
boa	digno/decoroso/digno/nobre/virtuoso/eqüitativo/recto/reto/justo/moral/bom
igual	mesmo/o_mesmo/comparável
paterno	patriarcal
sistemático	regular/organizado
temporário	precário/instável
remanescente	existente
parcial	injusto/incompleto
pacífico	quieto/calmo/amigável
considerável	grande
ofensiva	desrespeitoso/prejudicial/danoso/daninho/nocivo
evidente	explícito/aberto
imóvel	imóvel/imóvel
feminino	feminina
estreito	estreita/estreito/fino/limitado/estreito
recente	novo
insuficiente	escasso/escasso
bem-sucedido	produtivo/produtor/afortunado
impossível	inexorável/insuperável/inviável/impraticável/falta_de_esperança/desesperado
gradual	inclinado/lento/devagar
rico	privilegiado/abastado/copioso/abundante/basto/farto/bastante/lauto
solidário	unido/partilhado/integrado/comum/colectivo/coletivo
criador	produtivo/produtor/original
pronto	preparado
contemporâneo	novo/tardio/atual/actual/corrente
esquerdista	liberal/socialista
improdutivo	impotente/ineficaz
agressivo	de_ataque/ofensivo/malvado/peremptório/assertivo/agressivo/agressivo
abaixo	descendente/deprimido
precário	inseguro/oscilante/temporário/inconstante
desfavorável	malvado/prejudicial/danoso/daninho/nocivo/ruim/crítico
prático	prestativo/realístico/possível/concreto
provável	possível
inelegível	não_qualificado
inativo	letárgico
baixa	inferior
legítimo	válido/verdadeiro/existente/legal/honesto/sincero/honesta/sincera
ofensivo	desrespeitoso/arisco/desagradável/abominável/malvado/prejudicial/danoso/daninho/nocivo/mau/maléfico/malvado/ruim/agressivo
eficiente	útil/poderoso/potente/eficiente/eficiente/eficaz/eficiente/eficaz/efetivo/eficiente/eficaz/efetivo/competente/habilitado
descendente	abaixo
simpático	aprazível/boa!/lhano/gentil/afável/amável
amoroso	apaixonado/passional/adorável/amável/amorável/empenhado
inevitável	previsível/que_se_pode_prever
organizado	sistemático/sistémico/estruturado/exigente/detalhista/limpo
inteiro	totalizado/completo/integral
estável	imutável/permanente/duradouro/constante
clemente	temperado/compassivo/misericordioso
extenso	amplo/largo/geral/totalizado/completo/integral
leigo	sofisticado/profano
substancial	material
fácil	singelo/simples/brando
informal	informal/informal
lento	gradual
incapaz	incompetente
eficaz	útil/poderoso/potente/eficiente/eficiente/eficaz/eficiente/eficaz/efetivo
sensível	suscetível/susceptível/sensível/sensível/responsivo/responsivo/consciente/ciente/informado
incompatível	diferente/incompatível/incompatível
esquerdo	canhoto
convencional	ceremonioso/formal
enfermo	adoentado/doente/doentio/insalubre/inapropriado
nulo	ilegítimo
idêntico	mesmo/o_mesmo/comparável
valente	arrojado/audacioso/destemido/bravo/corajoso/audaz/destemido/sem_medo/aventureiro
restrito	reservado
nobre	eqüitativo/recto/reto/justo/piedoso/religioso/moral/honroso/honrado/bom/boa/casto/casta
funcional	prestativo
similar	mesmo/o_mesmo
empenhado	amoroso/afectuoso/carinhoso/queama
automático	mecânico
prejudicial	tóxico/doloroso/árduo/dolorido/doído/extenuante/ofensivo/ofensiva/nocivo/tóxico/destrutivo/caluníe/maligno/desvantajoso/desfavorável
competente	habilidoso/talentoso/qualificado/eficiente/capaz
silvestre	intratável/desobediente/não_governável
racional	mentalmente_sadio/mentalmente_são/são/sadio/sã/razoável/lógico
perigoso	vulnerável/inseguro
contundente	persuasivo
explícito	público/explícito/aberto/explícito/inequívoco/unívoco/denotativo/definitivo
melhor	superior/bom/incomparável
enérgico	empreendedor/dinâmico/vívido/ativo
útil	simpática/prestativo/proveitoso/rendoso/lucrativo/prestativo/serviçal/prestável/amistoso/amigo/amigável/eficiente/eficaz/efetivo/compatível
lucrativo	útil/produtivo/produtor/propício/profícuo/favorável/vantajoso
unido	conjunto/solidário/integrado/colectivo/coletivo
sólido	duro/dura
subordinado	inferior/subalterno
ortodoxo	conservador
cedo	primeiro
móvel	movente
tenso	apertado/desassossegado/inquieto
distante	longe/longínquo/distante
típico	caraterístico/característico
escrito	roteirizado/escrito
deficiente	escasso
crucial	essencial/decisivo/crítico
rica	privilegiado/abastado/copioso/abundante/basto/farto/bastante/lauto
moderado	moderado/moderado/suave/suave
inviável	impossível
conveniente	certo/correto/justo/apropriado/acessível
feminina	feminina/feminino/feminina
compatível	harmonioso/útil/congenial
cerrado	concentrado
intensivo	profundo/entranhado
aberto	público/aberto/aberto/explícito
consciente	voluntário/sensível/ciente/informado/acordado/desperto
frio	frio/frígido/frio/fresco/frio/frio/congelado/gelado
estranho	desconhecido/estranho/estrangeiro/feia/feio/desajeitado
corrupto	imoral/fora_da_lei/ilegal/desonroso
puro	casto/casta
integrado	unido/conjunto/solidário
imprescindível	necessário/essencial/necessário/essencial
gentil	agradável/simpático/amável/agradável
divergente	oblíquo
visível	perceptível
flexível	elástico
bonito	aprazível/gracioso/atraente
artificial	irreal/não_material/lógico
abrangente	amplo/largo/geral/totalizado/completo/integral
manso	tratável
caro	precioso/valioso
informativo	noticioso
coerente	racional/lógico
propício	proveitoso/rendoso/lucrativo/cómodo/propício/oportuno/favorável/propício/propício/auspicioso/propício/profícuo/favorável/vantajoso
patriótico	leal/fiel
inútil	indigno/inútil/vão/impróprio/inapto/não_lucrativo/não_rentável/impotente/ineficiente/inútil/vão/desempregado
escasso	deficiente/insuficiente/minimum/mínimo/escasso/escasso/insuficiente
satisfatório	capaz/adequado/aceitável
sagrado	sagrado/piedoso/religioso/celeste/dedicado/dedicado
raro	infreqüente/infrequente/infrequënte
razoável	válido/racional/lógico
ferido	imcompleto/com_imperfeições/deteriorado/lesionado/atingido/danificado/avariado/quebrado/partido
dinâmico	enérgico/energético
separado	dividido/outro/segregado/independente/individual
variável	inconstante/inconstante/inconsistente
injusto	errado/que_não_tem_razão/incorrecto/parcial/injusto/imoral/desonroso/injusto
ambíguo	dúbio/ambíguo/confuso/vago/impreciso/ambíguo/dúbio/indefinido
surpreendente	inesperado/imprevisto
subalterno	subordinada/subordinado
oportuno	propício/profícuo/favorável/vantajoso
exato	precisa/preciso/bem_acabado/precisa/preciso/bem_acabado/perfeito/aprimorado/literal/textual/preciso/certo/exato/correcto/certo/correto/justo/preciso/exacto/justo/exato/acurado
duradouro	estável/inalterável/imutável
digno	precioso/valioso/eqüitativo/recto/reto/justo/eqüitativo/recto/reto/justo/piedoso/religioso/moral/honroso/honrado/bom/boa/bom/boa/elegante/esbelto/garboso/airoso/gracioso/constituído/casto/casta
cauteloso	cautelosa/cuidadosa/prudente/atento
imparcial	imparcial
feliz	ditoso/feliz/grato/contente/alegre/eufórico/contente/contente/animado/animador/contente/animado/animador
inesperado	surpreendente
fino	estreita/estreito/liso/macio/magro/esbelto
atento	prudente/sensato/judicioso/diligente/preocupado/cauto/cauteloso/prudente/atento/cautelosa/cuidadosa/prudente/atento
lógico	razoável/racional/racional/lógico/consistente/coerente/lógico/artificial/sintético/analítico
implícito	conotativo/conotativa
genérico	comum
vantajoso	proveitoso/rendoso/lucrativo/optimista/otimista/cómodo/propício/oportuno/construtivo/afirmativo
nocivo	tóxico/tóxico/doloroso/árduo/dolorido/doído/extenuante/ofensivo/ofensiva/nocivo/tóxico/prejudicial/danoso/daninho/nocivo/destrutivo/caluníe/maligno/desvantajoso/desfavorável
animador	feliz/grato/contente/alegre/feliz/contente
vazio	vazio
solto	lasso
humorístico	aprazível
súbito	rápido/veloz/rápida
sagrada	sagrado/dedicado
atingido	ferido/danificado/avariado
ambicioso	empreendedor
inocente	eqüitativo/recto/reto/justo
honesto	verdadeiro/justo/correto/honroso/honrado/genuíno/legítimo/autêntico/direto
desempregado	desempregado/inútil/vão/desempregado
paciente	tolerante/resignado
otimista	positivo/vantajoso
delicado	débil/débil/frágil/quebrável
estreita	fino/limitado/estreito
dividido	separado/segregado
correto	verdadeiro/conveniente/adequado/próprio/lícito/honesto/sincero/honesta/sincera/preciso/exacto/justo/exato/acurado
alerta	vívido/acordado/desperto/cauteloso/cuidadoso/astuto
acessível	conveniente
vário	diferente/heterogênea/heterogêneo
vulnerável	suscetível/susceptível/inseguro/inseguro/perigoso
inequívoco	não_ambíguo
problemático	preocupado
perfeito	utópico/preciso/certo/exato/correcto
mortal	limitado/finito
consistente	invariável/racional/lógico
confuso	indistinto/incompreensível/opaco/vago/impreciso/ambíguo/dúbio/indefinido
ilegítimo	nulo/inválido/ilegal
heterogêneo	vário/que_oferece_várias_aspectos/diferente
cooperativo	prestativo/serviçal/prestável
solúvel	explicável
secular	sofisticado/profano
indefinido	dúbio/ambíguo/confuso
hábil	astuto
empreendedor	enérgico/energético/ambicioso/aventureiro
ciente	sensível/consciente/acordado/desperto
aceitável	satisfatório
usual	comum
masculino	masculina/macho/varão/macho/varonil/viril
informado	sensível/consciente/acordado/desperto
incompetente	não_qualificado/ineficiente
conclusivo	decisivo
óbvio	explícito/aberto
ágil	astuto
próspero	produtivo/produtor/afortunado
proeminente	indiscreto/imprudente
preparado	pronto/preparado/prestes/disposto/preparado
limpo	organizado/limpo/exigente/detalhista/limpo
interessante	excitante/emocionante
desejável	adorável/amável/amorável
sincero	verdadeiro/justo/correto/honroso/honrado/genuíno/legítimo/autêntico/direto
prematuro	imaturo
esporádico	infreqüente/infrequente/infrequënte
eqüitativo	digno/decoroso/digno/nobre/virtuoso/moral/inocente/bom/boa
privilegiado	rica/rico/afortunado
inteligente	precoce/esperto
incompleto	fracionário/parcial
formoso	aprazível/gracioso/atraente
emocional	cálido/apaixonado/passional/emocionante/comovente/trasladado/afetado
construtivo	positivo/vantajoso
análogo	mesmo/o_mesmo/comparável
vão	inútil/vão/impróprio/inapto/não_lucrativo/não_rentável/impotente/ineficiente/inútil/vão/desempregado
sintético	lógico
selvagem	intratável/desobediente/não_governável
prematura	imaturo
precioso	digno/decoroso/importante/caro
pessimista	falta_de_esperança/desesperado
inconsistente	variável
implacável	imisericordioso/impiedoso
constituído	condigno/digno
composto	intrincado/complexo
compacto	concentrado
celeste	sagrado/imortal
amistoso	cálido/social/sociável/social/amigável/útil/congenial
abundante	rica/rico
saudável	saudável/saudável/bom/bem/bom/bem/digno_de_confiança/digno_de_confiança/saudável/salubre/são/saudável/salubre/são/saudável/saudável/em_forma
satisfeito	contente
sangrento	imisericordioso/impiedoso
imoral	indigno/iniquo/malvada/mal_afamado/injusto/desonroso/mau/maléfico/malvado/ruim
gordo	espesso/grosso
concentrado	compacto/cerrado
vertical	reto/íngrime/íngreme
valioso	digno/decoroso/importante/caro
ineficiente	inútil/vão/incompetente
articulado	comunicativo
analítico	lógico
tóxico	tóxico/nocivo/tóxico/prejudicial/danoso/daninho/nocivo/prejudicial/danoso/daninho/nocivo
repentino	rápido/veloz/rápida
perplexo	perplexo/hesitante/perplexo
experiente	duro/resistente/grosso/habilidoso/talentoso
dúbio	dúbio/ambíguo/confuso/vago/impreciso/ambíguo/dúbio/indefinido
característico	típico
suscetível	vulnerável/sensível
sadio	racional
ruim	iniquo/malvada/errado/que_não_tem_razão/incorrecto/ofensivo/desobediente/imoral/mau/maléfico/malvado/ruim/ruim/desfavorável/pior/pior
rotineiro	genérico/habitual/geral/ordinário/costumeiro/usual/comum/comum
noticioso	noticioso/informativo/noticioso
lícito	justo/correto/legal
instável	inseguro/oscilante/temporário/inconstante
incerto	imprevisível
homogêneo	mesmo/o_mesmo/uniforme/invariável
hesitante	perplexo
farto	rica/rico
áspero	rugoso/desuniforme/desnivelado/despadronizado
árduo	desumano/inumano/prejudicial/danoso/daninho/nocivo/duro
incontrolável	intratável/desobediente/não_governável/desobediente/desafiador
inalienável	intrínseca/intrínseco
feio	desajeitado/esquisito/estranho
exaustivo	amplo/largo/geral/totalizado/completo/integral
criativo	produtivo/produtor/original
caloroso	forgoso/quente
azedo	saboroso
receoso	cobarde/covardemente/covarde/timorato
impróprio	não_lucrativo/não_rentável/inútil/vão
impressionante	emocionante/comovente
impraticável	impossível
honroso	digno/decoroso/respeitável/nobre/moral/honesto/sincero/honesta/sincera
estruturado	organizado
entusiástico	apaixonado/passional
elegível	qualificado
desrespeitoso	sarcástico/ofensivo/ofensiva/descortês
audacioso	valente/bravo/afoito/corajoso/arrojado/brava/valoroso/destemido/sem_medo/aventureiro
afirmativo	positivo/vantajoso/favorável
triste	pesaroso/triste/destestável/triste/infeliz/triste/infeliz/triste/discontente/triste
superficial	frívolo/fútil/descuidado/negligente
sofisticado	secular/leigo/letrado/alfabetizado/cosmopolita/elegante/esbelto/garboso/airoso/gracioso
ruidoso	estrepitante/berrante/alto/alta/cacofônico
quadrado	angulado/angular
miserável	mal_sucedido/sem_sucesso
limitado	estreita/estreito/mortal
inócuo	seguro/indolor/inócuo/inofensivo/que_não_causa_danos/inócuo/benigno
harmonioso	compatível
escuso	indireto
corajoso	valente/bravo/afoito/corajoso/arrojado/brava/valoroso/arrojado/audacioso/destemido/bravo/corajoso/audaz/destemido/sem_medo/destemido/sem_medo/aventureiro/aventureiro
comparável	paralelo/paralela/igual/idêntico/análogo/parelho
tenaz	consciente
pior	inferior/ruim
passional	amoroso/afectuoso/carinhoso/queama/quente/esquentado/entusiástico/entusiasta/emocional
insensível	desfalecido/inconsciente/desmaiado/desacordado/incônscio/esmaecido
ineficaz	impotente/infértil/estéril/improdutivo
habitual	comum
grato	contente/animado/animador
glorioso	sabido
fértil	produtivo/produtor/produtivo/produtor/potente/proveitoso/frutífero/fértil/fecundo/fecundo/fértil
entusiasta	apaixonado/passional
derrotado	mal_sucedido/sem_sucesso
civilizado	mimoso/grácil
aventureiro	valente/bravo/afoito/corajoso/arrojado/brava/valoroso/arrojado/audacioso/destemido/bravo/corajoso/audaz
atraente	aprazível/belo/lindo/bonito/formoso
tolerante	paciente/caridoso
sênior	velho
sucinto	taciturno
submisso	tratável/obediente/manipulável
suave	moderado/silencioso/quieto/moderado
silencioso	suave/inaudível
dispensável	desnecessário/desnecessária
detalhado	amplo/largo/geral/totalizado/completo/integral
desumano	doloroso/árduo/dolorido/doído/extenuante
convincente	persuasivo
utópico	perfeito/aprimorado
rápida	apressado/abrupto/súbito/repentina/repentino
resistente	forte/vivido/experimentado/experiente
quente	caloroso/apaixonado/passional
protegido	invulnerável
oscilante	precário/instável/desuniforme/desnivelado/despadronizado/inquieto
ocupado	diligente
obediente	tratável/dócil/manipulável/bom/complacente/submisso
insuperável	impossível/inconquistável
infinito	imortal
indigno	inútil/imoral/desonroso/desprezível
fechado	fechado/fechado
elegante	sofisticado/mimoso/grácil/gracioso/condigno/digno
desconhecido	desconhecido/estranho/estrangeiro/pouco_familiar/desconhecido/estranho
covarde	timorato/receoso
compreensível	inteligível/explicável
amigável	cálido/social/sociável/social/pacífico/adorável/amável/amorável/amigável/amistoso/amigo/amigável/útil/congenial
precoce	inteligente/primeiro
plausível	acreditável/crível
perceptível	visível/audível
maduro	velho
inseguro	vulnerável/vulnerável/precário/instável/inseguro/inseguro/perigoso/desuniforme/desnivelado/despadronizado/inquieto
insalubre	doente/enfermo/inapropriado
imprevisível	incerto
imprevisto	surpreendente
impreciso	geral/dúbio/ambíguo/confuso
imortal	celeste/infinito
doloroso	desumano/inumano/prejudicial/danoso/daninho/nocivo
convergente	oblíquo
calmo	pacífico
bravo	valente/bravo/afoito/corajoso/arrojado/brava/valoroso/arrojado/audacioso/destemido/bravo/corajoso/audaz/destemido/sem_medo/destemido/sem_medo/aventureiro/aventureiro
angular	quadrado/pontudo
temporão	primeiro
sábio	prudente/sensato/judicioso/aconselhável
sujo	eriçado/hirto/indecente
proveitoso	útil/produtivo/produtor/produtivo/produtor/fecundo/fértil/propício/profícuo/favorável/vantajoso
previsível	inevitável/seguro/certo
negligente	imprudente/superficial/sem_cuidado/desatencioso
inquieto	tenso/inseguro/oscilante/impaciente/excitada/entusiasmado/excitado
incrível	inverossímil
humanitário	compassivo/misericordioso/humano/civilizado
fecundo	produtivo/produtor/produtivo/produtor/potente/proveitoso/frutífero/fértil/fecundo/fecundo/fértil
erudito	profundo/entranhado/intelectual/crítico
equitativo	imparcial
desonesto	fora_da_lei/ilegal/desonroso
basto	rica/rico
talentoso	vivido/experimentado/experiente/competente/habilitado
sã	racional
retórico	figurativo
precisa	específico/preciso/certo/exato/correcto/inconfundível/preciso/exacto/justo/exato/acurado
perdido	perdido/perdido/amaldiçoado/maldita/maldito
patriarcal	paternal/paterno
oblíquo	inclinado/divergente/convergente
mimoso	exigente/detalhista/elegante/esbelto/garboso/airoso/gracioso/civilizado
maligno	prejudicial/danoso/daninho/nocivo
irreal	sobrecomum/sobrenatural/artificial
intrínseco	essencial/inalienável
infeliz	mal_sucedido/sem_sucesso/pesaroso/triste/destestável/triste/discontente/triste
imutável	estável/permanente/duradouro/no_mesmo_nível/plano/constante
impiedoso	implacável/duro/sangüíneo/sangrento
imperfeito	quebrado/partido
escuro	negro/preto
errado	iniquo/malvada/falso/errado/imoral/injusto/desonroso/mau/maléfico/malvado/ruim/não_ético/errado/incorreto
doméstica	nacional
detalhista	organizado/limpo/mimoso/grácil
danoso	tóxico/doloroso/árduo/dolorido/doído/extenuante/ofensivo/ofensiva/nocivo/tóxico/destrutivo/caluníe/maligno/desvantajoso/desfavorável
casta	digno/nobre/virtuoso/puro/moral
brando	tenro/meigo
benigno	amável/inofensivo/que_não_causa_danos/inócuo
arrojado	valente/bravo/afoito/corajoso/arrojado/brava/valoroso/arrojado/audacioso/destemido/bravo/corajoso/audaz/destemido/sem_medo/destemido/sem_medo/aventureiro/aventureiro
varonil	macho/masculina/masculino
sobrenatural	irreal/não_material
simétrico	regular/paralelo/paralela
simpática	amável/útil/congenial
relutante	involuntário/desafiador
qualificado	elegível/competente/habilitado
prolixo	tagarela
obstinado	intratável/desobediente/não_governável/desobediente/inflexível
inválido	ilegítimo
infiel	inconstante
inexplicável	incompreensível
inexorável	impossível/inconquistável
incorreto	falso/errado
incompreensível	inexplicável/incompreensível/incompreensível/confuso
inclinado	oblíquo/gradual
inalterável	permanente/duradouro/constante
imprudente	tolo/descuidado/negligente
impotente	débil/impotente/impotente/ineficaz/infértil/estéril/improdutivo/inútil/vão
horrível	arisco/desagradável
habilitado	habilidoso/talentoso/qualificado/eficiente/capaz
genuíno	verdadeiro/existente/honesto/sincero/honesta/sincera
estéril	impotente/ineficaz
entusiasmado	inquieto
encontrado	salvado
débil	delicado/impotente/delicado
desgastado	dinheiro_tradicional/antigo/velho
desagradável	ofensivo/antipático/horrível
cortês	respeitoso
corriqueiro	ceremonioso/formal
conciso	taciturno
audaz	valente/bravo/afoito/corajoso/arrojado/brava/valoroso/destemido/sem_medo/aventureiro
atípico	anormal
aprazível	agradável/simpático/engraçado/humorístico/belo/lindo/bonito/formoso/atraente
anormal	insano
ávido	entusiástico/entusiasta
varão	macho/masculina/masculino
torto	indireto
sincera	verdadeiro/justo/correto/honroso/honrado/genuíno/legítimo/autêntico/direto
sensato	sábio/responsável/cautelosa/cuidadosa/prudente/atento
saliente	indiscreto/imprudente
respeitável	digno/decoroso/respeitável/respeitável/honroso/honrado/bom
reservado	taciturno/inibido/restrito/inarticulado
rendoso	útil/produtivo/produtor/propício/profícuo/favorável/vantajoso
questionável	contestável
profícuo	proveitoso/rendoso/lucrativo/cómodo/propício/oportuno
potente	poderoso/fecundo/fértil/eficiente/eficaz/efetivo
paralela	simétrico/comparável
palpável	perceptível
maléfico	iniquo/malvada/errado/que_não_tem_razão/incorrecto/ofensivo/imoral/ruim
inconsciente	involuntário/insensível/adormecido
inconclusivo	indecisivo
incomparável	extraordinário/melhor
inapto	não_lucrativo/não_rentável/inútil/vão
imaturo	nao-maduro/jovem/prematuro/prematura
frutífero	produtivo/produtor/fecundo/fértil
fronteiro	progressivo
explicável	solúvel/compreensível
exigente	organizado/limpo/mimoso/grácil
devoto	piedoso/religioso
desvantajoso	prejudicial/danoso/daninho/nocivo
destrutivo	prejudicial/danoso/daninho/nocivo
dedicado	sagrado/santa/sagrada/santo/sagrado
costumeiro	genérico/habitual/geral/ordinário/costumeiro/usual/comum/comum/comum
copioso	rica/rico
contente	contente/satisfeito/ditoso/feliz/grato/contente/alegre/feliz/grato/contente/alegre/feliz/contente/feliz/contente/eufórico/contente/contente/contente/animado/animador/contente/animado/animador
congelado	frio
complacente	tratável/obediente/manipulável
auspicioso	propício
apropriado	conveniente/adequado/próprio
alienígena	internacional
afetado	paranormal/fenômenos_paranormais/sobrecomum/sobrenatural/trasladado/afetado/emocional/afetado/afetado
aconselhável	sábio/prudente/sensato/judicioso
abrupto	rápido/veloz/rápida
volátil	inconstante
valoroso	arrojado/audacioso/destemido/bravo/corajoso/audaz/destemido/sem_medo/aventureiro
tenro	brando/comestível
suja	eriçado/hirto/indecente
singelo	simples/fácil
sangüíneo	imisericordioso/impiedoso
reto	digno/decoroso/digno/nobre/virtuoso/moral/inocente/vertical/fio_de_prumo/perpendicular/bom/boa/directo
respeitoso	cortês
presumido	insípido
perpendicular	reto/íngrime/íngreme
masculina	masculina/macho/masculina/masculino/macho/varão/macho/varonil/viril
magro	fino
macho	masculina/macho/masculina/masculino/macho/masculina/masculino/macho/varão/macho/varonil/viril
involuntário	relutante/de_mau_grado/desfalecido/inconsciente/desmaiado/desacordado/incônscio/esmaecido
invariável	constante/consistente
inibido	reservado
incorrigível	desobediente
imaterial	insubstancial/insustancial
heterogênea	vário/que_oferece_várias_aspectos/diferente
habilidoso	vivido/experimentado/experiente/competente/habilitado
frouxo	lasso
finito	mortal
figurativo	retórico
extenuante	desumano/inumano/prejudicial/danoso/daninho/nocivo
estúpido	retardado/lerdo/estúpido/sonso/estúpido/imbecil/idiota
dócil	tratável/obediente
doentio	doente/enfermo/inapropriado
desprezível	indigno
desperto	consciente/ciente/informado/alerta
desconfortável	desassossegado
desaconselhável	tolo/imprudente
deprimido	abaixo/baixo/inferior
daninho	tóxico/doloroso/árduo/dolorido/doído/extenuante/ofensivo/ofensiva/nocivo/tóxico/destrutivo/caluníe/maligno/desvantajoso/desfavorável
crédulo	cândido
covardemente	timorato/receoso
condigno	elegante/esbelto/garboso/airoso/gracioso/constituído
comovente	impressionante/emocional
comestível	macio/tenro/digerível
colorido	cromático
chato	incolor/sem_cor
casual	infreqüente/infrequente/infrequënte
carinhoso	apaixonado/passional/adorável/amável/amorável/empenhado
brava	arrojado/audacioso/destemido/bravo/corajoso/audaz/destemido/sem_medo/aventureiro
benfeitor	amável
astuto	hábil/ágil/alerta
apertado	tenso
apaixonado	amoroso/afectuoso/carinhoso/queama/quente/esquentado/entusiástico/entusiasta/emocional
agradável	aprazível/boa!/lhano/gentil/afável/amável
acurado	precisa/preciso/bem_acabado/preciso/certo/exato/correcto/certo/correto/justo
acabado	liso/macio
abastado	rica/rico
íngreme	vertical/fio_de_prumo/perpendicular
virtuoso	eqüitativo/recto/reto/justo/piedoso/religioso/moral/bom/boa/casto/casta
traseiro	posterior/traseiro/de_trás/rabo/posterior/traseiro
textual	preciso/certo/exato/correcto
terminado	liso/macio
temperado	clemente
teimoso	intratável/desobediente/não_governável/desobediente/inflexível
tangível	perceptível/concreto
taciturno	conciso/sucinto/lacônico/lacónico/não_comunicativo/reservado
substituível	sacrificável/esgotável
subordinada	inferior/subalterno
significante	significativo/importante
serviçal	útil/encorajador/cooperativo/prestável
sarcástico	desrespeitoso/crítico
rítmico	regular
rabo	posterior/traseiro/de_trás
quebrado	imcompleto/com_imperfeições/imperfeito/ferido/danificado/avariado
prospectivo	futuro
profano	secular/leigo
piedoso	digno/nobre/virtuoso/sagrado/devoto/religioso
pacato	pacífico
mutável	inconstante
monótono	incolor/sem_cor
literal	preciso/certo/exato/correcto
liso	escorregadio/fino/no_mesmo_nível/plano
lauto	rica/rico
invulnerável	seguro/protegido/inconquistável
intrincado	composto/duro/árduo/intrincado/difícil
inteligível	compreensível
insano	irracional
indistinto	confuso
inconfundível	precisa/preciso/bem_acabado/definitivo
inaudível	silencioso/quieto
inapropriado	doente/enfermo/imcompleto/com_imperfeições/adoentado/doente/doentio/insalubre
imbecil	lerdo/estúpido
idiota	lerdo/estúpido
honrado	digno/decoroso/respeitável/nobre/moral/honesto/sincero/honesta/sincera
homogênea	mesmo/o_mesmo/uniforme/invariável
gregário	social
gracioso	sofisticado/mimoso/grácil/gracioso/elegante/esbelto/garboso/airoso/gracioso/condigno/digno/belo/lindo/bonito/formoso
fútil	superficial
frívolo	superficial
fresco	novo/frio
extrovertido	passado
experimentado	duro/resistente/grosso/habilidoso/talentoso
excitante	sensual/sexy/interessante
eufórico	feliz/contente
esquisito	feia/feio/desajeitado
esperto	inteligente
emocionante	sensual/sexy/interessante/impressionante/emocional
elástico	flexível
domesticado	nacional
diligente	cautelosa/cuidadosa/prudente/atento/atarefado/ocupado
deteriorado	ferido/danificado/avariado
destro	direito/direita
despretensioso	simples
desonroso	indigno/falso/errado/desonesto/corrupto/mal_afamado/injusto/imoral/desonroso/desonroso
desinteressante	incolor/sem_cor
desatento	inconsiderado
desafiador	relutante/de_mau_grado/intratável/desobediente/não_governável/desobediente/incontrolável/difícil
casto	digno/nobre/virtuoso/puro/moral
barulhento	estrepitante/berrante/alto/alta/cacofônico
arisco	ofensivo/antipático/horrível
animado	feliz/grato/contente/alegre/feliz/contente
afável	agradável/simpático/amável/agradável
afortunado	próspero/bem_sucedido/bem-sucedido/privilegiado/afortunado/sortudo/afortunado
adorável	amoroso/afectuoso/carinhoso/queama/amigável/desejável
adormecido	desfalecido/inconsciente/desmaiado/desacordado/incônscio/esmaecido