partido	regimes_políticos
estado	nação/país/terra
legenda	regimes_políticos
filho	família
escola	universidade
legislatura	autoridades/governo/regime
diretor	comité/junta/comitê/conselho
instituto	universidade
faculdade	universidade
exército	serviço_militar
professor	corpo_docente
chapa	regimes_políticos
departamento	empresa/organização_empresarial/autoridades/governo/regime
pai	família
carvalho	carvalho/quercus
aranha	aranhas/aranha
pessoa	pessoal/população/povo/gente
pessoal	espécie_humana/homem/povo/mundo/humanidade
povo	espécie_humana/homem/povo/mundo/humanidade
terra	sistema_solar
polícia	polícia/lei
livro	jogo/grupo
população	espécie_humana/homem/povo/mundo/humanidade
carneiro	manada/grei/rebanho/gado/rebanho/ovis
divisão	corpo/empresa/organização_empresarial/autoridades/governo/regime
coluna	tabela
policial	polícia/lei
nota	escala_musical/escalas_musicais
mundo	sistema_solar
equipe	tripulação
cordeiro	ovis
sócio	sócios
agente	polícia/lei
consumidor	relação_de_negócios
máquina	trem/locomotivas/caminhos-de-ferro/comboio
criança	família
cidadão	população/povo/gente
eleitor	eleitorado
catedrático	corpo_docente
avião	frota
aliado	aliança/coligação/coalizão
ilha	arquipélago
mãe	família
inimigo	inimigo
guarda	polícia/lei
província	nação/país/terra
letra	alfabeto
lobo	canis
parente	tribo/familia/clã/família
espécie	gênero/género/gênero/gênero/género/gênero
leão	panthera
carro	trem/locomotivas/caminhos-de-ferro/comboio
princesa	família_real/família_real/família_real/família_real
esposo	casamento/casal
palmeira	palmeira/arecaceae
marido	casamento/casal
automóvel	trem/locomotivas/caminhos-de-ferro/comboio
esposa	casamento/casal
ônibus	frota
tom	escala_musical/escalas_musicais
gado	manada/grei/rebanho/gado/bos
indivíduo	pessoal/população/povo/gente
feminista	feminismo
júri	corte/tribunal_de_justiça/tribunal/juizado/corte/tribunal_de_justiça/tribunal/juizado
sus	seu/dela
rei	família_real/família_real
gente	espécie_humana/homem/povo/mundo/humanidade
cliente	relação_de_negócios
alguém	pessoal/população/povo/gente
parceiro	sócios
sol	sistema_solar/sistema_solar
comprador	relação_de_negócios
cavalo	equus
vegetal	plantae
pato	anatidae
palma	palmeira/arecaceae
elenco	companhia/pessoal/elenco
mito	mitologia/mitologia
alma	pessoal/população/povo/gente
menino	família
votante	eleitorado
príncipe	família_real/família_real/família_real/família_real/família_real/família_real
trem	trem/locomotivas/caminhos-de-ferro/comboio
árvore	mata/bosque/floresta
rainha	família_real/família_real
flora	plantae/biota/biologia
táxi	frota
planta	plantae
aeronave	frota
comboio	trem/locomotivas/caminhos-de-ferro/comboio
tripulação	tripulação
acompanhante	compromisso/hora_marcada
pomba	columbidae
planeta	sistema_solar
cônjuge	casamento/casal
vagão	trem/locomotivas/caminhos-de-ferro/comboio
peixe	cardume
lenda	mitologia/mitologia
ave	aves
cidadã	população/povo/gente
tigre	panthera
suíno	seu/dela
locomotiva	trem/locomotivas/caminhos-de-ferro/comboio
variante	espécie/espécie/espécies
noiva	boda/casamento
amante	seguidores
marte	sistema_solar
lírio	lírio
dente	dentama/dentição/dentadura
bode	capra/capra
pombo	columbidae
vegetação	biota/biologia
pássaro	aves
cão	matilha/canis
cachorro	matilha/canis
bovinos	manada/grei/rebanho/gado/bos
porco	seu/dela
inseto	nuvem/enxame
freguês	relação_de_negócios
equipagem	tripulação
coruja	strigiformes/coruja
pimenta-do-reino	piper
cepa	espécie/espécie/espécies
caracter	alfabeto
batata	solanum
vagões	trem/locomotivas/caminhos-de-ferro/comboio
ovelha	manada/grei/rebanho/gado/rebanho/ovis
onça	panthera
genitor	família
director	comité/junta/comitê/conselho
consorte	casamento/casal
abelha	apoidea
águia	accipitridae/accipitridae
taxi	frota
progenitor	família
ovinos	manada/grei/rebanho/gado/rebanho/ovis
nebulosa	universo/cosmo/criação/mundo
loba	canis
galáxia	universo/cosmo/criação/mundo
estirpe	espécie/espécie/espécies
eleitores	eleitorado
corujão	strigiformes/coruja
constituintes	eleitorado
cabra	capra
bezerro	vacas/bovinos/gado_bovino/gado