ano	década/decênio
dia	semana/dia
segundo	min/minuto
mês	ano
empresa	mercado
setor	sistema_econômico/economia/sociedade
função	programa_de_computador/programa_de_computador/programa
período	ano/duração_de_uma_vida/vida
parte	unidade/vegetal/planta/flora/todo/unidade
lei	lei/jurisprudência/ciências_jurídicas/teoria
costa	elevação
base	estrutura/tecido/edifício
tempo	ano/esporte
comércio	mercado
turno	tempo/turno/jogo/rodada/esporte
época	duração_de_uma_vida/vida
hora	dia
carta	correio
tarde	dia
artigo	shopping/centros_comerciais/shopping_center
luta	guerra
década	século/século/centúria/séculos
classe	sociedade
ciência	ciência
pessoa	indivíduo/pessoa/alguém/ser_humano/alma
linha	missiva/carta
terra	terra/mundo/globo_terrestre
combate	guerra
possibilidade	teoria
caráter	personalidade/temperamento/pessoa
transporte	comércio/mercantilismo/comercialismo
golpe	batalha/pugna/peleja/luta/disputa/combate
seção	todo/unidade
texto	publicação/edição
idade	duração_de_uma_vida/vida
campo	arena/estádio
produto	shopping/centros_comerciais/shopping_center
arma	equipamento_militar/arma/armamento/munição
conclusão	discurso
negócio	mercado
corpo	estrutura_organica/corpo/corpo_humano
intenção	programa
jogo	tempo/turno/jogo/rodada/esporte
manhã	jornada/dia
qualidade	natureza
quarto	edifício/prédio
jornada	dia
semana	mês/semana
item	lista/listagem/lista_numerada
meta	programa
ala	anjo/hemípteros/inseto/insetos/insecto/insectos/pássaro/ave
radical	molécula
teto	edifício/prédio
alvo	programa
água	superfície/infraestructura/infraestrutura/infra-estrutura
natureza	personalidade/temperamento/pessoa
noite	dia
face	cabeça/humano/ser_humano/besta/criatura/ser/bicho/animal
metade	tempo/turno/jogo/rodada/jogo_de_futebol/futebol
evento	episódio
personalidade	personalidade/temperamento/pessoa/indivíduo/pessoa/alguém/ser_humano/alma
manobra	esporte
segmento	todo/unidade
cabo	brocha/escova_de_dentes/pincel/escova
característica	natureza
incidente	episódio
etapa	jornada/viagem
hipótese	teoria
estação	ano
cadeia	molécula
domínio	nação/país/terra
passado	vida
gráfico	publicação/edição
batalha	guerra
armamento	equipamento_militar/arma/armamento/munição
arte	publicação/edição
teoria	teoria
parque	zona_urbana/áreas_urbanas/área_urbana/região_urbana
língua	faringe/garganta/boca
banda	corpo/tronco/torso
minuto	hora
seio	corpo/tronco/torso/vertebrado
componente	totalidade
mercadoria	shopping/centros_comerciais/shopping_center
solo	terra/mundo/globo_terrestre
cabeça	estrutura_organica/corpo/corpo_humano/besta/criatura/ser/bicho/animal
anexo	edifício/prédio
sala	edifício/prédio
expedição	comércio/mercantilismo/comercialismo
leis	lei/jurisprudência/ciências_jurídicas
hemisfério	terra/mundo/globo_terrestre
estrela	universo/cosmo/criação/mundo
biblioteca	edifício_residencial/habitação/casa/vivenda
medicamento	tratamento
andar	edifício/prédio
remédio	tratamento
relevo	terra/mundo/globo_terrestre
pé	estrutura/tecido/edifício
traço	cara/rosto/face
feição	personalidade/temperamento/pessoa
s	min/minuto
vegetal	erva
desenho	publicação/edição
célula	ser/organismo
sintoma	doenças/doença
piso	quarto/aposento/sala/edifício/prédio
canto	edifício/prédio
parada	jornada/viagem
subida	elevação
rodada	esporte
índole	personalidade/temperamento/pessoa
janela	auto/veículo/carro/automóvel/viatura/edifício/prédio
boca	cara/rosto/face/boca
rosto	cabeça/humano/ser_humano/besta/criatura/ser/bicho/animal
céu	terra/mundo/globo_terrestre
chapéu	fungos/fungo
anatomia	ser/organismo
tronco	corpo/tronco/torso/estrutura_organica/corpo/corpo_humano
orquestra	teatro/casa
decênio	século/século/centúria/séculos
vidro	copo
perna	estrutura_organica/corpo/corpo_humano
parede	quarto/aposento/sala/edifício/prédio
ilustração	publicação/edição
vão	superfície
arco	ponte/ponte
alicerce	estrutura/tecido/edifício
cara	cabeça/humano/ser_humano/besta/criatura/ser/bicho/animal
temperamento	indivíduo/pessoa/alguém/ser_humano/alma
suposição	teoria
peculiaridade	personalidade/temperamento/pessoa
muro	quarto/aposento/sala/edifício/prédio
meio-dia	dia
tomo	unidade
ladeira	elevação
peito	seio/peito/corpo/tronco/torso/vertebrado
pedaço	unidade
cozinha	aposento/habitação/moradia/residência/casa/lar/morada/domicílio
bolso	artigo_de_vestuário/roupa/vestuário
ombro	corpo/tronco/torso
buraco	agulha
terapia	tratamento
porção	unidade/repasto/refeição/todo/unidade
dígito	vertebrado
asa	anjo/edifício/prédio/hemípteros/inseto/insetos/insecto/insectos/pássaro/ave
aposento	edifício/prédio
testa	cara/rosto/face
chão	terra/mundo/globo_terrestre/quarto/aposento/sala
casca	ovo
ingrediente	prato
estômago	corpo/tronco/torso
aquecimento	edifício/prédio
ventre	corpo/tronco/torso
industria	mercado
dedo	vertebrado
colo	seio/peito
colarinho	colarinho/artigo_de_vestuário/roupa/vestuário
astro	universo/cosmo/criação/mundo
pavimento	quarto/aposento/sala/edifício/prédio
nuvem	céu
louça	mesa
gramado	arena/estádio
estrato	sociedade
curva	caminho/rodovia/via/estrada
costas	corpo/tronco/torso
min	hora
encosta	elevação
átomo	molécula/elemento_químico/elemento_químico
verdura	erva
joelho	perna
colchão	leito/cama
barriga	corpo/tronco/torso
têmpora	cabeça
telhado	edifício/prédio
secção	unidade
recanto	edifício/prédio
prato	repasto/refeição/repasto/refeição
muralha	quarto/aposento/sala/edifício/prédio
missiva	correio
mento	cara/rosto/face
melodia	missiva/carta
fragmento	vegetal/planta/flora
esqueleto	esqueleto/sistema_esquelético
canela	perna
anca	corpo/tronco/torso
alça	brocha/escova_de_dentes/pincel/escova
abdome	corpo/tronco/torso
tórax	seio/peito
traseiro	corpo/tronco/torso/corpo/tronco/torso/vertebrado
sílaba	vocábulo/termo/verbo/palavra
sulco	pele/pele
rincão	edifício/prédio
rabo	corpo/tronco/torso/vertebrado
porrada	batalha/pugna/peleja/luta/disputa/combate
lombo	humano/ser_humano
legume	erva
hortaliça	erva
cauda	vertebrado
casco	ungulados/ungulados
banheiro	aposento/habitação/moradia/residência/casa/lar/morada/domicílio