ser	cabeça
dia	hora/fim_de_tarde/noitada/tarde/noite
rio	cachoeira/cascata/catarata/queda_de_água/queda_d'água
mês	semana
curso	conferência/lição/aula
jornal	tiras_diárias/tira_diária/banda_desenhada/tiras_de_banda_desenhada/manchete
escola	sala_de_aula/classe
ação	ação
cadeira	pé
ato	cena
arena	campo/gramado
comércio	expedição/transporte/transportação
colégio	sala_de_aula/classe
hora	min/minuto
agricultura	colheita
carta	linha/melodia
tarde	crepúsculo/pôr_do_sol/anoitecer/meia_noite/meia-noite
luta	porrada/golpe
década	ano
departamento	sala_de_aula/classe
produção	plano
discurso	conclusão/introdução
sociedade	classe_social/classe/estrato
disputa	porrada/golpe
mercado	estante/prateleira
pessoa	corpo_humano/corpo/carne/anatomia/personalidade/temperamento/pessoa/peculiaridade/feição
terra	céu/relevo_(geografia)/chão/terra_firme/terra/relevo/solo/hemisfério
combate	porrada/golpe
casa	estudio/escritório/mansarda/ático/trapeira/sótão/cozinha/dormitório/quarto/casa_de_banho/banheiro/quarto_de_banho/sala_de_banho
história	idade/era/época/período
rádio	rádio
conta	balanço
texto	passagem/parágrafo/alínea/capítulo
campo	prado/pasto/pastagem
televisão	tv/televisão/tevê/televisor
edição	cartoon/caricatura/texto
histórico	idade/era/época/período
arma	tubo
folha	tiras_diárias/tira_diária/banda_desenhada/tiras_de_banda_desenhada/manchete
corpo	braço/traseiro/rabo/bumbum/popô/bunda/ânus/nádegas/ventre/abdome/estômago/barriga/abdómen/tronco/abdômen/anca/quadril/talhe/tronco/barriga/cintura/seio/peito/corpo/tronco/torso/ombro/pescoço/cabeça
mesa	caixa/gaveta
usina	linha_de_montagem/linha_de_produção
mão	dedo/dedo_da_mão
estrada	acostamento/berma/encruzilhada/cruzamento/curva
mundo	céu/relevo_(geografia)/chão/terra_firme/terra/relevo/solo/hemisfério
correio	missiva/carta
publicação	cartoon/caricatura/texto
quarto	muralha/parede/muro/chão/piso/assoalho/pavimento/teto/leito/cama
humano	cara/rosto/face/pata/mão/braço/pé/corpo_humano/corpo/carne/anatomia
julgamento	processo_criminal/processo
véspera	crepúsculo/pôr_do_sol/anoitecer
doença	síndroma/síndrome/sintoma
via	acostamento/berma/encruzilhada/cruzamento/curva
moeda	coroa/cara
hospital	sala/sala_de_estar
residência	cozinha/dormitório/quarto/casa_de_banho/banheiro/quarto_de_banho/sala_de_banho
caminho	acostamento/berma/encruzilhada/cruzamento/curva
caixa	fechadura/tampa/base
bicho	cabeça
fábrica	linha_de_montagem/linha_de_produção
palavra	sílaba
natureza	qualidade/característica
noite	crepúsculo/pôr_do_sol/anoitecer/meia_noite/meia-noite
termo	sílaba
face	bochecha/testa/traço/mento/chinchilla/queixo/nariz/olfato/sobrancelha/supercílio/sobrolho/sobrancelha/óculo/olho/barba
página	margem
século	década/decênio/década/decênio
personalidade	peculiaridade/feição
prédio	muralha/parede/muro/escada/escadaria/quarto/aposento/sala/telhado/teto/aquecimento/calefação/calefacção/centrais_de_aquecimento/pavimento/piso/andar/ascensor/elevador/jardim_interno/pátio/antessala/átrio/vestíbulo/sala/antecâmara/saguão/anexo/asa
periódico	tiras_diárias/tira_diária/banda_desenhada/tiras_de_banda_desenhada/manchete
avião	asa/ala/camarote/pedal_do_acelerador/acelerador
contabilidade	balanço
rodovia	acostamento/berma/encruzilhada/cruzamento/curva
habitação	estudio/escritório/mansarda/ático/trapeira/sótão/cozinha/dormitório/quarto/casa_de_banho/banheiro/quarto_de_banho/sala_de_banho
veículo	mala/bagageira/porta-malas/porta-bagagem/buzina/pedal_do_acelerador/acelerador
pecuária	colheita
mina	poço/chaminé
gráfico	curvas/curva
ramo	casca/súber
batalha	porrada/golpe
divisa	coroa/cara
aula	conferência/lição/aula
ponte	pilar_de_ponte
peça	coroa/cara
teatro	ato
edifício	muralha/parede/muro/escada/escadaria/quarto/aposento/sala/telhado/teto/aquecimento/calefação/calefacção/centrais_de_aquecimento/pavimento/piso/andar/ascensor/elevador/jardim_interno/pátio/antessala/átrio/vestíbulo/sala/antecâmara/saguão/anexo/asa
carro	mala/bagageira/porta-malas/porta-bagagem/buzina/pedal_do_acelerador/acelerador
porta	fechadura/fechadura
feira	estante/prateleira
secretária	caixa/gaveta
automóvel	mala/bagageira/porta-malas/porta-bagagem/buzina/pedal_do_acelerador/acelerador
cinema	plano
assento	pé
marketing	anúncio/propaganda/publicidade/promoção/anúncio/propaganda/publicidade/promoção
minuto	sec/segundo/s
correspondência	missiva/carta
gado	bife/carne_de_vaca/carne
filme	plano
indivíduo	corpo_humano/corpo/carne/anatomia/personalidade/temperamento/pessoa
cabeça	têmpora/cara/rosto/face/crânio/crânio/crâneo/caveira/encéfalo/cérebro/encéfalo/orelha
sala	muralha/parede/muro/chão/piso/assoalho/pavimento/teto
estádio	campo/gramado
prata	coroa/cara
braço	pulso/carpo/punho/cotovelo/pata/mão
alguém	corpo_humano/corpo/carne/anatomia/personalidade/temperamento/pessoa
animal	cabeça
cultivo	colheita
túnel	poço/chaminé
olho	pálpebra
pé	polegada/alfândega/calcanhar/dedo_do_pé/artelho/dedo
roubo	participação_nos_lucros
moradia	cozinha/dormitório/quarto/casa_de_banho/banheiro/quarto_de_banho/sala_de_banho
domicílio	cozinha/dormitório/quarto/casa_de_banho/banheiro/quarto_de_banho/sala_de_banho
saque	participação_nos_lucros
escolas	sala_de_aula/classe
raíz	casca/súber
computador	memória/placa_de_memória/hardware/circuito_integrado/microchip/ci/chip
salão	muralha/parede/muro/chão/piso/assoalho/pavimento/teto
alma	corpo_humano/corpo/carne/anatomia/personalidade/temperamento/pessoa
supermercado	estante/prateleira
raiz	casca/súber
bar	bar
auto	mala/bagageira/porta-malas/porta-bagagem/buzina/pedal_do_acelerador/acelerador
boca	língua
rosto	bochecha/testa/traço/mento/chinchilla/queixo/nariz/olfato/sobrancelha/supercílio/sobrolho/sobrancelha/óculo/olho/barba
lar	cozinha/dormitório/quarto/casa_de_banho/banheiro/quarto_de_banho/sala_de_banho
céu	arco-íris/nuvem
drama	ato
aeronave	camarote
tronco	traseiro/rabo/bumbum/popô/bunda/ânus/nádegas/ventre/abdome/estômago/barriga/abdómen/tronco/abdômen/anca/quadril/talhe/tronco/barriga/cintura/seio/peito/ombro/barriga/intestino/intestinos
decênio	ano
parede	arco
doenças	síndroma/síndrome/sintoma
convento	cela
verbo	sílaba
espada	ponta/pico/lâmina/lâmina
escada	degrau
escadaria	degrau
cara	bochecha/testa/traço/mento/chinchilla/queixo/nariz/olfato/sobrancelha/supercílio/sobrolho/sobrancelha/óculo/olho/barba
temperamento	peculiaridade/feição
revólver	tubo
muro	arco
manufatura	linha_de_montagem/linha_de_produção
vocábulo	sílaba
balé	ato
ave	ala/asa/pluma/plumagem/pena/bico
refeição	porção/prato
portão	fechadura/fechadura
bicicleta	corrente/cadeia
shopping	mercadoria/artigo/produto
pele	ruga/sulco/ruga/sulco/sarda/lentigem/sardas/sarda/lentigem/sardas
mosteiro	cela
espólio	participação_nos_lucros
viatura	mala/bagageira/porta-malas/porta-bagagem/buzina/pedal_do_acelerador/acelerador
aposento	muralha/parede/muro/cozinha/chão/piso/assoalho/pavimento/teto/dormitório/quarto/casa_de_banho/banheiro/quarto_de_banho/sala_de_banho
gaveta	fechadura
bode	corno/chifre/corno/chifre
saguão	muralha/parede/muro/chão/piso/assoalho/pavimento/teto
estômago	barriga/intestino/intestinos
enfermaria	sala/sala_de_estar
anoitecer	crepúsculo/pôr_do_sol/anoitecer
ventre	barriga/intestino/intestinos
faca	lâmina/lâmina
séculos	década/decênio
pássaro	ala/asa/pluma/plumagem/pena/bico
morada	cozinha/dormitório/quarto/casa_de_banho/banheiro/quarto_de_banho/sala_de_banho
garrafa	tampa
bovinos	bife/carne_de_vaca/carne
anjo	ala/asa
ópera	ato
vaso	rebordo/base
min	sec/segundo/s
lápis	ponta/pico
inseto	ala/asa
criatura	cabeça
centúria	década/decênio
rapina	participação_nos_lucros
pescoço	faringe/garganta
lâmpada	base
barriga	barriga/intestino/intestinos
tampa	fechadura
sacolão	estante/prateleira
prato	molho
película	plano
ovo	casca/casca_de_ovo/casca_do_ovo
muralha	arco
missiva	linha/melodia
mercantilismo	expedição/transporte/transportação
mercadologia	anúncio/propaganda/publicidade/promoção
lauda	margem
garganta	língua
empório	estante/prateleira
cômoda	estante/prateleira/caixa/gaveta
crânio	mandíbula/mandíbula
botequim	bar
barril	arco/arco
abdome	barriga/intestino/intestinos
vivenda	estudio/escritório/mansarda/ático/trapeira/sótão
tevê	tv/televisão/tevê/televisor
quitanda	estante/prateleira
pugna	porrada/golpe
portas	fechadura
pilhagem	participação_nos_lucros
galho	casca/súber/casca/súber
fim-de-semana	domingo
escudeiro	margem
caveira	mandíbula
cabra	corno/chifre
besta	cabeça
banheiro	banheira
armário	estante/prateleira