partir	partir/dividir/separar
dar	ter
apresentar	olhar/ver/enxergar
concluir	parar/terminar/finalizar/cessar/encerrar/acabar
organizar	encontrar/reunir
dirigir	fazer/agir/atuar
provocar	acontecer/ocorrer/suceder/passar
abrir	abrir
colocar	jazer/estar_deitado
prender	fixar/aferrolhar
encerrar	parar/terminar/finalizar/cessar/encerrar/acabar
parecer	sentir/experimentar
viajar	viajar/ir/caminhar/andar
entregar	ter
mudar	alterar/mudar
mostrar	olhar/ver/enxergar
reduzir	encolher/contrair-se/murchar/contrair
fixar	fixar/aferrolhar
terminar	parar/terminar/finalizar/cessar/encerrar/acabar
obrigar	fazer/agir/atuar/fazer/agir/atuar
alterar	alterar/mudar
pôr	jazer/estar_deitado/sentar/sentar-se/estar_sentado
lecionar	adquirir/aprender
conduzir	fazer/agir/atuar
fechar	fechar
dividir	partir/dividir/separar
completar	encher
produzir	acontecer/ocorrer/suceder/passar
unir	unir/juntar/juntar/grudar
elevar	ascender/subir/alegrar-se/regozijar-se/regozijar/alegrar
sentar	sentar/sentar-se/estar_sentado
fortalecer	consolidar
efetuar	acontecer/ocorrer/suceder/passar
modificar	alterar/mudar
derrubar	descer/baixar/cair
baixar	descer/baixar/cair
levantar	ascender/subir/levantar/ficar_de_pé
mover	deslocar/mexer/mover
deslocar	deslocar/mexer/mover
forçar	fazer/agir/atuar/fazer/agir/atuar
ferir	doer
diminuir	encolher/contrair-se/murchar/contrair
matar	expirar/morrer/bater_as_botas/falecer/comer_capim_pela_raiz/perecer
afetar	sentir/experimentar
juntar	unir/juntar/juntar/grudar
enfraquecer	enfraquecer
melhorar	melhorar
desagradar	desgostar/não_gostar/antipatizar
destruir	destruir/quebrar
ocasionar	acontecer/ocorrer/suceder/passar
separar	partir/dividir/separar
esvaziar	esvaziar
aperfeiçoar	melhorar
ensinar	adquirir/aprender
instruir	adquirir/aprender
cerrar	fechar
abater	descer/baixar/cair
finalizar	parar/terminar/finalizar/cessar/encerrar/acabar
erguer	ascender/subir/levantar/ficar_de_pé
virar	virar/derrubar
animar	animar-se/alegrar-se/animar/alegrar
alçar	ascender/subir
encorajar	esperar/aguardar/esperançar
impressionar	sentir/experimentar
assustar	temer/ter_medo_de/recear/apavorar
intimidar	temer/ter_medo_de/recear/apavorar
anexar	juntar/grudar
rebaixar	descer/baixar/cair
afundar	afundar/naufragar
endurecer	endurecer/inrijecer
arruinar	destruir/quebrar
fortificar	consolidar
coagir	fazer/agir/atuar
afrouxar	sossegar
encher	encher
compelir	fazer/agir/atuar/fazer/agir/atuar
acoplar	unir/juntar
aquecer	acalorar/esquentar/aquecer
alongar	alongar/esticar
atemorizar	temer/ter_medo_de/recear/apavorar
submergir	afundar/naufragar
soar	soar/ressoar/fazer
esfriar	esfriar-se/arrefecer/esfriar/refrescar/resfriar
desgostar	desgostar/não_gostar/antipatizar
deitar	jazer/estar_deitado
aterrorizar	temer/ter_medo_de/recear/apavorar
amedrontar	temer/ter_medo_de/recear/apavorar
alentar	esperar/aguardar/esperançar/animar-se/alegrar-se/animar/alegrar
verter	manar/fluir/correr
posar	sentar/sentar-se/estar_sentado
exaurir	fatigar
esquentar	acalorar/esquentar/aquecer
enxugar	secar
derramar	manar/fluir/correr
refrescar	esfriar-se/arrefecer/esfriar/refrescar/resfriar
machucar	doer/sofrer
irar	irritar_se/zangar_se/enraivecer
extender	esticar
enrijecer	endurecer/inrijecer
doer	doer/sofrer
angustiar	sofrer
zangar	irritar_se/zangar_se/enraivecer
tensionar	ficar_tenso
secar	secar
refrigerar	esfriar-se/arrefecer/esfriar/refrescar/resfriar
pendurar	pendurar
gelar	congelar
estressar	ficar_tenso
esticar	esticar
enraivecer	irritar_se/zangar_se/enraivecer
comover	sentir/experimentar
alegrar	animar-se/alegrar-se/animar/alegrar
abalroar	afundar/naufragar