fazer	arte_dramatica/dramaturgia/teatro/comércio/mercantilismo/comercialismo/cultivo/pecuária/agricultura
realizar	música/comércio/mercantilismo/comercialismo
integrar	ciência_exacta/matematica/matemática/ciências_exactas
obter	comércio/mercantilismo/comercialismo
filiar	lei/jurisprudência/ciências_jurídicas
atuar	arte_dramatica/dramaturgia/teatro/arte_dramatica/dramaturgia/teatro
trabalhar	cultivo/pecuária/agricultura
representar	arte_dramatica/dramaturgia/teatro/arte/arte/arte
ligar	quimica/química/cirurgia
marcar	jogo_de_futebol/futebol
ver	psicologia/psicólogos_por_nacionalidade
compor	música
entrar	arte_dramatica/dramaturgia/teatro
incluir	quimica/química
desenvolver	ciência_exacta/matematica/matemática/ciências_exactas
atingir	comércio/mercantilismo/comercialismo
prender	lei/jurisprudência/ciências_jurídicas
escrever	música
transformar	ciências_físicas/fisica/física/física/quimica/química
aumentar	fotografia
recusar	lei/jurisprudência/ciências_jurídicas
condenar	lei/jurisprudência/ciências_jurídicas/lei/jurisprudência/ciências_jurídicas
entregar	lei/jurisprudência/ciências_jurídicas
mostrar	lei/jurisprudência/ciências_jurídicas
reduzir	ciência_exacta/matematica/matemática/ciências_exactas
aliar	quimica/química
apurar	quimica/química
suspender	quimica/química
oferecer	hasta/leilão/almoeda/arrematação
revelar	fotografia
pôr	música
controlar	disciplina_cientifica/ciência
negociar	comércio/mercantilismo/comercialismo
dividir	ciências_físicas/fisica/física/física/quimica/química/quimica/química
pagar	crime/ofensa
submeter	lei/jurisprudência/ciências_jurídicas
completar	jogo_de_futebol/futebol
produzir	cultivo/pecuária/agricultura
adquirir	comércio/mercantilismo/comercialismo/comércio/mercantilismo/comercialismo
registrar	lei/jurisprudência/ciências_jurídicas
analisar	gramática
concordar	gramática
distribuir	esporte
vender	comércio/mercantilismo/comercialismo/comércio/mercantilismo/comercialismo/crime/ofensa
preferir	lei/jurisprudência/ciências_jurídicas
modificar	gramática
operar	remédio/prática_da_medicina/medicina/incisão/medicina
aparecer	arte_dramatica/dramaturgia/teatro
baixar	música
comprar	comércio/mercantilismo/comercialismo/comércio/mercantilismo/comercialismo
acrescentar	vegetal/planta/flora
empenhar	comércio/mercantilismo/comercialismo
formular	quimica/química
contestar	lei/jurisprudência/ciências_jurídicas
acreditar	crença_religiosa/fé/religião
verificar	lei/jurisprudência/ciências_jurídicas/disciplina_cientifica/ciência
figurar	arte
pleitear	lei/jurisprudência/ciências_jurídicas
misturar	quimica/química
liberar	quimica/química
reagir	quimica/química
qualificar	gramática
libertar	quimica/química
advogar	lei/jurisprudência/ciências_jurídicas
administrar	remédio/prática_da_medicina/medicina/incisão/medicina
expor	fotografia
explorar	remédio/prática_da_medicina/medicina/incisão/medicina
isolar	psicologia/psicólogos_por_nacionalidade/quimica/química
projetar	psicologia/psicólogos_por_nacionalidade
importar	informática/ciência_da_computação/comércio/mercantilismo/comercialismo
cair	música
render	fundos_de_investimento/investimento
dispensar	remédio/prática_da_medicina/medicina/incisão/medicina
converter	quimica/química
privilegiar	comércio/mercantilismo/comercialismo
quebrar	quimica/química/quimica/química
absorver	quimica/química
evidenciar	lei/jurisprudência/ciências_jurídicas
correr	esporte/esporte
bater	música/beisebol/basebol
anistiar	lei/jurisprudência/ciências_jurídicas
espalhar	cultivo/pecuária/agricultura
provar	lei/jurisprudência/ciências_jurídicas/ciência_exacta/matematica/matemática/ciências_exactas/disciplina_cientifica/ciência
apelar	lei/jurisprudência/ciências_jurídicas
tramitar	comércio/mercantilismo/comercialismo
diferenciar	ciência_exacta/matematica/matemática/ciências_exactas
atenuar	lei/jurisprudência/ciências_jurídicas
privatizar	industria/comércio/negócio/empresa/indústria/manufatura
caminhar	esporte/esporte
gravar	película/filme/produção/cinema/informática/ciência_da_computação/arte
subir	esporte
delinear	arte
programar	informática/ciência_da_computação
livrar	quimica/química
liquidar	comércio/mercantilismo/comercialismo
calcular	ciência_exacta/matematica/matemática/ciências_exactas
exportar	informática/ciência_da_computação/comércio/mercantilismo/comercialismo
salvar	informática/ciência_da_computação
atestar	lei/jurisprudência/ciências_jurídicas
andar	esporte
instruir	lei/jurisprudência/ciências_jurídicas
polarizar	ciências_físicas/fisica/física/física
intermediar	comércio/mercantilismo/comercialismo
protocolar	lei/jurisprudência/ciências_jurídicas
versar	poema/verso/poesia
congelar	ciências_físicas/fisica/física/física
seqüestrar	crime/ofensa/crime/ofensa
aprisionar	lei/jurisprudência/ciências_jurídicas
saldar	comércio/mercantilismo/comercialismo
induzir	ciências_físicas/fisica/física/física
renegociar	contrato/acordo
aliviar	psicanálise
resgatar	crime/ofensa
endereçar	informática/ciência_da_computação
tocar	música/música
cultivar	cultivo/pecuária/agricultura/cultivo/pecuária/agricultura/vegetal/planta/flora
racionalizar	ciência_exacta/matematica/matemática/ciências_exactas
soltar	quimica/química
roubar	crime/ofensa/crime/ofensa/beisebol/basebol
reconsiderar	legislação
capturar	beisebol/basebol
ilustrar	arte
debilitar	quimica/química
crer	crença_religiosa/fé/religião
protagonizar	arte_dramatica/dramaturgia/teatro
comercializar	comércio/mercantilismo/comercialismo
propagar	vegetal/planta/flora
capacitar	lei/jurisprudência/ciências_jurídicas
sanar	remédio/prática_da_medicina/medicina/incisão/medicina
abastecer	comércio/mercantilismo/comercialismo
naturalizar	vegetal/planta/flora
plantar	cultivo/pecuária/agricultura/cultivo/pecuária/agricultura
extrair	quimica/química
alfabetizar	linguagem/discurso/idioma/língua
retratar	arte
harmonizar	música
subornar	crime/ofensa/crime/ofensa
extrapolar	ciência_exacta/matematica/matemática/ciências_exactas
desenhar	arte
convergir	ciência_exacta/matematica/matemática/ciências_exactas
encarcerar	lei/jurisprudência/ciências_jurídicas
cristalizar	ciências_físicas/fisica/física/física
armazenar	comércio/mercantilismo/comercialismo
sequestrar	quimica/química/crime/ofensa/crime/ofensa
leiloar	comércio/mercantilismo/comercialismo
voar	aeroplano/aeronave/avião
inibir	quimica/química
diagnosticar	remédio/prática_da_medicina/medicina/incisão/medicina
pintar	arte/arte
computar	ciência_exacta/matematica/matemática/ciências_exactas
testemunhar	lei/jurisprudência/ciências_jurídicas/lei/jurisprudência/ciências_jurídicas
escalar	esporte
dissociar	quimica/química
solidificar	ciências_físicas/fisica/física/física/ciências_físicas/fisica/física/física
perdoar	lei/jurisprudência/ciências_jurídicas
lavrar	cultivo/pecuária/agricultura/cultivo/pecuária/agricultura
fotografar	fotografia
truncar	ciência_exacta/matematica/matemática/ciências_exactas
convencionar	arte
revender	comércio/mercantilismo/comercialismo
estocar	comércio/mercantilismo/comercialismo
acessar	informática/ciência_da_computação
injetar	remédio/prática_da_medicina/medicina/incisão/medicina
imitar	informática/ciência_da_computação
extorquir	crime/ofensa
contrabandear	comércio/mercantilismo/comercialismo/crime/ofensa
sentenciar	lei/jurisprudência/ciências_jurídicas
pilotar	aeroplano/aeronave/avião
modelar	arte
limpar	informática/ciência_da_computação/quimica/química
filmar	película/filme/produção/cinema
arbitrar	esporte
apanhar	beisebol/basebol
republicar	lei/jurisprudência/ciências_jurídicas
potencializar	medicamento/produtos_farmacêuticos/remédio/droga/entorpecente
mitigar	lei/jurisprudência/ciências_jurídicas
mapear	informática/ciência_da_computação
decair	ciências_físicas/fisica/física/física
adorar	crença_religiosa/fé/religião
semear	cultivo/pecuária/agricultura/cultivo/pecuária/agricultura
iluminar	arte
eletrificar	ciências_físicas/fisica/física/física
corromper	crime/ofensa
remediar	lei/jurisprudência/ciências_jurídicas/remédio/prática_da_medicina/medicina/incisão/medicina
licitar	comércio/mercantilismo/comercialismo
interiorizar	psicologia/psicólogos_por_nacionalidade
desintegrar	ciências_físicas/fisica/física/física
curar	remédio/prática_da_medicina/medicina/incisão/medicina/remédio/prática_da_medicina/medicina/incisão/medicina
sincronizar	película/filme/produção/cinema
estrelar	arte_dramatica/dramaturgia/teatro
digitalizar	remédio/prática_da_medicina/medicina/incisão/medicina
comerciar	comércio/mercantilismo/comercialismo
chutar	esporte/jogo_de_futebol/futebol
chantagear	crime/ofensa
vacinar	remédio/prática_da_medicina/medicina/incisão/medicina
transacionar	comércio/mercantilismo/comercialismo
saturar	quimica/química
posar	arte
passear	esporte
internalizar	psicologia/psicólogos_por_nacionalidade
extirpar	cirurgia
driblar	esporte
destilar	quimica/química/quimica/química/quimica/química
catalisar	quimica/química
amoldar	arte
transladar	ciências_físicas/fisica/física/física
traficar	comércio/mercantilismo/comercialismo/crime/ofensa
sangrar	remédio/prática_da_medicina/medicina/incisão/medicina
rascunhar	arte
purificar	quimica/química/quimica/química
manejar	gado/pecuária/animais_domésticos
inocular	remédio/prática_da_medicina/medicina/incisão/medicina
domesticar	vegetal/planta/flora/besta/criatura/ser/bicho/animal/besta/criatura/ser/bicho/animal
decompor	gramática
rubricar	arte
rimar	poema/verso/poesia
remir	crime/ofensa
raptar	crime/ofensa/crime/ofensa
piratear	crime/ofensa
narcotizar	remédio/prática_da_medicina/medicina/incisão/medicina
medicar	remédio/prática_da_medicina/medicina/incisão/medicina/remédio/prática_da_medicina/medicina/incisão/medicina/remédio/prática_da_medicina/medicina/incisão/medicina
liquefazer	ciências_físicas/fisica/física/física
gelar	ciências_físicas/fisica/física/física
estilizar	moda/moda/arte
esquiar	esporte
escusar	lei/jurisprudência/ciências_jurídicas
encharcar	besta/criatura/ser/bicho/animal
eletrizar	ciências_físicas/fisica/física/física
dublar	película/filme/produção/cinema
domar	vegetal/planta/flora/besta/criatura/ser/bicho/animal
deslizar	esporte
desclassificar	esporte
arrumar	moda/moda
arar	cultivo/pecuária/agricultura/cultivo/pecuária/agricultura
amputar	remédio/prática_da_medicina/medicina/incisão/medicina
amanhar	cultivo/pecuária/agricultura