ser	verruga/olfato/nariz/lado/estrutura_organica/corpo/corpo_humano/humanidade/rede/armadilha/arapuca/microorganismo/microrganismo/rastreamento/rastreio/sacrificio/sacrifício
rio	orla/litoral/costa/canal/massa_de_água/água/corpo_de_água/confluência/curva
eleição	pluralidade/maioria_relativa/maioria_absoluta/maioria/pesquisa_de_opinião/contagem
empresa	meios_financeiros/parte/participante/sócio/capitalista/empresa/organização_empresarial/cadeia/setor_de_negócios/pessoas_de_negócios/cine/chinês/indústria_cinematográfica/cinema/astucidade/astúcia/sagacidade/estabelecimento/gestão/gerenciamento/administração/negócio
legislatura	sargento_de_armas
lei	limitação/bigamia/matrimônio/matrimónio/conúbio/casamento/casal/estado_civil/cidadania/situação_legal/registro/honorário/honorário_advocatício/herança/legado/herança/patrimônio/legado/testemunha/testemunho/uxor/curador/advogado/defensor_público/defensoria_pública/promotor/promotor_de_justiça/promotor_público/querelante/parte/técnico_jurídico/proprietário/dono/notário/tabelião/litigante/legislador/jurista/advogado/fazedor_de_leis/legislador/juiz_de_paz/jurisconsulto/jurista/advogado_de_defesa/cliente/constituinte/contratador/promotor/defensor/advogado/procurador-geral_da_república/procurador_geral_da_república/procurador-geral/promotor/advogado/procurador/acusado/réu/suspeito/argüido/domicílio/casa/legislação_tributaria/legislação_fiscal/legislação_financeira/leis/lei/código_militar/lei_militar/direito_militar/direito_mercantil/direito_comercial/direito_empresarial/lei_marcial/direito_comum/lei_suprema_do_país/direito_marítimo/direito_do_mar/direito_internacional/common_law/direito_consuetudinário/common_law/common-law/direito_civil/direito_romano-germânico/direito_administrativo/júri/suprema_corte_dos_estados_unidos_da_américa/federal_bureau_of_investigation/fbi/federal_bureau_of_investigation/departamento_de_justiça/justiça/justiça/judiciário/corpo_jurídico/alegação/aviso_legal/arbitragem/barra_lateral/questão_de_direito/obiter_dictum/álibi/declaração/testemunho_indireto/prova_indiciária/prova_indireta/evidência_circumstancial/evidência_indireta/evidência/testemunho/testemunha/depoimento/prova/conspiração/código_dos_estados_unidos_da_américa/código_dos_estados_unidos_da_américa/código_penal/código_jurídico/estatuo/estatuto/transação_penal/libelo/resposta_evasiva/alegação/multa/coima/citação/interdição/citação/intimação/intimação/mandato/execução/execução_de_instrumento/execução/mandado/perdão/anistia/juízo/carta-patente/licença/licenciamentos/mandado/contrato/feito_notável/ato/escritura_pública/ato_heróico/declaração_antecipada_de_vontade/codicilo/nota_de_suicídio/testamento/processo_cautelar/processo_cautelar/injunção/proibição/toque_de_recolher/acta/decreto/direito_criminal/direito_penal/bill_of_attainder/projecto_de_lei/legislação/direito_público/constituição_dos_estados_unidos/constituição_dos_estados_unidos_da_américa/constituição/prescrição/lei/leis/actos_legislativos/ato/mandato/procuração/debênture/cópia/passaporte/passaportes/letra_de_câmbio/derivativos/derivativo/documento_oficial/negócio_jurídico/nome_fantasia/preempção/jus_soli/jus_sanguinis/sistema_eleitoral/sistema_de_votação/sistemas_de_votação/sistemas_de_impostos/fiança/sistema_legal/distúrbio/incômodo/moléstia/pertubação/chateação/contrariedade/circunstância_atenuante/premeditação/dolo/presunção/jurisdição/usufruto/desapropriação/sufrágio/voto/direito_ao_voto/liberdade_de_reunião/liberdade_de_imprensa/liberdade_de_expressão/liberdade_de_expressão/liberdade_religiosa/situação_da_liberdade_religiosa_por_país/habeas_corpus/liberdades_civis/direitos_do_cidadão/direito/título/privilégio/servidão/direitos_humanos/vigor/vigência/recolheràgaragem/corte/tribunal/liberdade_condicional/condicional/liberdade_condicional/perdão/amnistia/indulto/anulação/condenação/divórcio/divorcio/processo_criminal/processo/julgamento/legitimação/legalização/condenação_por_estupro/condenação_por_homicídio/quitação/veredito/veredicto/opinião/sentença/julgamento/ditame/tutela_antecipada/tutela_antecipada/decisão_final/julgamento/sentença/litígio/bancarrota/falência/revogação/apelação/apelo/recurso/adoção/adoção/procedimento_legal/procedimento_legal/ação_popular/causa/processo/processo_judicial/pleito/ação_legal/processo_judicial/processo/causa/processo_legal/devido_processo_legal/contempt_of_court/desacato/encarceramento/execução_da_lei/legislação/rapto/sequestros/sequestro/seqüestro/seqüestro/abuso_sexual/abuso_sexual/delinquência_juvenil/delinqüência_juvenil/direito/advocacia/rescisão
acordo	contrato/aperto_de_mão/handshake/brecha/art./cláusula/artigo
indústria	indústria
comércio	meios_financeiros/parte/participante/sócio/capitalista/empresa/organização_empresarial/cadeia/setor_de_negócios/pessoas_de_negócios/cine/chinês/indústria_cinematográfica/cinema/astucidade/astúcia/sagacidade/estabelecimento/gestão/gerenciamento/administração/negócio
economia	risco_moral/oligopolio/oligopólio/monopsônio/monopólio/lei_da_utilidade_marginal/lei_da_utilidade_marginal/função_de_utilidade/consumo/conta_capital/teoria_dos_jogos/teoria_económica/lei_de_gresham/lei_de_gresham/produção
educação	ministério_de_educação_dos_eua/educação/ministerio_da_educação/ensino/educação/pedagogia
agricultura	cultivo
formação	ministério_de_educação_dos_eua/educação/ministerio_da_educação/ensino/educação/pedagogia
ensino	ministério_de_educação_dos_eua/educação/ministerio_da_educação/ensino/educação/pedagogia
discurso	idioma/linguagem/estilo/discurso/língua/acento/sotaque
ciência	teórico/ciência_exacta/matematica/matemática/ciências_exactas
marinha	marina
imposto	encargo/imposto/taxa/rendimento/renda/a_receber/coletor/recolhedor/cobrador
história	sarraceno/sarraceno/sarraceno/sarraceno/historiografo/historiador/cronista/historiografo/historiador/cronista/crónica/crônica/crónica/crônica/festa_do_chá_de_boston/festa_do_chá_de_boston/festa_do_chá_de_boston/festa_do_chá_de_boston
crescimento	isometria
solução	fluoresceina/fluoresceína/vermelho_congo/solubilidade/salinidade
engenharia	código-fonte/fonte/controlo_de_cheias/enchente
tecnologia	código-fonte/fonte/controlo_de_cheias/enchente
taxa	encargo/imposto/taxa/rendimento/renda/a_receber/coletor/recolhedor/cobrador
contrato	contrato/aperto_de_mão/handshake/brecha/art./cláusula/artigo
negócio	meios_financeiros/parte/participante/sócio/capitalista/empresa/organização_empresarial/cadeia/setor_de_negócios/pessoas_de_negócios/cine/chinês/indústria_cinematográfica/cinema/astucidade/astúcia/sagacidade/estabelecimento/gestão/gerenciamento/administração/negócio
usina	uptime/distribuição_de_gas/gás/distribuição_de_gás_natural/correia_transportadora/esteira_transportadora/circuito_fechado_de_televisão
jogo	tempo/turno/jogo/rodada/repetição/vez/jogo/jogo/jogada
informática	command_processing_overhead_time/tempo_de_rotação/bits_por_segundo/track_to_track_seek_time/tempo_de_posicionamento/tempo_de_busca/tempo_de_acesso/tempo_partilhado/capacidade_não_formatada/capacidade_formatada/partição/bloco/bit_de_paridade/paridade/baud/baud_rate/baud/velocidade_baud/armazenamento/operação/repetição/iteração/fragmentação/instrução_de_execução/execução/processamento_de_dados/programador/usuário_avançado/overhead_do_disco/еspaço_em_disco/crash_da_cabeça_do_dispositivo/travamento/crache/erro_em_tempo_de_execução/barra_de_título/ícone/linguagem_orientada_a_objectos/linguagem_orientada_à_objetos/linguagem_de_programação/domínio/dominio/fonte_de_ecrã/fonte_de_cartucho/sgml/protocolo_de_transferência_de_arquivos/ftp/protocolo_de_comunicação/protocolo/inicialização/formatação_de_baixo_nível/formatação_de_alto_nível/base_de_dados/instrução/instrução/utilitário/editor_de_texto/intérprete/interpretador/interface_do_utilizador/interface_do_utilizador/editor/controlador/driver_de_dispositivo/compilador/programa_de_computador/programa_de_computador/programa/sistema_operativo/sistema_operacional/pacote_de_software/software/programa/arquivo_de_texto/ficheiro_só_de_leitura/ficheiro_de_saída/ficheiro_de_dados_de_entrada/ficheiro_de_entrada/ficheiro_de_transacções/ficheiro_de_movimentos/ficheiro_em_disco/arquivo_principal/ficheiro_principal/ficheiro_mestre/arquivo_binário/arquivo_binário/arquivo_de_backup/ficheiro_de_segurança/ficheiro_de_backup/arquivo/ficheiro_do_computador/menu_hierárquico/menu/menu_do_computador/subdirectório/sub-directório/subdiretório/ficheiro/diretório/core_dump/firmware/ascii/ascii/endereço_do_computador/parâmetro/parâmetro/código/linha_de_comandos/e-mail/email/correio_electrónico/correio_eletrônico/vídeo/ontologia/lógica/teoria_da_informação/simulação/modelagem_computacional/simulação_por_computador/modelagem_computacional/emulador_de_terminal/interoperabilidade/bits_por_polegada/velocidade_de_execução/risc/risc/arquitectura/arquitetura_de_computadores/arquitetura/janela/janela/memória_virtual/memória_virtual/trilha/registrador_de_deslocamento/registrador_de_deslocamento/registo_de_deslocamento/servidor/descanso_de_tela/roteador/router/roteador/rotary_actuator/registrador/memória_rom/memória_somente_de_leitura/disco_ram/impressora/pixel/elemento_de_imagem/píxel/periférico/equipamento_periférico/servidor_de_arquivos_não_dedicado/cliente/disco_magnético/disco/caneta_óptica/porta/registo_de_índice/registrador_de_índice/hardware/firewall/firewall/servidor_de_arquivos/memória_eprom/eprom/dongle/placa_gráfica/hard-drive/controlador_de_disco/controladora_de_disco/chave_dip/caixa_de_diálogo/servidor_de_arquivos_dedicado/cursor/tecla_control/rede_de_computadores/rede_de_computadores/rede/circuito_do_computador/calculadora/computador/processador/ucp/cpu/unidade_central_de_processamento/cachê/cache_da_memória/cache/bbs/sistema_eletrônico_de_quadro_de_mensagens/buffer/cópia_de_segurança/becape/backup/registo_acumulador/editoração_electrónica/editoração_eletrônica
humano	sindactilia/polidactilia/lado/estrutura_organica/corpo/corpo_humano
bicho	verruga/olfato/nariz/lado/estrutura_organica/corpo/corpo_humano/humanidade/rede/armadilha/arapuca/microorganismo/microrganismo/rastreamento/rastreio/sacrificio/sacrifício
fábrica	uptime/distribuição_de_gas/gás/distribuição_de_gás_natural/correia_transportadora/esteira_transportadora/circuito_fechado_de_televisão
filosofia	filósofo/vitalismo/teleologia/estoicismo/solipsismo/sensacionalismo/sensualismo/semiótica/semiótica/relativismo/realismo/racionalismo/pragmatismo/platonismo/nominalismo/naturalismo/nativismo/mentalismo/materialismo/logicismo/idealismo/idealismo/formalismo/determinismo/existencialismo/existencialismo/empirismo/desconstrução/desconstrução/aristotelismo/aristotelismo/estética
instrução	ministério_de_educação_dos_eua/educação/ministerio_da_educação/ensino/educação/pedagogia
armada	marina
avião	titanio/titânio/desvio/piloto_de_aviao/piloto/passageiro/assento/cadeira/lugar/circum-navegação/circumnavegação
cirurgia	trombose_venosa/enxerto/ostomia/operação_cirúrgica/cirurgia/operação
veículo	tração/tracção/passageiro/túnel/mapa_rodoviário/alternador/aluguel/arrendamento/aluguel
pecuária	cultivo
teologia	teologia/predestinação/purgatório/teologia/salvação/redenção
literatura	redacção/redação/analepse/literatura/literatura/desconstrução/desconstrução/corcel/literatura
química	contraste/indicador/fluorocarbono/composto_químico/substância_química/catalisador/molécula/emulsão/fulereno/radical/grupo_químico/átomo/mistura/solução/misturas_químicas/radioactividade/estados_físicos_da_matéria/fases_da_matéria/estequiometria/osmose_inversa/osmose/eletrólise/electrólise/dissociação_química/dissociação_química/dissociação/reações_químicas/reação_química/reação_química/reacções_químicas/absorção/polimorfismo/químico/cadeia/tabela_periódica/tabela_periódica/tabela_periodica/química_orgânica/lei_de_ação_das_massas/lei_de_proust/lei_de_proust/lei_de_henry/lei_de_henry/lei_da_partição_de_nernst/lei_de_dalton/ph/ph/valência/valência_química/massa_atômica/massa_atomica/massa_atómica/peso_atômico/eletronegatividade
esporte	jogo/morte_súbita/agente_de_talentos/olheiro/agente/juiz/árbitro/técnico/treinador/cabine_de_imprensa/posse/falta/posição/tacada/lance/impedimento
tributo	encargo/imposto/taxa/rendimento/renda/a_receber/coletor/recolhedor/cobrador
lago	orla/litoral/costa/massa_de_água/água/corpo_de_água
arte	teórico/avaliador/exposição/exposições/linguagem/estilo/discurso/língua/cine/chinês/indústria_cinematográfica/cinema/estética/estética/belas_artes/belas-artes/arte
estatística	estatístico/actuário/atuário/estatístico/actuário/atuário/teoria_da_informação/teoria_da_informação/teoria_das_probabilidades/teoria_das_probabilidades/binómio_de_newton/binômio_de_newton/binómio_de_newton/binômio_de_newton/distribuição_de_bernoulli/distribuição_de_bernoulli/distribuição_de_bernoulli/distribuição_de_bernoulli/coeficiente_de_correlação_produto-momento/coeficiente_de_correlação_de_pearson/coeficiente_de_correlação_produto-momento/coeficiente_de_correlação_de_pearson/coeficiente_de_correlação/correlação/coeficiente_de_correlação/correlação/análise_de_variância/análise_de_variância/série_temporal/série_temporal/regressão_linear/regressão_linear/regressão/regressão/regressão/regressão/multicolinearidade/multicolinearidade/amostra_aleatória/amostra_aleatória/base_de_sondagem/base_de_sondagem/subpopulação/subpopulação/universo/universo/distribuição_de_poisson/distribuição_de_poisson/distribuição_de_poisson/distribuição_de_poisson/distribuição_normal/distribuição_normal/distribuição_normal/distribuição_normal/distribuição_de_frequências/distribuição_de_frequências/co-variância/covariância/co-variância/covariância/desvio_padrão/desvio-padrão/desvio_padrão/desvio_padrão/desvio-padrão/desvio_padrão/variância/variância/média_harmônica/média_harmónica/média_harmônica/média_harmónica/média_geométrica/média_geométrica/valor_esperado/média_aritmética/valor_esperado/média_aritmética/média/média/média/canteiro_central/mediana/média/canteiro_central/mediana/moda/moda/estatística_parametrica/estatística_parametrica/estatística_sem_distribuicao/estatística_nao_parametrica/estatística_sem_distribuicao/estatística_nao_parametrica/estatística_demografica/estatística_demografica/norma/média/norma/média/estatística/estatística/método_dos_mínimos_quadrados/método_dos_mínimos_quadrados/método_estatístico/procedimento_estatístico/método_estatístico/procedimento_estatístico/teorema_de_bayes/teorema_de_bayes/teorema_de_bayes/teorema_de_bayes/variável_dependente/variável_dependente/variável_independente/variável_independente/quartil/quartil/técnicas_de_amostragem/amostragem/técnicas_de_amostragem/amostragem
teatro	assento/cadeira/lugar/teatro/casa/circuito_fechado_de_televisão/anfiteatro
arquitetura	fenestração/pináculo/pilar/mísula/coluna/coluna/pilar/arquitetura/arquitectura/arco/arco
carro	tração/tracção/passageiro/túnel/mapa_rodoviário/alternador/aluguel/arrendamento/aluguel
música	batidas_por_minuto/andamento/valor_da_nota/tacto/musico/músico/músico/família_dos_violinos/vibrato/arioso/linguagem/estilo/discurso/língua/adágio/suíte/tema/dó_maior/dó_maior/ligadura/pauta/dominante/tonica/tônica/tónica/gama/charanga/fanfarra/escala_musical/escalas_musicais/partitura/notacao_musical/notação_musical/notação_musical/seção/parte/música/fermata/piano/timbre/som/uníssono/sintetizador/sintetizadores/corda/placa_de_som/órgão/órgão_eletrónico/órgão_eletrônico/realejo/sanfona/afinação/recapitulação/música/transposição
poesia	erin/dor/calma
futebol	ponteiro/ponta/ponteiro/ponta/tight_end/tight_end/running_back/running_back/punter/placekicker/fullback/zagueiro/beque/meio-campo/final_de_copa/final_da_taça/drible/gol-contra/gol_contra/autogolo
droga	anafilaxia
língua	idioma/linguagem/estilo/discurso/língua/acento/sotaque
automóvel	tração/tracção/passageiro/túnel/mapa_rodoviário/alternador/aluguel/arrendamento/aluguel
ônibus	passageiro
eletricidade	terra
psicologia	delusão/tensão/stress/fadiga/tensão/nervosismo/introvertido/extrovertido/adiência/abiência/gestalt/associacionismo/revestimento/recompensa/generalização/double_bind/rosto/extroversão/comportamento/inibição/hábito/costume
poema	erin/dor/calma
religião	noviciado/numina/conformista/frade/irmão/diabo/satã/lúcifer/satanás/meditação/submundo/inferno/ortodoxia/hábito/claustro/incensário/turíbulo/tolerância/celibato/castidade/recato/pudicícia/consagração/vigília/perseguição
pedagogia	ministério_de_educação_dos_eua/educação/ministerio_da_educação/ensino/educação/pedagogia
física	desaceleração/desaceleração/aceleração/aceleração/molécula/molécula/átomo/átomo/lápis/lápis/geometria_métrica/métrica/geometria_métrica/métrica/constante_gravitacional_universal/constante_gravitacional_universal/constante_universal_dos_gases_perfeitos/constante_universal_dos_gases_perfeitos/espalação/espalação/reacção_nuclear/reação_nuclear/reacções_nucleares/reacção_nuclear/reação_nuclear/reacções_nucleares/difusão/difusão/absorção/absorção/força_nuclear_fraca/força_nuclear_fraca/força_forte/força_forte/interacção_fundamental/interação_fundamental/força_fundamental/interacção_fundamental/interação_fundamental/força_fundamental/tensão/tensão/tensão/tensão_mecânica/tensão/tensão_mecânica/luz/luz/velocidade_angular/velocidade_angular/aceleração_angular/aceleração_angular/inércia/inércia/gravitação/gravidade/gravitação/gravidade/força/força/potência/potência/energia/energia/coesão/coesão/pertubação/pertubação/força_de_coriolis/força_de_coriolis/força_de_coriolis/força_de_coriolis/físico/físico/quark/quark/particula_elementar/partícula_elementar/partícula_elementar/particula_elementar/partícula_elementar/partícula_elementar/frente_de_onda/frente_de_onda/transiente/transiente/onda/onda/vibrações/vibração/vibração/oscilação/vibrações/vibração/vibração/oscilação/ondas_de_gravidade/ondas_de_gravidade/colisão/colisão/supersimetria/supersimetria/paridade/paridade/lei_de_planck_da_radiação/lei_de_planck_da_radiação/lei_de_charles/lei_de_charles/lei_de_charles/lei_de_charles/estatística_de_fermi-dirac/estatística_de_fermi-dirac/estatística_de_fermi-dirac/estatística_de_fermi-dirac/lei_de_dalton/lei_de_dalton/estatística_de_bose-einstein/estatística_de_bose-einstein/atractor/atractor/quantum/quantum/absorbância/absorbância/fluxo/fluxo/massa_invariante/massa_invariante/absortividade/absortividade/dualidade_particula-onda/dualidade/dualidade_particula-onda/dualidade/isotropia/isotropia/nível_metaestável/nível_metaestável/reactores_nucleares/reatores_nucleares/reator_nuclear/reactor/reactores/reactores_nucleares/reatores_nucleares/reator_nuclear/reactor/reactores/magnete/íman/ímã/magnete/íman/ímã/espaço_fásico/espaço_fásico
show	ensaio
linguagem	idioma/linguagem/estilo/discurso/língua/acento/sotaque
fé	noviciado/numina/conformista/frade/irmão/diabo/satã/lúcifer/satanás/meditação/submundo/inferno/ortodoxia/hábito/claustro/incensário/turíbulo/tolerância/celibato/castidade/recato/pudicícia/consagração/vigília/perseguição
taxação	encargo/imposto/taxa/rendimento/renda/a_receber/coletor/recolhedor/cobrador
medicamento	anafilaxia
eletrônica	constante_de_tempo/constante_de_tempo/pulsação/pulsação/ripple/ripple/demodulação/demodulação/modulação/modulação/resposta_em_frequência/resposta_em_frequência/transistor/transístor/transistor/transístor/rede/rede/tangência/tangência
animal	verruga/olfato/nariz/lado/estrutura_organica/corpo/corpo_humano/humanidade/rede/armadilha/arapuca/microorganismo/microrganismo/rastreamento/rastreio/sacrificio/sacrifício
cultivo	cultivo
remédio	anafilaxia
fotografia	subdesenvolvimento/registro/contraste/fotografia/intensificação
matemática	raio/cota_superior/paralela/linha_geodésica/geodésica/plano/recíproco/inverso_multiplicativo/reflexiva/transitiva/números_pares_e_ímpares/operador/transformação_afim/transformação_geométrica/transformação/geometria_métrica/métrica/função/número_imaginário/número_complexo/cardinalidade/matemático/progressão_geométrica/progressão_aritmética/diagonal/matriz_mitocondrial/matrizes/matriz/corpo/espaço_topológico/imagem/domínio/conjunto/asserção_matemática/declaração_matemática/expressão_matemática/fórmula/expressão/equação/equações/equaçao/prova/demonstração/evidência/binômio/binómio/produtos_notáveis/produtos_notáveis/topologia/topologia/teoria_de_galois/teoria_de_galois/teoria_dos_grupos/subgrupo/teoria_de_conjuntos/cálculo_de_variações/cálculo_das_variações/cálculo_integral/análise_matemática/análise/calculo/cálculo/cálculo/álgebra_linear/álgebra/álgebra/trigonometria/trigonometria/geometria_projetiva/geometria_projectiva/geometria_projetiva/sólido_geométrico/geometria_analítica/trigonometria_esférica/geometria_esférica/análise_numérica/geometria_de_riemann/geometria_hiperbólica/geometria_não-euclidiana/geometria_não_euclidiana/geometria_não-euclidiana/geometria_euclidiana/geometria_afim/geometria/aritmética/aritmética/fractal/infinitesimal/série/polinômio/polinómios/polinómio/polinômio/invariante/invariância/regra/fórmula/interpolação/extrapolação/fatoração/assimetria/simetria/operação/cáculo/arredondamento
verso	erin/dor/calma
vegetal	peroxidase/fotossíntese/fotossíntese/fotossintese/nitrificação/cobertura_vegetal/flora/vegetação/circulação/coca/comensalismo/parasita/microorganismo/microrganismo/fitoterapia/fitoterapia
computador	formato/formatação/comunicação_de_dados/informática/ciência_da_computação/teste_beta/teste_alfa/estrutura_de_dados/throughput/plotter/lutter/módulo/console
jurisprudência	limitação/bigamia/matrimônio/matrimónio/conúbio/casamento/casal/estado_civil/cidadania/situação_legal/registro/honorário/honorário_advocatício/herança/legado/herança/patrimônio/legado/testemunha/testemunho/uxor/curador/advogado/defensor_público/defensoria_pública/promotor/promotor_de_justiça/promotor_público/querelante/parte/técnico_jurídico/proprietário/dono/notário/tabelião/litigante/legislador/jurista/advogado/fazedor_de_leis/legislador/juiz_de_paz/jurisconsulto/jurista/advogado_de_defesa/cliente/constituinte/contratador/promotor/defensor/advogado/procurador-geral_da_república/procurador_geral_da_república/procurador-geral/promotor/advogado/procurador/acusado/réu/suspeito/argüido/domicílio/casa/legislação_tributaria/legislação_fiscal/legislação_financeira/leis/lei/código_militar/lei_militar/direito_militar/direito_mercantil/direito_comercial/direito_empresarial/lei_marcial/direito_comum/lei_suprema_do_país/direito_marítimo/direito_do_mar/direito_internacional/common_law/direito_consuetudinário/common_law/common-law/direito_civil/direito_romano-germânico/direito_administrativo/júri/suprema_corte_dos_estados_unidos_da_américa/federal_bureau_of_investigation/fbi/federal_bureau_of_investigation/departamento_de_justiça/justiça/justiça/judiciário/corpo_jurídico/alegação/aviso_legal/arbitragem/barra_lateral/questão_de_direito/obiter_dictum/álibi/declaração/testemunho_indireto/prova_indiciária/prova_indireta/evidência_circumstancial/evidência_indireta/evidência/testemunho/testemunha/depoimento/prova/conspiração/código_dos_estados_unidos_da_américa/código_dos_estados_unidos_da_américa/código_penal/código_jurídico/estatuo/estatuto/transação_penal/libelo/resposta_evasiva/alegação/multa/coima/citação/interdição/citação/intimação/intimação/mandato/execução/execução_de_instrumento/execução/mandado/perdão/anistia/juízo/carta-patente/licença/licenciamentos/mandado/contrato/feito_notável/ato/escritura_pública/ato_heróico/declaração_antecipada_de_vontade/codicilo/nota_de_suicídio/testamento/processo_cautelar/processo_cautelar/injunção/proibição/toque_de_recolher/acta/decreto/direito_criminal/direito_penal/bill_of_attainder/projecto_de_lei/legislação/direito_público/constituição_dos_estados_unidos/constituição_dos_estados_unidos_da_américa/constituição/prescrição/lei/leis/actos_legislativos/ato/mandato/procuração/debênture/cópia/passaporte/passaportes/letra_de_câmbio/derivativos/derivativo/documento_oficial/negócio_jurídico/nome_fantasia/preempção/jus_soli/jus_sanguinis/sistema_eleitoral/sistema_de_votação/sistemas_de_votação/sistemas_de_impostos/fiança/sistema_legal/distúrbio/incômodo/moléstia/pertubação/chateação/contrariedade/circunstância_atenuante/premeditação/dolo/presunção/jurisdição/usufruto/desapropriação/sufrágio/voto/direito_ao_voto/liberdade_de_reunião/liberdade_de_imprensa/liberdade_de_expressão/liberdade_de_expressão/liberdade_religiosa/situação_da_liberdade_religiosa_por_país/habeas_corpus/liberdades_civis/direitos_do_cidadão/direito/título/privilégio/servidão/direitos_humanos/vigor/vigência/recolheràgaragem/corte/tribunal/liberdade_condicional/condicional/liberdade_condicional/perdão/amnistia/indulto/anulação/condenação/divórcio/divorcio/processo_criminal/processo/julgamento/legitimação/legalização/condenação_por_estupro/condenação_por_homicídio/quitação/veredito/veredicto/opinião/sentença/julgamento/ditame/tutela_antecipada/tutela_antecipada/decisão_final/julgamento/sentença/litígio/bancarrota/falência/revogação/apelação/apelo/recurso/adoção/adoção/procedimento_legal/procedimento_legal/ação_popular/causa/processo/processo_judicial/pleito/ação_legal/processo_judicial/processo/causa/processo_legal/devido_processo_legal/contempt_of_court/desacato/encarceramento/execução_da_lei/legislação/rapto/sequestros/sequestro/seqüestro/seqüestro/abuso_sexual/abuso_sexual/delinquência_juvenil/delinqüência_juvenil/direito/advocacia/rescisão
trem	passageiro
retórica	figuras_de_linguagem/figura_linguagem/figuras_de_linguagem/figura_linguagem/exórdio/exórdio
flora	peroxidase/fotossíntese/fotossíntese/fotossintese/nitrificação/cobertura_vegetal/flora/vegetação/circulação/coca/comensalismo/parasita/microorganismo/microrganismo/fitoterapia/fitoterapia
auto	tração/tracção/passageiro/túnel/mapa_rodoviário/alternador/aluguel/arrendamento/aluguel
ensinamento	ministério_de_educação_dos_eua/educação/ministerio_da_educação/ensino/educação/pedagogia
planta	peroxidase/fotossíntese/fotossíntese/fotossintese/nitrificação/cobertura_vegetal/flora/vegetação/circulação/distribuição_de_gas/gás/distribuição_de_gás_natural/coca/comensalismo/parasita/microorganismo/microrganismo/fitoterapia/fitoterapia
barco	passageiro/amarra
aeronave	piloto_de_aviao/piloto
comboio	passageiro
estatísticas	estatístico/actuário/atuário/teoria_da_informação/teoria_das_probabilidades/binómio_de_newton/binômio_de_newton/distribuição_de_bernoulli/distribuição_de_bernoulli/coeficiente_de_correlação_produto-momento/coeficiente_de_correlação_de_pearson/coeficiente_de_correlação/correlação/análise_de_variância/série_temporal/regressão_linear/regressão/regressão/multicolinearidade/amostra_aleatória/base_de_sondagem/subpopulação/universo/distribuição_de_poisson/distribuição_de_poisson/distribuição_normal/distribuição_normal/distribuição_de_frequências/co-variância/covariância/desvio_padrão/desvio-padrão/desvio_padrão/variância/média_harmônica/média_harmónica/média_geométrica/valor_esperado/média_aritmética/média/média/canteiro_central/mediana/moda/estatística_parametrica/estatística_sem_distribuicao/estatística_nao_parametrica/estatística_demografica/norma/média/estatística/método_dos_mínimos_quadrados/método_estatístico/procedimento_estatístico/teorema_de_bayes/teorema_de_bayes/variável_dependente/variável_independente/quartil/técnicas_de_amostragem/amostragem
entorpecente	anafilaxia
psicanálise	estágio_fálico/fase_fálica/fase_oral/estágio_oral/fase_anal/estágio_anal/desenvolvimento_psicossexual/acatexia/catexia/energia_libidinal/desejo_de_morte/pulsão_de_morte/tânato/libido/transferência/princípio_de_realidade/princípio_de_prazer/superego/catarse
idioma	idioma/linguagem/estilo/discurso/língua/acento/sotaque
folclore	titania/titânia/titania/titânia/banshee/banshee/banshee/banshee/vampiro/vampiro/assombração/duende/hobgoblin/assombração/duende/hobgoblin/silfo/elfo/duende/silfo/elfo/duende/troll/troll/troll/troll/ogro/ogre/ogro/ogre/licantropia/licantropia
vírus	artrite_reumatoide/artrite_reumatóide/artrite_reumatóide
manufatura	uptime/indústria/correia_transportadora/esteira_transportadora/circuito_fechado_de_televisão
lenda	isolda/tristão/sísifo/midas/tavola_redonda_do_rei_arthur/tavola_redonda/santo_graal/santo_graal
balé	pas
oceano	orla/litoral/costa/massa_de_água/água/corpo_de_água
bíblia	gabriel/exegese/exegese/pacto/promessa/contrato
concerto	ensaio
viatura	tração/tracção/passageiro/túnel/mapa_rodoviário/alternador/aluguel/arrendamento/aluguel
basquete	tabela/assistência/drible/contra-ataque
industria	meios_financeiros/parte/participante/sócio/capitalista/empresa/organização_empresarial/cadeia/setor_de_negócios/pessoas_de_negócios/cine/chinês/indústria_cinematográfica/cinema/astucidade/astúcia/sagacidade/estabelecimento/gestão/gerenciamento/administração/negócio
tênis	game/serviço/forehand
gramática	artigo/oração/cláusula/constituinte_gramatical/constituinte/objeto/complemento_verbal/sujeito/categoria_gramatical/quantificador
jazz	jazz/jazz
inseto	holometabolismo
criatura	verruga/olfato/nariz/lado/estrutura_organica/corpo/corpo_humano/humanidade/rede/armadilha/arapuca/microorganismo/microrganismo/rastreamento/rastreio/sacrificio/sacrifício
impostos	encargo/imposto/taxa/rendimento/renda/a_receber/coletor/recolhedor/cobrador
dramaturgia	assento/cadeira/lugar/teatro/casa/circuito_fechado_de_televisão/anfiteatro
basquetebol	tabela/tabela/assistência/assistência/drible/drible/contra-ataque/contra-ataque
golfe	par/meleca/passarinho/medalhista/calça_de_golfe/equipamento_de_golfe/campo_de_golfe
concertos	ensaio
bote	passageiro/amarra
besta	verruga/olfato/nariz/lado/estrutura_organica/corpo/corpo_humano/humanidade/rede/armadilha/arapuca/microorganismo/microrganismo/rastreamento/rastreio/sacrificio/sacrifício
apólogo	isolda/tristão/sísifo/midas/tavola_redonda_do_rei_arthur/tavola_redonda/santo_graal/santo_graal