passar	deixar
deixar	dar/legar/entregar/passar/deixar/deixar
dar	deixar
falecer	morrer
levar	trazer/tirar/transportar/levar/levar/trazer
reunir	encontrar/ver
encontrar	encontrar/reunir/encontrar/ver
pedir	segurar/reservar
ver	encontrar/reunir
tratar	tratar/tratar/falar/cobrir/endereçar/lidar
entregar	deixar
trazer	trazer/tirar/transportar/levar/levar/trazer
morrer	morrer/expirar/morrer/bater_as_botas/falecer/comer_capim_pela_raiz/perecer
falar	tratar
cobrir	tratar
reservar	pedir
pesar	pesar/pesar/tomar_o_peso
tirar	levar/trazer
transportar	levar/trazer
endereçar	tratar
expirar	morrer
lidar	tratar
segurar	pedir
legar	deixar
embalar	balançar/sacudir
sacudir	balançar/embalar
perecer	morrer