ter	dispõe/apresenta/dispõe/apresenta/ter/contrair/sofrer/padecer/ter
passar	transmitir/dar
fazer	auferir/ganhar/fazer/representar/atuar/cozinhar/preparar/criar/fazer/arrumar/organizar/conquistar/adquirir/fazer
deixar	transmitir/dar/permitir/outorgar/dar/conceder/dar/legar/entregar/passar/deixar/esquecer/olvidar
realizar	realizar/efetuar/levar_a_cabo/executar/atingir/cumprir/visualizar/figurar/afigurar/envisionar/ver
ocupar	consumir/gastar
obter	comprar/receber/obter/comprar/adquirir/receber/obter/incorrer
votar	votar
criar	criar/fazer
partir	partir/abandonar/deixar/sair/largar/partir/deixar/sair
dar	prover/dar/causar/provocar/dar/transmitir/dar/transmitir/dar/dar/legar/entregar/passar/deixar/ajudar/servir/consagrar/devotar/comprometer/dedicar/deixar/permitir/consentir
formar	trabalhar
chegar	vir/aproximar-se_de/chegar/avizinhar/acercar
receber	topar/aceitar/receber/obter/comprar/adquirir/receber/obter/incorrer
substituir	substituir
publicar	escrever/compor
tomar	tomar/beber
considerar	compreender/entender
manter	prosseguir/continuar/permanecer/seguir/ir/progredir/avançar/prosseguir/seguir/continuar/manter/considerar/julgar
atuar	fazer/representar/atuar/atuar/comportar-se/agir/parecer
afirmar	reclamar/reivindicar/falar/contar/dizer/manter/considerar/julgar
declarar	falar/contar/dizer
levar	convencer/persuadir/ir/caminhar/andar/consumir/gastar
trabalhar	trabalhar/trabalhar/forjar/formar/modelar/moldar/trabalhar/amassar
ir	partir/abandonar/deixar/sair/largar/partir/deixar/sair/montar/cavalgar/andar/ir/deslocar/mover/andar/viajar
acabar	expirar/morrer/bater_as_botas/falecer/comer_capim_pela_raiz/perecer
representar	fazer/representar/atuar
organizar	convocar/chamar
começar	iniciar/começar/principiar
seguir	observar/espionar/guardar/mirar/olhar/ver/esposar/adotar/adoptar
encontrar	encontrar/achar/reganhar/encontrar/achar/reganhar/encontrar/reconquistar/recuperar/reganhar/re-adquirir/tocar/encostar
disputar	jogar
permitir	providenciar/possibilitar/fornecer/permitir/proporcionar/deixar/admitir/permitir/outorgar/dar/conceder/deixar/permitir/consentir
casar	juntar/casar-se/casar/esposar
servir	servir/servir/servir/funcionar/ajudar/servir/servir/dar/exercer/servir
continuar	prosseguir/continuar/permanecer/seguir/prosseguir/continuar/permanecer/seguir/ir/progredir/avançar/prosseguir/seguir/continuar
pedir	requerer/solicitar
marcar	etiquetar/rotular
chamar	organizar/convocar/chamar
provocar	prover/dar/parecer/impressionar/comover/afetar
ver	olhar/ver/enxergar/achar/determinar/compreender/entender/realizar/perceber/entender/compreender/realizar/perceber/entender/compreender
determinar	achar/descobrir
aceitar	aceitar/admitir/admitir/aceitar/receber/aceitar
dizer	falar/contar/dizer/ler
colocar	jogar
conceder	deixar/permitir/consentir
acompanhar	ir/caminhar/andar
desenvolver	preparar/educar/treinar/instruir/adquirir/desenvolver/adquirir/desenvolver/desenvolver/progredir
atingir	comprar/parecer/impressionar/comover/afetar/acertar/bater/golpear
prender	prender
sair	partir/abandonar/deixar/sair/largar/partir/deixar/sair
escrever	escrever/compor/escrever/redigir
tratar	tratar/tratar/tratar/falar/cobrir/endereçar/lidar
transformar	virar/mudar/tornar/transformar/converter/transmudar
sofrer	suportar/tolerar/aguentar/aturar/padecer/ter
alcançar	vir/chegar
convidar	convidar/convidar
retirar	desobstruir/limpar
convocar	organizar
solicitar	requerer/solicitar
caber	compreender/incluir/ter/conter
recusar	negar
exigir	custar
viajar	ir/deslocar/mover/andar/ir/viajar/andar/viajar
entregar	transmitir/dar
utilizar	jogar
conquistar	auferir/ganhar
mudar	trocar/mudar/substituir/converter/mudar/trocar/virar/mudar/tornar
reduzir	diminuir/reduzir
abandonar	esquecer/olvidar
ganhar	convencer/persuadir/adquirir/desenvolver/conquistar/adquirir/fazer
preparar	preparar/educar/treinar/instruir
romper	separar/dividir/desmoronar
construir	criar/fazer/preparar/educar/treinar/instruir
gerar	adquirir/desenvolver
informar	introduzir/apresentar
estender	estender/desdobrar/esticar/prorrogar/prolongar/extender
revelar	transmitir/dar
pôr	sentar/sentar-se/estar_sentado
conduzir	ir/exprimir/transmitir
transmitir	dar/legar/entregar/passar/deixar/exprimir/transmitir/espalhar/circular
fechar	fechar/cerrar/fechar
conter	compreender/incluir/ter/conter/tratar/falar/cobrir/endereçar/lidar
admitir	providenciar/possibilitar/fornecer/permitir/proporcionar/deixar/admitir/aceitar/admitir/admitir/aceitar
aderir	aderir/grudar/colar/aderir/colar
dividir	quebrar/romper
atribuir	imputar/atribuir
pagar	pegar
causar	prover/dar
produzir	criar/fazer
adquirir	comprar/auferir/ganhar/adquirir/desenvolver/receber/obter/incorrer
usar	jogar
reivindicar	reclamar/reivindicar
funcionar	servir/operar/funcionar
entender	escutar_sem_os_falantes_saberem/visualizar/figurar/afigurar/envisionar/ver/achar/considerar/ver
concordar	compatibilizar/harmonizar/concordar/combinar/corresponder/concordar/acordar/concordar
saber	conhecer/saber/entender
trazer	exprimir/transmitir
possuir	dispõe/apresenta
significar	significar
ajudar	servir/servir/dar
estimular	parecer/impressionar/comover/afetar
sentar	sentar-se/pôr/sentar/posar/sentar/sentar-se/estar_sentado/sentar/sentar-se/estar_sentado
vender	vender/vender/vender
morrer	expirar/morrer/bater_as_botas/falecer/comer_capim_pela_raiz/perecer/expirar/morrer/bater_as_botas/falecer/comer_capim_pela_raiz/perecer
esperar	antecipar/dar_à_luz/ter/parir
derrubar	virar
atacar	parecer/impressionar/comover/afetar/atingir/afetar/atacar/tirotear/atirar/atacar/assaltar
falar	tratar
desejar	desejar
crescer	adquirir/desenvolver
executar	executar/tocar/realizar/efetuar/levar_a_cabo/executar/atingir/cumprir
comprar	comprar/comprar/adquirir/obter/atingir/receber/obter/incorrer
acontecer	suceder/ocorrer/acontecer/calhar/virar/mudar/tornar/virar/mudar/tornar
levantar	ficar_de_pé/levantar/erguer/levantar/ficar_de_pé
precisar	custar
avaliar	estimar/avaliar/medir
formular	adquirir/desenvolver
observar	achar/descobrir
embarcar	vir/chegar
verificar	achar/determinar/checar/conferir
mover	viajar/ir/caminhar/andar
figurar	realizar/perceber/entender/compreender
deslocar	viajar/ir/caminhar/andar
incentivar	parecer/impressionar/comover/afetar
forçar	forçar/tirar/puxar/arredar
recuperar	encontrar/achar/reganhar/recuperar/convalescer/melhorar
achar	encontrar/achar/reganhar/encontrar/reconquistar/recuperar/reganhar/re-adquirir/achar/descobrir/achar/descobrir/achar/determinar/compreender/entender
cobrar	cobrar
ler	proclamar/ler/entender/compreender
diminuir	diminuir/reduzir
acatar	esposar/adotar/adoptar
questionar	perguntar/indagar
resistir	existir/viver/subsistir/sobreviver/estar_vivo/viver
corresponder	compatibilizar/harmonizar/concordar
noticiar	introduzir/apresentar
antecipar	aguardar/esperar
motivar	parecer/impressionar/comover/afetar
compreender	visualizar/figurar/afigurar/envisionar/ver/tratar/falar/cobrir/endereçar/lidar/achar/considerar/ver/realizar/perceber/entender/compreender
preservar	prosseguir/continuar/permanecer/seguir/ir/progredir/avançar/prosseguir/seguir/continuar
atravessar	voar/avionar/pilotar/voar/encostar/varrer/vassourar
proclamar	ler
aguardar	antecipar
cair	precipitar/cair/tombar/cair/tombar/cair/largar/soltar/deixar_cair
cobrir	tratar/cobrir/tampar/cobrir
interessar	focar/centrar/concentrar
descobrir	achar/descobrir/achar/descobrir/achar/determinar/achar/determinar
repetir	tocar
advertir	avisar/alertar/advertir
converter	transformar/converter/transmudar
assistir	servir/olhar/ver/enxergar
perceber	visualizar/figurar/afigurar/envisionar/ver
melhorar	preparar/educar/treinar/instruir/melhorar/aperfeiçoar/melhorar
requerer	requerer/solicitar/custar
outorgar	deixar/permitir/consentir
constatar	achar/determinar
traçar	observar/espionar/guardar/mirar/olhar/ver/desenhar
acertar	bater/colidir/atingir
quebrar	arruinar/destruir/desistir/abandonar/largar_mão/separar/dividir/desmoronar
conservar	preservar/conservar
destruir	arruinar/destruir
contrair	padecer/ter
tirar	retirar/resgatar/tirar/sacar
sufocar	asfixiar/sufocar
assinalar	diferenciar/distinguir
correr	correr/correr
bater	bater/agitar/bater/agitar/palpitar/pulsar/acertar/bater/golpear/bater/bater_repetidamente/bater/colidir/atingir
comparar	comparar/comparar
separar	quebrar/romper
espalhar	espalhar/circular
restar	jazer
competir	equiparar/igualar
estimar	estimar/avaliar/medir
combinar	compatibilizar/harmonizar/concordar/ajustar/caber
caminhar	ir/caminhar/andar/deslocar/mover
sobreviver	existir/viver/subsistir/sobreviver/estar_vivo/viver
assentar	sentar/sentar-se/estar_sentado
requisitar	requerer/solicitar/custar
delinear	desenhar
avisar	avisar/alertar/advertir
averiguar	achar/determinar
difundir	espalhar/circular
agitar	bater/agitar/bater/agitar
aperfeiçoar	melhorar
equilibrar	balancear/equilibrar/compensar
impulsionar	forçar
abster	negar
perguntar	questionar/perguntar/perguntar/indagar/perguntar/indagar
englobar	tratar/falar/cobrir/endereçar/lidar
andar	montar/cavalgar/andar/ir/ir/ir/caminhar/andar/deslocar/mover/andar/ir/viajar/andar/viajar
confundir	disconcertar/confundir
cerrar	fechar
agredir	atacar/assaltar
guardar	manter/guardar/segurar/reter
congelar	gelar/congelar/congelar
jogar	jogar
desdobrar	estender/desdobrar/esticar
girar	virar-se/tornar-se/virar/rodar/revirar/revolver
falhar	expirar/morrer/bater_as_botas/falecer/comer_capim_pela_raiz/perecer
forjar	trabalhar
prevenir	avisar/alertar/advertir
aprender	achar/determinar
reconquistar	encontrar/achar/reganhar
erguer	levantar/ficar_de_pé
endereçar	tratar/denominar/chamar/nomear
tocar	tocar/tocar
cultivar	trabalhar/amassar
detectar	achar/descobrir
atirar	atirar_e_matar/balear/tirotear/atirar
soltar	cair
indagar	questionar/perguntar
carregar	transportar/levar/carregar/dar_à_luz/ter/parir
capturar	segurar/agarrar
aparelhar	vestir/vestir-se/arrumar-se
suportar	sofrer
demandar	custar
virar	virar/virar/derrubar/encarar/rodar/revirar/revolver/virar/mudar/tornar
lidar	tratar
disseminar	espalhar/circular
prover	causar/provocar/dar
suplantar	substituir
errar	perambular/vaguear/vagar/vagabundear/vadiar/errar
compatibilizar	combinar/corresponder/concordar
disparar	tirotear/atirar
consentir	permitir/outorgar/dar/conceder
notificar	introduzir/apresentar
mergulhar	focar
apostar	apostar/jogar
vagar	perambular/vaguear/vagar/vagabundear/vadiar/errar
queimar	pegar_fogo/conflagrar/combustir/começar_a_queimar/acender/incinerar/queimar/queimar/carburar
extrair	retirar/resgatar/tirar/sacar
desaconselhar	avisar/alertar/advertir
alastrar	espalhar/circular
adicionar	adicionar/somar/acrescentar/acrescer
tolerar	sofrer
pegar	escutar_sem_os_falantes_saberem/vir/chegar
harmonizar	combinar/corresponder/concordar
olhar	manter/guardar/segurar/reter
incorrer	receber/obter/comprar/adquirir
cumprimentar	denominar/chamar/nomear
treinar	treinar/preparar/educar/treinar/instruir/exercitar/malhar
sobrepor	substituir
desenhar	delinear/traçar
conformar	esposar/adotar/adoptar
colar	aderir/grudar/colar/aderir/colar/aderir/colar
convergir	tocar/encostar
sacar	retirar/resgatar/tirar/sacar
voar	voar/avionar/pilotar/viajar_de_avião/voar/aerotransportar/transportar_por_avião
vestir	vestir/vestir-se/arrumar-se/vestir/vestir-se/arrumar-se
afundar	afundar/naufragar/abalroar/submergir/afundar/largar/soltar/deixar_cair
abarcar	tratar/falar/cobrir/endereçar/lidar
fotografar	filmar
empurrar	afastar/tocar/desvanecer/rechaçar/afugentar/forçar/empurrar
colidir	acertar/bater/golpear
auferir	conquistar/adquirir/fazer
segurar	capturar/apanhar
dizimar	erradicar/massacrar/devastar/aniquilar/dizimar
acender	cozinhar/preparar/arrumar/organizar
legar	transmitir/dar
golpear	bater/colidir/atingir
comer	comer/papar/alimentar_se/comer/papar/alimentar_se/comer/comer
afigurar	realizar/perceber/entender/compreender
varrer	encostar/varrer/vassourar/varrer/atravessar/varrer/raspar/roçar
simular	fazer/representar/atuar/atuar/comportar-se/agir/parecer
rivalizar	equiparar/igualar
lucrar	auferir/ganhar
familiarizar	introduzir/apresentar
embalar	balançar/sacudir
balear	tirotear/atirar/tirotear/atirar
ruir	desistir/abandonar/largar_mão
rolar	rodar/revirar/revolver
pilotar	viajar_de_avião/voar/aerotransportar/transportar_por_avião
modelar	trabalhar
limpar	desobstruir/limpar/lavar/limpar/lavar-se
filmar	fotografar
desabar	desistir/abandonar/largar_mão
apanhar	segurar/agarrar
naufragar	abalroar/submergir/afundar
largar	cair
igualar	equiparar/igualar
flutuar	boiar/nadar/estar_a_deriva/vagar
exercitar	exercitar/malhar
asfixiar	asfixiar/sufocar
submergir	afundar/naufragar
semear	semear/plantar
rotular	marcar
padecer	ter/contrair/sofrer
lavar	lavar/lavar
chorar	chorar/choramingar
puxar	tirar/puxar/arredar
perseverar	existir/viver/subsistir/sobreviver/estar_vivo/viver
namorar	sair_com
moldar	trabalhar
manchar	derreter/fundir
fascinar	focar/centrar/concentrar
desmoronar	desistir/abandonar/largar_mão/quebrar/romper
beijar	montar/pinar/meter/foder/comer/trepar/transar/copular
estrangular	asfixiar/sufocar
dançar	bailar/dançar/dançar
brincar	fazer/representar/atuar
beber	tomar/beber
afluir	tocar/encostar
saturar	encher/carregar
posar	sentar/sentar-se/estar_sentado
passear	ir/caminhar/andar/perambular/ir/vagar/perambular/vaguear/vagar/vagabundear/vadiar/errar
inter-relacionar	relacionar/inter-relacionar
fincar	forjar/martelar
desperdiçar	gastar_desperdiçando/torrar
visualizar	visualizar/figurar/afigurar/envisionar/ver/realizar/perceber/entender/compreender
verbalizar	proferir/falar/dizer/verbalizar/conversar
tremer	palpitar/pulsar
raspar	encostar/varrer/vassourar
malhar	exercitar/malhar
intencionar	significar/denotar
fingir	fazer/representar/atuar/fazer/representar/atuar/atuar/comportar-se/agir/parecer/atuar/comportar-se/agir/parecer
encostar	varrer/atravessar/raspar/roçar
agasalhar	vestir/vestir-se/arrumar-se
agarrar	capturar/apanhar
topar	receber
pendurar	pendurar
martelar	forjar/martelar
justiçar	executar
jazer	jazer
gelar	congelar
fruir	dispõe/apresenta
enfileirar	passar/correr
dispõe	possuir/ter/fruir/ter
circundar	tratar/falar/cobrir/endereçar/lidar
balancear	balancear/equilibrar/compensar
amamentar	sugar/chupar
aguentar	sofrer
aerotransportar	voar/avionar/pilotar
admoestar	avisar/alertar/advertir
abalroar	afundar/naufragar