rio	centro_urbano/cidade/urbe/metrópole
carlos	terrorista
sem	homem
nome	distrito/arraial/aldeia/povoado/vila/burgo
maria	progenitora/mãe
franco	general
paraná	rio
porto	centro_urbano/cidade/urbe/metrópole
santos	centro_urbano/cidade/urbe/metrópole
recife	centro_urbano/cidade/urbe/metrópole
washington	general/centro_urbano/cidade/urbe/metrópole
césar	general
natal	distrito/território/domínio/comarca/districto/circunscrição/circunscrição_administrativa
joaquim	compositor
inácio	bispos/bispo_da_igreja_católica/bispo
amazonas	rio
américa	relevo_(geografia)/chão/terra_firme/terra/relevo/solo
curitiba	centro_urbano/cidade/urbe/metrópole
sete	homem
braga	centro_urbano/cidade/urbe/metrópole
belém	distrito/arraial/aldeia/povoado/vila/burgo/centro_urbano/cidade/urbe/metrópole
paris	distrito/arraial/aldeia/povoado/vila/burgo
plínio	escritor/autor
acre	distrito/arraial/aldeia/povoado/vila/burgo/distrito/território/domínio/comarca/districto/circunscrição/circunscrição_administrativa
albuquerque	centro_urbano/cidade/urbe/metrópole
benedito	frei/monge/frade
norma	constelação
alfredo	rei
genebra	personagem_fictícia/personagem/personagem/centro_urbano/cidade/urbe/metrópole
ciro	príncipe/príncipe
nilo	rio
cuba	ilha
toledo	centro_urbano/cidade/urbe/metrópole
ascensão	milagre
ilha	ilha
cabo	província/estado
espanha	centro_urbano/cidade/urbe/metrópole
teresa	monja/freiras/madre/religiosa/freira
frederico	distrito/arraial/aldeia/povoado/vila/burgo
tiro	centro_urbano/cidade/urbe/metrópole
vaticano	centro_urbano/cidade/urbe/metrópole
aníbal	general
aragão	escritor/autor/distrito/território/domínio/comarca/districto/circunscrição/circunscrição_administrativa
petrônio	escritor/autor
leão	constelação/casa_astral/signo/signo_do_zodíaco
pacífico	oceano
redonda	ilha
leitura	centro_urbano/cidade/urbe/metrópole
abelardo	filósofo
américas	relevo_(geografia)/chão/terra_firme/terra/relevo/solo
nazaré	distrito/arraial/aldeia/povoado/vila/burgo
lafayette	distrito/arraial/aldeia/povoado/vila/burgo
rosário	centro_urbano/cidade/urbe/metrópole
jackson	general/general
osasco	centro_urbano/cidade/urbe/metrópole
haia	centro_urbano/cidade/urbe/metrópole
filipe	príncipe/príncipe
madeira	rio/ilha
felipe	príncipe/príncipe
pádua	centro_urbano/cidade/urbe/metrópole
herculano	centro_urbano/cidade/urbe/metrópole
colônia	centro_urbano/cidade/urbe/metrópole
câncer	constelação/casa_astral/signo/signo_do_zodíaco/casa_astral/signo/signo_do_zodíaco
balança	constelação/casa_astral/signo/signo_do_zodíaco
jordão	rio
atlântico	oceano
triângulo	constelação
parnaíba	rio
diógenes	filósofo
sena	rio
libra	constelação/casa_astral/signo/signo_do_zodíaco
fausto	personagem_fictícia/personagem/personagem
leonardo	escritor/autor
califórnia	centro_urbano/cidade/urbe/metrópole
medina	centro_urbano/cidade/urbe/metrópole
rute	mulher/esposa
raquel	mulher/esposa
nicolau	bispos/bispo_da_igreja_católica/bispo
bonn	centro_urbano/cidade/urbe/metrópole
setúbal	centro_urbano/cidade/urbe/metrópole
salomão	rei
pompeu	general
malta	ilha
hamilton	centro_urbano/cidade/urbe/metrópole/centro_urbano/cidade/urbe/metrópole
estêvão	escritor/autor
amarelo	rio
tristão	personagem_fictícia/personagem/personagem
james	escritor/autor/psicólogo/filósofo
sócrates	filósofo
lyra	constelação
hércules	constelação
hamburgo	centro_urbano/cidade/urbe/metrópole
david	rei
miami	centro_urbano/cidade/urbe/metrópole
montreal	centro_urbano/cidade/urbe/metrópole
nápoles	centro_urbano/cidade/urbe/metrópole
belisário	general
átila	rei
formosa	ilha/ilha
asdrúbal	general
terror	idade/era/época/período
jr.	artista/intérprete/actor/ator
tanger	centro_urbano/cidade/urbe/metrópole
cambridge	centro_urbano/cidade/urbe/metrópole
cairo	distrito/arraial/aldeia/povoado/vila/burgo
oxford	centro_urbano/cidade/urbe/metrópole
chicago	centro_urbano/cidade/urbe/metrópole
america	relevo_(geografia)/chão/terra_firme/terra/relevo/solo
suriname	rio
barcelona	centro_urbano/cidade/urbe/metrópole
milão	centro_urbano/cidade/urbe/metrópole
grã-bretanha	ilha
depressão	idade/era/época/período
sara	mulher/esposa
protagonista	personagem_fictícia/personagem/personagem
haiti	ilha
filadélfia	centro_urbano/cidade/urbe/metrópole
texas	centro_urbano/cidade/urbe/metrópole/centro_urbano/cidade/urbe/metrópole/centro_urbano/cidade/urbe/metrópole
portland	centro_urbano/cidade/urbe/metrópole
limeira	centro_urbano/cidade/urbe/metrópole
lagos	centro_urbano/cidade/urbe/metrópole
adão	homem
medellín	centro_urbano/cidade/urbe/metrópole
eva	mulher
pasto	vulcão
munique	centro_urbano/cidade/urbe/metrópole
córdoba	centro_urbano/cidade/urbe/metrópole
carlota	centro_urbano/cidade/urbe/metrópole
saul	rei
fez	centro_urbano/cidade/urbe/metrópole
versalhes	centro_urbano/cidade/urbe/metrópole/palácio/palácio/palácios
houston	centro_urbano/cidade/urbe/metrópole
suez	centro_urbano/cidade/urbe/metrópole
reno	rio
puebla	centro_urbano/cidade/urbe/metrópole
columbia	distrito/arraial/aldeia/povoado/vila/burgo
colorado	rio/rio
utopia	livro
istambul	centro_urbano/cidade/urbe/metrópole
florença	centro_urbano/cidade/urbe/metrópole
demócrito	filósofo
himalaia	serra/cadeia_de_montanhas/cadeia_montanhosa/cordilheira
ferrara	centro_urbano/cidade/urbe/metrópole
monroe	distrito/arraial/aldeia/povoado/vila/burgo/distrito/arraial/aldeia/povoado/vila/burgo
kansas	rio/distrito/arraial/aldeia/povoado/vila/burgo
bolonha	centro_urbano/cidade/urbe/metrópole
armínio	herói
zurique	centro_urbano/cidade/urbe/metrópole
veneza	centro_urbano/cidade/urbe/metrópole
selma	distrito/arraial/aldeia/povoado/vila/burgo
kissinger	diplomata/embaixador
frankfurt	centro_urbano/cidade/urbe/metrópole
cartagena	centro_urbano/cidade/urbe/metrópole
beira	centro_urbano/cidade/urbe/metrópole
turim	centro_urbano/cidade/urbe/metrópole
tarquínio	rei
irlanda	ilha
cingapura	ilha
petersburgo	centro_urbano/cidade/urbe/metrópole
pavão	constelação
otelo	personagem_fictícia/personagem/personagem
ohio	rio
nice	centro_urbano/cidade/urbe/metrópole
hull	centro_urbano/cidade/urbe/metrópole
cleveland	centro_urbano/cidade/urbe/metrópole
tigre	rio
pensilvânia	centro_urbano/cidade/urbe/metrópole
gênova	centro_urbano/cidade/urbe/metrópole
georgetown	áreas_residenciais
aristóteles	filósofo
lisandro	general
guadalupe	ilha
córdova	centro_urbano/cidade/urbe/metrópole/centro_urbano/cidade/urbe/metrópole
atlanta	assédio/cerco/sítio
vichy	distrito/arraial/aldeia/povoado/vila/burgo
sevilha	centro_urbano/cidade/urbe/metrópole
renascimento	idade/era/época/período
princeton	distrito/arraial/aldeia/povoado/vila/burgo
lyon	centro_urbano/cidade/urbe/metrópole
granada	centro_urbano/cidade/urbe/metrópole
chade	lago
california	distrito/arraial/aldeia/povoado/vila/burgo
antuérpia	centro_urbano/cidade/urbe/metrópole
taiwan	ilha/ilha
pompéia	centro_urbano/cidade/urbe/metrópole
pirâmide	monumento/monumentos
manhattan	ilha
havaí	ilha
cancún	centro_urbano/cidade/urbe/metrópole
andes	serra/cadeia_de_montanhas/cadeia_montanhosa/cordilheira
zelândia	ilha
virgem	constelação/casa_astral/signo/signo_do_zodíaco
trípoli	centro_urbano/cidade/urbe/metrópole
tennessee	rio
salina	distrito/arraial/aldeia/povoado/vila/burgo
palermo	centro_urbano/cidade/urbe/metrópole
nancy	centro_urbano/cidade/urbe/metrópole
louisville	centro_urbano/cidade/urbe/metrópole
king	cantor/cantador/vocalista
indiana	centro_urbano/cidade/urbe/metrópole/centro_urbano/cidade/urbe/metrópole
glasgow	centro_urbano/cidade/urbe/metrópole
constantinopla	centro_urbano/cidade/urbe/metrópole
congo	rio
camarões	vulcão
bona	centro_urbano/cidade/urbe/metrópole
baltimore	centro_urbano/cidade/urbe/metrópole
açores	ilha
agra	centro_urbano/cidade/urbe/metrópole
xangai	centro_urbano/cidade/urbe/metrópole
weimar	centro_urbano/cidade/urbe/metrópole
timor	ilha
tarzan	personagem_fictícia/personagem/personagem
renascença	idade/era/época/período
rebeca	mulher/esposa
pittsburgh	centro_urbano/cidade/urbe/metrópole
orígenes	filósofo
maryland	centro_urbano/cidade/urbe/metrópole
marselha	centro_urbano/cidade/urbe/metrópole
jamaica	ilha
heródoto	historiografo/historiador/cronista
grenoble	centro_urbano/cidade/urbe/metrópole
dragões	constelação
confúcio	filósofo
chipre	ilha
barbuda	ilha
vela	constelação
trinidad	ilha
pitágoras	filósofo
liège	centro_urbano/cidade/urbe/metrópole
guálter	maestro
guadalajara	centro_urbano/cidade/urbe/metrópole
gibraltar	assentamento/colônia
essen	centro_urbano/cidade/urbe/metrópole
düsseldorf	centro_urbano/cidade/urbe/metrópole
catalunha	distrito/território/domínio/comarca/districto/circunscrição/circunscrição_administrativa
casablanca	centro_urbano/cidade/urbe/metrópole
bordeaux	centro_urbano/cidade/urbe/metrópole
baviera	província/estado
barém	ilha
apeninos	serra/cadeia_de_montanhas/cadeia_montanhosa/cordilheira
abidjan	centro_urbano/cidade/urbe/metrópole
wiesbaden	centro_urbano/cidade/urbe/metrópole
verona	centro_urbano/cidade/urbe/metrópole
valparaíso	centro_urbano/cidade/urbe/metrópole
tucana	constelação
tobago	ilha
partenon	templo
osaka	centro_urbano/cidade/urbe/metrópole
nantes	centro_urbano/cidade/urbe/metrópole
málaga	centro_urbano/cidade/urbe/metrópole
mombaça	centro_urbano/cidade/urbe/metrópole
lisímaco	general
leningrado	centro_urbano/cidade/urbe/metrópole
leipzig	centro_urbano/cidade/urbe/metrópole
kobe	centro_urbano/cidade/urbe/metrópole
isolda	personagem_fictícia/personagem/personagem
ezequias	rei
estrasburgo	centro_urbano/cidade/urbe/metrópole
edimburgo	capital/capital
dusseldorf	centro_urbano/cidade/urbe/metrópole
dragão	constelação/constelação
dallas	centro_urbano/cidade/urbe/metrópole
corinto	centro_urbano/cidade/urbe/metrópole
canárias	ilha
cannes	centro_urbano/cidade/urbe/metrópole
cancer	constelação
bordéus	centro_urbano/cidade/urbe/metrópole
bologna	centro_urbano/cidade/urbe/metrópole
babilônia	centro_urbano/cidade/urbe/metrópole
áquila	centro_urbano/cidade/urbe/metrópole
valência	centro_urbano/cidade/urbe/metrópole/centro_urbano/cidade/urbe/metrópole
toyota	centro_urbano/cidade/urbe/metrópole
tel-aviv	centro_urbano/cidade/urbe/metrópole
seattle	centro_urbano/cidade/urbe/metrópole
potsdam	centro_urbano/cidade/urbe/metrópole
pisa	centro_urbano/cidade/urbe/metrópole
oviedo	centro_urbano/cidade/urbe/metrópole
núbia	tapera/deserto
leo	constelação
leeds	centro_urbano/cidade/urbe/metrópole
lawrence	distrito/arraial/aldeia/povoado/vila/burgo
ialta	centro_urbano/cidade/urbe/metrópole
hong-kong	centro_urbano/cidade/urbe/metrópole
gotemburgo	centro_urbano/cidade/urbe/metrópole
ebro	rio
delaware	rio
calvário	montanha/barranco/ladeira/colina/morro/monte
calcutá	centro_urbano/cidade/urbe/metrópole
buffalo	centro_urbano/cidade/urbe/metrópole
brighton	centro_urbano/cidade/urbe/metrópole
barroco	idade/era/época/período
bahrein	ilha
argos	centro_urbano/cidade/urbe/metrópole
anibal	general
alexandria	centro_urbano/cidade/urbe/metrópole
yokohama	centro_urbano/cidade/urbe/metrópole
voltaire	escritor/autor
vancouver	distrito/arraial/aldeia/povoado/vila/burgo/centro_urbano/cidade/urbe/metrópole
utrecht	centro_urbano/cidade/urbe/metrópole
tânger	centro_urbano/cidade/urbe/metrópole
toulouse	centro_urbano/cidade/urbe/metrópole
toulon	centro_urbano/cidade/urbe/metrópole
tolosa	centro_urbano/cidade/urbe/metrópole
sião	montanha/barranco/ladeira/colina/morro/monte
sicília	ilha
saragoça	centro_urbano/cidade/urbe/metrópole
samoa	ilha
salônica	centro_urbano/cidade/urbe/metrópole
platão	filósofo
peixes	constelação/casa_astral/signo/signo_do_zodíaco
orly	subúrbios/arrabalde/periferia/subúrbio
newark	centro_urbano/cidade/urbe/metrópole
neolítico	tempo/etapa/período/tempo/etapa/período
nanquim	centro_urbano/cidade/urbe/metrópole
nagasaki	centro_urbano/cidade/urbe/metrópole
monterey	distrito/arraial/aldeia/povoado/vila/burgo
milwaukee	centro_urbano/cidade/urbe/metrópole
midland	distrito/arraial/aldeia/povoado/vila/burgo
mannheim	centro_urbano/cidade/urbe/metrópole
manchester	centro_urbano/cidade/urbe/metrópole/centro_urbano/cidade/urbe/metrópole
mallorca	ilha
madonna	cantor/cantador/vocalista
liverpool	centro_urbano/cidade/urbe/metrópole
lille	centro_urbano/cidade/urbe/metrópole
latrão	locação/sítio/lugar
kananga	centro_urbano/cidade/urbe/metrópole
java	ilha
ithaca	distrito/arraial/aldeia/povoado/vila/burgo
islândia	ilha
iluminismo	idade/era/época/período
ibadan	centro_urbano/cidade/urbe/metrópole
hongkong	centro_urbano/cidade/urbe/metrópole
hiroshima	centro_urbano/cidade/urbe/metrópole
havai	ilha
hamlet	personagem_fictícia/personagem/personagem
guaiaquil	centro_urbano/cidade/urbe/metrópole
genserico	rei
durban	centro_urbano/cidade/urbe/metrópole
dumas	escritor/autor
dresden	centro_urbano/cidade/urbe/metrópole
dortmund	centro_urbano/cidade/urbe/metrópole
detroit	centro_urbano/cidade/urbe/metrópole
danúbio	rio
cáli	centro_urbano/cidade/urbe/metrópole
curaçao	ilha
creta	ilha
creso	rei
charleston	centro_urbano/cidade/urbe/metrópole
cardiff	capital/capital
camelot	capital/capital
bósnia	província/estado
bremen	centro_urbano/cidade/urbe/metrópole
birmingham	centro_urbano/cidade/urbe/metrópole/centro_urbano/cidade/urbe/metrópole
basiléia	centro_urbano/cidade/urbe/metrópole
bari	centro_urbano/cidade/urbe/metrópole
barbados	ilha
bangalore	centro_urbano/cidade/urbe/metrópole
bali	ilha
bach	compositor
assur	centro_urbano/cidade/urbe/metrópole
aral	lago
acapulco	centro_urbano/cidade/urbe/metrópole
índico	oceano
winchester	centro_urbano/cidade/urbe/metrópole
watertown	distrito/arraial/aldeia/povoado/vila/burgo
waco	centro_urbano/cidade/urbe/metrópole
volga	rio
villa-lobos	compositor
vieques	ilha
tucídides	historiografo/historiador/cronista
tróia	centro_urbano/cidade/urbe/metrópole
tours	centro_urbano/cidade/urbe/metrópole
terranova	ilha
taiyuan	centro_urbano/cidade/urbe/metrópole
sumatra	ilha
sucre	centro_urbano/cidade/urbe/metrópole
split	centro_urbano/cidade/urbe/metrópole
soweto	centro_urbano/cidade/urbe/metrópole
sodoma	centro_urbano/cidade/urbe/metrópole
siracusa	assédio/cerco/sítio
sheffield	centro_urbano/cidade/urbe/metrópole
scranton	centro_urbano/cidade/urbe/metrópole
sarajevo	centro_urbano/cidade/urbe/metrópole
salzburgo	centro_urbano/cidade/urbe/metrópole
saara	tapera/deserto
portsmouth	distrito/arraial/aldeia/povoado/vila/burgo/centro_urbano/cidade/urbe/metrópole
platéias	distrito/arraial/aldeia/povoado/vila/burgo
pierrô	personagem_fictícia/personagem/personagem
pierrot	personagem_fictícia/personagem/personagem
phoenix	constelação
pateta	personagem_fictícia/personagem/personagem
ourives	escritor/autor
orleães	assédio/cerco/sítio
orinoco	rio
níger	rio
newport	centro_urbano/cidade/urbe/metrópole/centro_urbano/cidade/urbe/metrópole
negev	tapera/deserto
nagoya	centro_urbano/cidade/urbe/metrópole
mérida	centro_urbano/cidade/urbe/metrópole
mysore	centro_urbano/cidade/urbe/metrópole
messina	centro_urbano/cidade/urbe/metrópole
medellin	centro_urbano/cidade/urbe/metrópole
mazatlán	centro_urbano/cidade/urbe/metrópole
martinica	ilha
maiorca	ilha
madagascar	ilha
louvre	museu/museus
león	constelação
lahore	centro_urbano/cidade/urbe/metrópole
joanesburgo	centro_urbano/cidade/urbe/metrópole
iowa	centro_urbano/cidade/urbe/metrópole
hyderabad	centro_urbano/cidade/urbe/metrópole/centro_urbano/cidade/urbe/metrópole
hokkaido	ilha
hesse	escritor/autor
hamburg	centro_urbano/cidade/urbe/metrópole
haifa	centro_urbano/cidade/urbe/metrópole
guantânamo	centro_urbano/cidade/urbe/metrópole
graz	centro_urbano/cidade/urbe/metrópole
golias	guerreiro
goa	província/estado
gloucester	centro_urbano/cidade/urbe/metrópole
gemini	constelação
eureka	distrito/arraial/aldeia/povoado/vila/burgo
eindhoven	centro_urbano/cidade/urbe/metrópole
duala	centro_urbano/cidade/urbe/metrópole
dorado	constelação
dijon	centro_urbano/cidade/urbe/metrópole
deli	centro_urbano/cidade/urbe/metrópole
cumaná	centro_urbano/cidade/urbe/metrópole
cleópatra	monarca_feminino/rainha_reinante/rainha
cincinnati	centro_urbano/cidade/urbe/metrópole
celebes	ilha
cantão	centro_urbano/cidade/urbe/metrópole
cantuária	distrito/arraial/aldeia/povoado/vila/burgo
cancun	centro_urbano/cidade/urbe/metrópole
cali	centro_urbano/cidade/urbe/metrópole
caim	homem
bristol	centro_urbano/cidade/urbe/metrópole
bridgetown	capital/capital
bombaim	centro_urbano/cidade/urbe/metrópole
bergen	centro_urbano/cidade/urbe/metrópole
bandung	centro_urbano/cidade/urbe/metrópole
aruba	ilha
arlington	centro_urbano/cidade/urbe/metrópole
arequipa	centro_urbano/cidade/urbe/metrópole
aquila	constelação
antígua	ilha
antioquia	distrito/arraial/aldeia/povoado/vila/burgo
alpes	serra/cadeia_de_montanhas/cadeia_montanhosa/cordilheira
alhambra	palácio/palácio/palácios
alcibíades	general
aden	centro_urbano/cidade/urbe/metrópole