governo	oficiais_do_governo/administração/burocracia/departamento/divisão/juizado/poder_executivo/poder_executivo/assembléia_legislativa/legislatura/poder_legislativo
comissão	comissário
público	auditor/ouvinte/aluno
regime	oficiais_do_governo/administração/burocracia/departamento/divisão/juizado/poder_executivo/poder_executivo/assembléia_legislativa/legislatura/poder_legislativo
grupo	livro
escola	escola/ies/instituto/faculdade/instituição_de_ensino_superior/universidade
criação	galáxia/nebulosa/via_láctea
conselho	diretor/director
instituto	escola/ies/instituto/faculdade/instituição_de_ensino_superior/universidade
faculdade	escola/ies/instituto/faculdade/instituição_de_ensino_superior/universidade
lei	oficial_de_polícia/agente/polícia/guarda/policial
tribunal	júri/júri
organização	associado/associação/quorum/quórum
união	associado
exército	militar/corpo/corpo/corpo/corpo
associação	associado
companhia	elenco
ordem	sócio_de_clube/associado
família	parente
sociedade	sócio_de_clube/associado/estrutura_social/sistema_social/sistemas_sociais
pessoal	plebeu/elenco/indivíduo/pessoa/alguém/ser_humano/alma
povo	plebeu/espectador/audiência/indivíduo/pessoa/alguém/ser_humano/alma
polícia	oficial_de_polícia/agente/polícia/guarda/policial
clube	sócio_de_clube
marinha	frota
comitê	diretor/director/comissário
série	número
população	indivíduo/pessoa/alguém/ser_humano/alma
compromisso	ficante/acompanhante
nação	plebeu
junta	diretor/director/comissário
mundo	galáxia/nebulosa/via_láctea/espectador/audiência
jogo	livro
equipe	tripulante/copiloto
corte	júri/júri
frota	navios/embarcação/navio/barco
eleitorado	votante/eleitor/voto/votantes/constituintes/eleitores
armada	frota
casamento	esposa/esposo/marido/cônjuge/cónjuge/consorte
espécie	estirpe/cepa/variante/estirpe/cepa/variante/raça/estirpe/raça/estirpe
casal	esposa/esposo/marido/cônjuge/cónjuge/consorte
gado	ovelha/carneiro/ovinos/vacas/bovinos/gado_bovino/gado/terneiro/bezerro/vitelo
júri	jurado/júri/juror/jurado/júri/juror
proletariado	colarinho_azul/proletário/operário/trabalhador
gente	plebeu/espectador/audiência/indivíduo/pessoa/alguém/ser_humano/alma
tabela	bicha/coluna/linha
universo	galáxia/nebulosa/via_láctea
cavalo	potro
elenco	elenco
trem	locomotivas/máquina/locomotiva/trem/vagão/vagões/automotora/carro/comboio/automóvel
biologia	cobertura_vegetal/flora/vegetação/zoologia/fauna
comboio	locomotivas/máquina/locomotiva/trem/vagão/vagões/automotora/carro/comboio/automóvel
tripulação	tripulante/copiloto
tribo	parente
rebanho	ovelha/carneiro/ovinos/ovelha/carneiro/ovinos/vacas/bovinos/gado_bovino/gado
juizado	júri/júri
autoridades	oficiais_do_governo/administração/burocracia/departamento/divisão/juizado/poder_executivo/poder_executivo/assembléia_legislativa/legislatura/poder_legislativo
clã	parente
comité	diretor/director/comissário
constelação	estrela/asterismo
bovinos	terneiro/bezerro/vitelo
vulgo	plebeu
equipagem	tripulante/copiloto
cosmo	galáxia/nebulosa/via_láctea
familia	parente
nebulosa	estrela
grei	ovelha/carneiro/ovinos/vacas/bovinos/gado_bovino/gado
galáxia	estrela