estado	dominante/classe_média
poder	poderoso
função	funcional
força	débil/potente/delicado
atividade	ativo
medida	padrão/pequeno/grande
crise	crítico
vida	vívido/vivo
posição	interno/adventício/interno/externo/dominante/classe_média
comércio	comercial
condição	dominante/classe_média
segurança	certo
momento	atual/presente/passado/precoce/temporão/cedo
classe	dominante/classe_média
convenção	corriqueiro/convencional
orientação	vertical/fio_de_prumo/perpendicular/horizontal
ciência	científica/científico
belo	feia/feio/belo/lindo/bonito/formoso
necessidade	necessário/essencial
responsabilidade	responsável
possibilidade	impossível
liberdade	livre/independente/dependente
virtude	puro/moral
êxito	próspero/bem_sucedido/bem-sucedido
idade	velho/novo/maturo/maduro
dificuldade	árduo/intrincado/difícil
presença	ausente/presente
continuidade	contínuo
qualidade	superior
permanência	temporário/permanente/duradouro
grau	intenso/intensivo/suave/alto
preparação	pronto/preparado/prestes/disposto
verdade	falso/errado/verdadeiro/existente
capacidade	capaz/capaz
realidade	existente/existente
independência	independente/dependente
confiança	tímido/inseguro/confiante
legalidade	ilegal/legal
propósito	funcional
volume	suave/estrepitante/berrante/alto/alta
moral	puro/moral
correção	preciso/exacto/justo/exato/acurado
colocação	interno/adventício/interno/externo
duração	curto/de_duração
altura	alto/deprimido
ideologia	liberal/conservador
gênero	sexual
potencial	possível/potencial
potência	potente
amizade	amistoso/amigo/amigável
peso	leve/pesado/magro/esbelto/gordo
aspiração	ambicioso
quantidade	deficiente/insuficiente/suficiente/bastante/padrão/abastado/copioso/abundante/basto/farto/bastante/lauto
popularidade	popular
eficiência	eficiente/eficaz/efetivo
dimensão	pequeno/grande
quantia	padrão
facilidade	fácil
conveniência	conveniente
disponibilidade	disponível/acessível
inteligência	intelectual
normalidade	anormal/normal
distinção	outro
distância	distante/distante/vizinho/perto/próximo/vizinho/perto/próximo/longe/longínquo/distante/longe/longínquo/distante
chance	impossível
utilidade	inútil/vão/impróprio/inapto/útil
temor	receoso
fé	certo
prontidão	pronto/preparado/prestes/disposto
ânimo	valente/bravo/afoito/corajoso/arrojado/brava/valoroso
sexo	sexual/homossexual/gay/homo
separação	separado
eficácia	potente/eficiente/eficaz/efetivo
credibilidade	inacreditável/incrível
rigor	preciso/exacto/justo/exato/acurado
status	dominante/classe_média
localização	interno/adventício/interno/externo
lealdade	leal/fiel
integridade	integral/inteiro/quebrado/partido
cor	colorido
significado	significativo/importante/significante
rapidez	pronto/preparado/prestes/disposto/lento/devagar
medo	receoso
diversidade	vário/que_oferece_várias_aspectos
certeza	certo/certo
tamanho	pequeno/grande
lógica	lógico
habilidade	capaz
plenitude	vazio/cheio/lotado/pleno/detalhado/exaustivo/extenso/abrangente/amplo/totalizado/completo/integral
coragem	valente/bravo/afoito/corajoso/arrojado/brava/valoroso
limpeza	suja/sujo/sujado/limpo
alma	vívido
felicidade	feliz/contente/feliz/contente
complexidade	intrincado/complexo
alegria	feliz/contente/feliz/contente
moralidade	puro/moral
quantitativo	padrão
terror	receoso
profundidade	desinteressante/raso/fundo/profundo
ambição	ambicioso
semelhança	semelhante/parecido/similar
adequação	inadequado/capaz/adequado
velocidade	lento/devagar
persistência	contínuo
realismo	existente
consistência	espesso/família_de_tyrogue
significação	significativo/importante/significante
regularidade	regular
modernidade	moderno/contemporâneo
potencialidade	capaz
magnitude	pequeno/grande
honestidade	justo/correto/justo/correto/honroso/honrado
formalidade	formal/informal
talento	capaz
ortodoxia	ortodoxo
sensibilidade	sensível
conforto	confortável
precisão	preciso/exacto/justo/exato/acurado
calibre	superior
solidez	macio/duro/dura
nobreza	nobre
largura	estreita/estreito
efetividade	eficiente/eficaz/efetivo
sexualidade	sexual
maturidade	maturo/maduro
estatura	alto
temperatura	frio/fresco/frio/fresco/caloroso/caloroso/frio/frio/forgoso/quente/forgoso/quente
simplicidade	fácil
acessibilidade	disponível/acessível
ousadia	arrojado/audacioso/destemido/bravo/corajoso/audaz
originalidade	original
exatidão	preciso/exacto/justo/exato/acurado
pudor	modesto
calor	frio/fresco/caloroso/frio/forgoso/quente
santidade	santa/sagrada/santo/sagrado
perfeição	perfeito/aprimorado
beleza	feia/feio/belo/lindo/bonito/formoso
asseio	suja/sujo/sujado/limpo
animação	vivo/vivo
modéstia	modesto
altitude	deprimido
mercantilismo	comercial
integralidade	totalizado/completo/integral
gritaria	suave/estrepitante/berrante/alto/alta
familiaridade	familiar
excitação	excitante/emocionante
desembaraço	certo
cortesia	gentil
bondade	boa!
audácia	arrojado/audacioso/destemido/bravo/corajoso/audaz
altivez	certo
umidade	seco/molhado
tédio	monótono/desinteressante/chato
tez	loiro/flavo
similitude	semelhante/parecido/similar
pose	certo
polidez	gentil
inteireza	totalizado/completo/integral
espessura	espesso/grosso
consternação	receoso
alteridade	outro