ser	cara/face/rosto/cabeça/anatomia/parte_do_corpo/célula
ano	estação_do_ano/estação/tempo/sazão/período/mês
dia	hora/fim_de_tarde/noitada/tarde/noite/meio_dia/meio-dia/manhã/jornada/dia
país	domínio
mês	semana
todo	seção/segmento/parte/porção
empresa	atividade_comercial
criação	estrela/corpo_celeste/astro
programa	sub-rotina/sub-rotina/função/subrotina/meta/alvo/intenção/objectivo
lei	lei/leis/actos_legislativos
tempo	metade/jogo/turno
arena	campo/gramado
vida	idade/período_da_vida/época/período/passado
guerra	luta/combate/batalha
comércio	expedição/transporte/transportação/atividade_comercial
economia	setor
turno	metade/jogo/turno
hora	quarto_de_hora/15_minutos/min/minuto
carta	linha/melodia
luta	porrada/golpe
década	ano
discurso	conclusão
ciência	disciplina_cientifica/ciência
sociedade	classe_social/classe/estrato/setor
disputa	porrada/golpe
mercado	industria/comércio/negócio/empresa
pessoa	natureza/índole/caráter/personalidade/personalidade/temperamento/pessoa/peculiaridade/feição
terra	céu/relevo_(geografia)/chão/terra_firme/terra/relevo/solo/hemisfério/domínio
combate	porrada/golpe
casa	alpendre/orquestra/mansarda/ático/trapeira/sótão/biblioteca/cozinha/casa_de_banho/banheiro/quarto_de_banho/sala_de_banho
unidade	pedaço/tomo/secção/parte/porção/seção/segmento/parte/porção
igreja	ábside/abside
viagem	parada/etapa
estrutura	alicerce/base/pé
edição	arte_gráfica/arte/desenho/gráfico/ilustração/texto
episódio	incidente/evento
arma	arma/armamento
nação	domínio
negócio	atividade_comercial
corpo	perna/banda/traseiro/fundilhos/nalga/nádega/anca/bunda/traseiro/rabo/bumbum/popô/bunda/ânus/nádegas/costas/ventre/abdome/estômago/barriga/abdómen/tronco/abdômen/seio/peito/corpo/tronco/torso/ombro/cabeça/sistema_nervoso
mesa	louça
estrada	curva
mundo	céu/relevo_(geografia)/chão/terra_firme/terra/relevo/solo/estrela/corpo_celeste/astro/hemisfério
jogo	metade/jogo/turno
correio	missiva/carta
lista	item
publicação	arte_gráfica/arte/desenho/gráfico/ilustração/texto
serra	passos_de_montanha/passo_de_montanha
quarto	muralha/parede/muro/chão/piso/assoalho/pavimento
humano	cara/rosto/face/lombo
jornada	manhã/parada/etapa
semana	dia/semana
doença	sintoma
via	curva
residência	cozinha/casa_de_banho/banheiro/quarto_de_banho/sala_de_banho
tratamento	produtos_farmacêuticos/remédio/terapia/medicamento
caminho	curva
organismo	anatomia/parte_do_corpo/célula
bicho	cara/face/rosto/cabeça
palavra	sílaba
natureza	qualidade/característica
termo	sílaba
face	bochecha/testa/traço/mento/chinchilla/queixo/boca
infra-estrutura	água/redes_de_distribuição_de_água/fornecimento_de_água/sistemas_de_comunicações
século	década/decênio/década/decênio
elevação	encosta/ladeira/subida/costa/declives/declive
personalidade	natureza/índole/caráter/personalidade/peculiaridade/feição
prédio	janela/fenestra/muralha/parede/muro/quarto/aposento/sala/telhado/teto/aquecimento/calefação/calefacção/centrais_de_aquecimento/pavimento/piso/andar/canto/quina/recanto/rincão/anexo/asa
rodovia	curva
habitação	alpendre/mansarda/ático/trapeira/sótão/biblioteca/cozinha/casa_de_banho/banheiro/quarto_de_banho/sala_de_banho
veículo	fenestra/janela/guarda-lama
esporte	tempo/turno/jogo/rodada/manobra
batalha	porrada/golpe
armamento	arma/armamento
ponte	arco/arco
teoria	suposição/possibilidade/hipótese/teoria/lei_da_natureza/lei
teatro	orquestra
edifício	janela/fenestra/muralha/parede/muro/quarto/aposento/sala/telhado/teto/aquecimento/calefação/calefacção/centrais_de_aquecimento/alicerce/base/pé/pavimento/piso/andar/canto/quina/recanto/rincão/anexo/asa
carro	fenestra/janela/guarda-lama
futebol	metade
automóvel	fenestra/janela/guarda-lama
minuto	sec/segundo/s
seio	colo/peito/tórax
totalidade	componente
indivíduo	personalidade/temperamento/pessoa
cabeça	têmpora/cara/rosto/face
infraestrutura	água/redes_de_distribuição_de_água/fornecimento_de_água/sistemas_de_comunicações
sala	muralha/parede/muro/chão/piso/assoalho/pavimento
munição	arma/armamento
estádio	campo/gramado
alguém	personalidade/temperamento/pessoa
animal	cara/face/rosto/cabeça
tecido	alicerce/base/pé
universo	estrela/corpo_celeste/astro
moradia	cozinha/casa_de_banho/banheiro/quarto_de_banho/sala_de_banho
domicílio	cozinha/casa_de_banho/banheiro/quarto_de_banho/sala_de_banho
vegetal	componentes_das_plantas/fragmento/parte
computador	hardware
jurisprudência	lei/leis/actos_legislativos
alma	personalidade/temperamento/pessoa
rodada	metade/jogo/turno
roupa	algibeira/bolso/colarinho
flora	componentes_das_plantas/fragmento/parte
auto	fenestra/janela/guarda-lama
boca	boca/língua
rosto	bochecha/testa/traço/mento/chinchilla/queixo/boca
lar	cozinha/casa_de_banho/banheiro/quarto_de_banho/sala_de_banho
céu	arco-íris/nuvem/ponto_celestial/ápice_solar
planta	componentes_das_plantas/fragmento/parte
tronco	banda/traseiro/fundilhos/nalga/nádega/anca/bunda/traseiro/rabo/bumbum/popô/bunda/ânus/nádegas/costas/ventre/abdome/estômago/barriga/abdómen/tronco/abdômen/umbigo/seio/peito/ombro
superfície	fenda/vão/massa_de_água/água/corpo_de_água
leito	colchão
decênio	ano
templo	ábside/abside
perna	artelho/tornozelo/maléolo/joelho/canela
doenças	sintoma
vestuário	algibeira/bolso/colarinho
verbo	sílaba
cara	bochecha/testa/traço/mento/chinchilla/queixo/boca
temperamento	natureza/índole/caráter/personalidade/peculiaridade/feição
peixe	aleta/barbatana
vocábulo	sílaba
igrejas	ábside/abside
ave	ala/asa
peito	colo/peito/tórax
refeição	porção/prato/prato
shopping	mercadoria/artigo/produto
pele	ruga/sulco/ruga/sulco
viatura	fenestra/janela/guarda-lama
aposento	muralha/parede/muro/cozinha/chão/piso/assoalho/pavimento/casa_de_banho/banheiro/quarto_de_banho/sala_de_banho
estômago	umbigo
cama	colchão
ventre	umbigo
industria	atividade_comercial
colarinho	colarinho/gola
xadrez	tabuleiro_de_xadrez
séculos	década/decênio
pássaro	ala/asa
morada	cozinha/casa_de_banho/banheiro/quarto_de_banho/sala_de_banho
anjo	ala/asa
min	sec/segundo/s
inseto	ala/asa
criatura	cara/face/rosto/cabeça
centúria	década/decênio
agulha	buraco
listagem	item
fungo	chapéu
erva	legume/hortaliça/vegetal/verdura
damas	tabuleiro_de_xadrez
cosmo	estrela/corpo_celeste/astro
barriga	umbigo
prato	molho/ingrediente
ovo	casca/casca_de_ovo/casca_do_ovo
missiva	linha/melodia
mercantilismo	expedição/transporte/transportação
garganta	língua
esqueleto	esqueleto
cordilheira	passos_de_montanha/passo_de_montanha
abdome	umbigo
vivenda	alpendre/mansarda/ático/trapeira/sótão/biblioteca
pugna	porrada/golpe
besta	cara/face/rosto/cabeça
banheiro	banheira