elevar	ascender/subir
levantar	ascender/subir
matar	expirar/morrer/bater_as_botas/falecer/comer_capim_pela_raiz/perecer
alimentar	papar/alimentar_se/comer
agradar	gostar
satisfazer	gostar
erguer	ascender/subir
alÃ§ar	ascender/subir
gostar	gostar
ofender	ressentir
irritar	ressentir
assustar	temer/ter_medo_de/recear/apavorar
intimidar	temer/ter_medo_de/recear/apavorar
insultar	ressentir
atemorizar	temer/ter_medo_de/recear/apavorar
encantar	gostar
comprazer	gostar
aterrorizar	temer/ter_medo_de/recear/apavorar
amedrontar	temer/ter_medo_de/recear/apavorar
verter	manar/fluir/correr
derramar	manar/fluir/correr
injuriar	ressentir