ser	possibilidade/chance/vida/animação/vida/existência/presença/realidade/fungos/fungo/mutante/mutação/mutantes/pessoa/indivíduo/larva/ave_de_caça/caça/presa/predadores/invertebrado/invertebrados/cordados/anfitrião/hospedeiro/comensalismo/parasita/microorganismo/microrganismo/herbívoro/cria/filhote/prole/macho/fêmea/animal_doméstico/animal_doméstico/vegetal/planta/flora/besta/criatura/ser/bicho/animal/indivíduo/pessoa/alguém/ser_humano/alma/célula/vida/ser/organismo
ano	ano
governo	estado/palácio/legislação
presidente	presidente
dia	efeméride/feriado/anoitecer/véspera/tarde/fim_de_tarde/noite/tarde/dia/data/dia/dia
estado	iniqüidade/maldade/iniqüidade/maldade/destruição/morte/perigo/perigo/segurança/segurança/aridez/secas/secura/aridez/secas/secura/imunidade/imunidade/ordem/ordem/circunstâncias/sina/sorte/destino/imperfeição/defeito/perfeição/nudez/nudez/necessidade/carência/necessidade/carência/conforto/conforto/ascendencia/controle/dominancia/superioridade/domínio/ascendencia/controle/dominancia/superioridade/domínio/liderança/nobreza/dignidade/posição/hierarquia/classe/posto/imaturidade/melhoria/melhora/melhoria/melhora/ligação/união/ligação/conexão/coalizão/fusão/coligação/estado/ligação/união/acção/ação/actividade/atividade/movimento/delegação/liberdades_civis/liberdade/delinquência/culpa/delinquência/culpa/iluminação/confronto/recontro/conflito/inimizade/hostilidade/desordem/bagunça/existência/ser/existência/forma_de_vida/nacionalidade/nacionalidade/status_social/posto/lugar/condições_sociais/circunstância/circunstância/fase/grau/nível/ápice/estado_natural/ligação/relação/relação/relacionamento/situação/condição/posição/situação/posição/situação/habilidade
político	prefeito/presidente_da_câmara_municipal/presidente_da_câmara
eleição	cabimento/possibilidade
militar	oficial
filho	rapaz/menino/filha/criança/menino/filho/bebé/nenê/recém-nascido/criancinha/bebê
segundo	hora
membro	irmã/soror/dedo_da_mão/dígito/dedo/perna/perna/membro/aleta/barbatana
mês	mês_lunar/lua
poder	sumptuosidade/suntuosidade/opulência/luxo/riqueza/efeitos/faculdade/talento/habilidade/talento/habilidade/meta/técnica/criatividade/criatividade/aptidão/inteligência/liderança/habilidade/efetividade/eficácia/eficiência/força/influência/força/valência/valência_química/potencia/potência/força/eficácia
movimento	vaga/onda/onda/migração/manobra/precipitação/aceleração/regresso/retorno/descensão/elevação/ascensão/introdução/inserção/caçada/perseguição/transporte/transferência/travessia/viagem/locomoção/progressão/avanço/manobra
todo	totalidade/soma/artefato/objeto_natural/objeto_natural
governador	castelão/senhor
projeto	programa/empreendimento_de_risco/bebê/aventura
empresa	empresa_comercial/empresa/organização_empresarial/empresas/agência/agencia/expedição/transporte/transportação/finança/indústria/manufatura
trabalho	publicação/edição/oficina/chácara/granja/quinta/sítio/fazenda/central_telefónica/central/central_telefônica/atividade_comercial/projeto/tarefa/obrigação/dever/assintência/cuidado/investigação/empenho/esforço/mão-de-obra/trabalho/profissão/ofício/profissão/arte/cargo/posição/posto/procedimento/operação
apoio	degrau/suporte/perna/pé/pé/base/pedestal/endosso/adesão/aderência
fim	efeito/efeitos/influência/ponta/pico/vencimento/derrota/perda/vitória/términio/parada/destruição/desolação/demolição/resultado/placar
vez	promoção/liquidação
campanha	charneca/brejos/páramo/planície/planícies
assembléia	corte/tribunal_de_justiça/tribunal/juizado/assembléia_legislativa/legislatura/poder_legislativo/concentração/encontro/reunião
curso	norte/trilha/curso/curso/seminário/caminho
função	lugar/posição/papel/profissão/ofício/profissão/arte/cargo/posição/posto
período	serviço_militar/turno_de_serviço/estágio/período/fase/sono/sesta/hora/tempo/juventude/pré-história/era/período/idade/tempo/período/escala_de_tempo_geológico/era/época/século/idade/temporada/tempo/estação/tempo/estação/temporada/inverno/estio/verão/primavera/outono/estação_do_ano/estação/tempo/sazão/período/momento/hora/ano_escolar/semestre/período/prazo/mês/dia/trimestre/século/século/centúria/séculos/década/decênio/ano/ano/ano/semana/noite/noite/noitada/noite/fim_de_tarde/noitada/tarde/noite/manhã/jornada/dia/dia/idade/velhice/puberdade/infância/idade/período_da_vida/época/período/passado/vida/vida/duração_de_uma_vida/vida/semana/duração/continuidade/dia/época/momento/período/tempo/era/licença/horas_de_trabalho
jornal	número/periódico/folha/jornal
regime	estado/palácio
grupo	voto/organização/sistema/júri/júri/grupo_profissional/vocação/associação/assentamento/colônia/camarilha/povo/gente/massa/população/administração/organização/população/povo/gente/classe/união/parelha/par/povo/raça/raças_humanas/linhagem/acúmulo/aglomeração/colecção/coleção/grupos_sociais/pessoal/população/povo/gente/grupo_biológico/reino/arranjo/categoria_gramatical/espécie_humana/homem/povo/mundo/humanidade
oposição	inversão_térmica/resistência/reação
processo	cálculo
início	criação/concepção/alvorecer/amanhecer/manhã/madrugada/princípio/início/começo/origem/começo/gênese/iniciação/estabelecimento/constituição/organização
chefe	superior/presidente/político/exemplo/modelo/líder/responsável/cabeça/chefe/liderança/empregador/gerente/administrador
legislatura	parlamento/assembléia
posse	possessão/propriedade
criação	afiguração/imagem/ilustração/figura/desenho/representação/bens/produção/produto/bordado/composição/belas_artes/belas-artes/arte/arte
força	efeitos/vigor/força/força/potência
nome	nome_comercial/título/prenome/nome_próprio/antenome/primeiro_nome/nome/denominação/nome_de_batismo/título/sobrenome/apelido/cognome/nome_de_família
atividade	jogo/jogos/comportamento/sucessão/sucessão_ecológica/reacção_nuclear/reação_nuclear/reacções_nucleares/fluxos/difusão/deterioração/decomposição/putrefação/apodrecimento/desabafo/consulta/divertimento/galhofa/diversão/liderança/comportamento/comportamento/conduta/amparo/suporte/auxílio/socorro/ajuda/assistência/preparação/mercado/provimento/abastecimento/fornecimento/posicionamento/colocação/ocultação/adoração/cerimônia/processo/procedimento/agrupamento/organização/calibração/medição/medida/mensuração/agressão/hostilidade/manobra/operação/utilização/uso/procurar/buscar/criação/representação/treinamento/preparação/treino/atividade_sensorial/atividade_sensorial/reação/resposta/transa/sexo/consumo/ingestão/respiração/protecção/proteção/controle/controlo/esforço/tentativa/desperdício/delito/transgressão/escrita/trabalho/tarefa/animação/atuação/representação/interpretação/música/vez/jogo/jogo/recreaçao/diversão/hábito/costume/operação/oposição/economia/mudança/selecção/seleção/escolha/performance/execução/desempenho/realização/vinda/chegada/esgrima/interação/trâmite/curso_de_ação/conduta/curso/caminho/corrente/conquista/façanha/realização/feito/gentileza/delicadeza/amabilidade/bondade/coisa
distrito	jurisdição/bairro/vizinhança/divisão_territorial/divisão_administrativa/distrito_administrativo
líder	superior/presidente/político/exemplo/modelo/líder/responsável/cabeça/chefe/liderança/empregador/gerente/administrador
final	ponta/pico/vencimento/derrota/perda/vitória/términio/parada/destruição/desolação/demolição/resultado/placar
parte	resíduo/sobra/excedente/resto/restante/membro/unidade/componente/elemento/componente/órgão_vegetal/órgão/chapéu/tira/fatia/segmento/canto/item/conclusão/unidade_da_linguagem/unidade_linguística/ponto/anatomia/parte_do_corpo/seção/segmento/pixel/elemento_de_imagem/píxel/peça/pedaço/hardware/componente/parte/apêndice/adição/melhoria/substância
programa	sub-rotina/sub-rotina/função/subrotina/programa_de_computador/programa_de_computador/programa/estratégia/planos/táctica/programa/tática
instituto	estabelecimentos_de_ensino/igrejas/igreja/religião/empresa/companhia
ação	jogo/jogos/comportamento/sucessão/sucessão_ecológica/reacção_nuclear/reação_nuclear/reacções_nucleares/fluxos/difusão/deterioração/decomposição/putrefação/apodrecimento/atos_da_fala/acto_de_fala/comunicado/comunicação/uma_comunicação/consulta/distribuição/ação_em_grupo/parada/paralisação/paralização/atrapalhação/impedimento/interferência/ociosidade/habitação/permanência/agressão/hostilidade/juízo/critica/julgamento/uso/atividade/ocupação/rejeição/oposição/economia/mudança/selecção/seleção/escolha/performance/execução/desempenho/realização/falha/insucesso/vinda/chegada/toque/contato/escape/escapatória/fuga/recuperação/impulsão/propulsão/efetuação/execução/realização/implementação/eliminação/disposição/descobrimento/descoberta/partida/causa/causalidade/aquisição/esgrima/interação/trâmite/curso_de_ação/conduta/curso/caminho/corrente/acção/ação/atividade/ato/conquista/façanha/realização/feito/gentileza/delicadeza/amabilidade/bondade/coisa
órgão	folhagem/folha/caule/tronco/raiz/raíz/genitália/órgão_reprodutivo/genitália/órgão_sexual/cristalino/lente/língua/víscera/ala/asa
faculdade	vontade/sentido/inteligência/entendimento/razão/memória/linguagem/idioma/discurso/língua
ocasião	virada/ponto_de_viragem/crise/vez/promoção/liquidação
cadeira	assento/cadeira
lei	direito_civil/direito_romano-germânico/constituição
medida	intervalo_de_tempo/tempo/intervalo/tempo/turno/jogo/rodada/momento/instante/unidades_de_tempo/unidade_de_tempo/unidade_de_peso/peso/unidade_métrica
administração	autorização/gestão/gerenciamento/administração/tratamento/legislação
costa	beira-mar/orla_marítima/litoral/costa
sistema	calendário/sistema_econômico/economia/sistema_de_referencia/sistemas_de_coordenadas/esqueleto/sistema_esquelético/sistema_nervoso
constituição	estrutura/arquitectura/arquitectura_do_computador
relação	romance/romance/amizade/oposição/comparação/reciprocidade/relação_de_negócios/relação_de_grandeza/paternidade/parentesco/relação/relação/afinidade/parentesco/relação_linguística/relação/relevância/relação/pertinência/relação/ligação/fundação/ligação/relação/parentesco/relacionamento/possessão/propriedade/relação_social/propriedade/bem/posse
comando	mandamento/ordem/ordem
base	alicerce/base/pé
acordo	consenso/acordo
organização	calendário/instituição/instituto/delegação/embaixada/comissão/missão/comitê/comité/sistema_econômico/economia/aliança/coligação/coalizão/chapa/partido_político/partido/legenda/quadrilha/gangue/sindicato/consórcio/clube/sociedade/guilda/ordem/companhia/pessoal/elenco/companhia/empresa/entidade_política/coisa_pública/organização/sociedade/ordem/união/associação/sistema_de_referencia/sistemas_de_coordenadas/ordenação
dever	tarefa/designação/papel/função/serviço/incumbência
tempo	serviço_militar/turno_de_serviço/estágio/período/fase/sono/sesta/suspensão/pausa/interrupção/hora/tempo/horário/juventude/partida/pré-história/era/período/idade/tempo/período/escala_de_tempo_geológico/era/época/século/idade/temporada/tempo/estação/tempo/estação/temporada/inverno/estio/verão/primavera/outono/estação_do_ano/estação/tempo/sazão/período/momento/hora/período/prazo/mês/dia/trimestre/século/século/centúria/séculos/década/decênio/ano/ano/ano/semana/noite/noite/noitada/noite/fim_de_tarde/noitada/tarde/noite/manhã/jornada/dia/dia/período_da_vida/época/período/passado/vida/vida/duração_de_uma_vida/vida/semana/duração/continuidade/contínuo/dia/época/momento/período/tempo/era/tacto/vindouro/futuro/porvir/tempos_passados/passado/presente/hoje/actualidade/licença/horas_de_trabalho/tempo_cósmico/periodo_geológico/tempo_geológico/era_geológica/período_geológico/vento/precipitação/precipitação_atmosférica
união	ligação/união/ligação/conexão/coalizão/fusão/coligação/instituição/instituto/união/confederação/federação/quadrilha/gangue/sindicato/consórcio/clube/sociedade/guilda/ordem
ato	atos_da_fala/acto_de_fala/acta/decreto/comunicado/comunicação/uma_comunicação/consulta/distribuição/ação_em_grupo/parada/paralisação/paralização/atrapalhação/impedimento/interferência/ociosidade/habitação/permanência/agressão/hostilidade/juízo/critica/julgamento/uso/atividade/ocupação/rejeição/oposição/economia/mudança/selecção/seleção/escolha/performance/execução/desempenho/realização/falha/insucesso/vinda/chegada/toque/contato/escape/escapatória/fuga/recuperação/impulsão/propulsão/efetuação/execução/realização/implementação/eliminação/disposição/descobrimento/descoberta/partida/causa/causalidade/aquisição/esgrima/interação/trâmite/curso_de_ação/conduta/curso/caminho/corrente/acção/ação/atividade/ato/conquista/façanha/realização/feito/gentileza/delicadeza/amabilidade/bondade/coisa
recurso	predominância/vantagem/benefício
exército	corpo
proposta	assessoramento/recomendação/conselho
justiça	justiça/justeza
objetivo	afeição/paixão/amor/paixão
área	zona/paragem/ponto/parada/região_de_espaço/localidade/cena/refúgio/quadra/quarteirão/bloco/áreas_de_recreio/esconderijo/lugar_predileto/jazida/lugar_de_nascimento/terra_natal/local_de_nascimento/área/tumba/túmulo/sepultura
reunião	acampamento/acampamentos/cimeira/cimeira/conferência/cúpula/reunião/turma/cambada/gangue/ano/classe/curso/classe/aula/curso/município/municipalidade/comunidade/ouvintes/audiências/público/montão/multidão/turba/assembléia/assembleia/par/dupla/sessão/concentração/encontro/reunião/reunião
indústria	produção
representante	chefe_de_estado/chefe_de_estado/agente/mostra/amostra/exceção/excepção
serviço	serviço/profissão/ofício/profissão/arte/cargo/posição/posto
gestão	autorização/gestão/gerenciamento/administração/tratamento
imprensa	periódico/folha/jornal
posição	liderança/nobreza/dignidade/posição/hierarquia/classe/posto/grau/gradação/nacionalidade/nacionalidade/status_social/posto/lugar/condições_sociais/lugar/primeiro/curso/espaço/marina/frente/fronte/direita/lugar/posição/ponto_de_vista/espaçamento/composição/posição/espaçamento
professor	professor_catedrático/professor/catedrático
comércio	pagamento/venda/expedição/transporte/transportação/finança/industria/comércio/negócio/empresa/indústria/manufatura
município	distrito/arraial/aldeia/povoado/vila/burgo/metrópole/metrópoles/cidade
campos	jardim/horto
caso	vez
lado	dianteira/frente/fundo/parte_de_baixo/parte_inferior
vitória	independência/vitória
turno	partida
condição	iniqüidade/maldade/destruição/morte/perigo/segurança/aridez/secas/secura/imunidade/ordem/imperfeição/defeito/perfeição/nudez/necessidade/carência/conforto/ascendencia/controle/dominancia/superioridade/domínio/liderança/nobreza/dignidade/posição/hierarquia/classe/posto/imaturidade/melhoria/melhora/estado/ligação/união/acção/ação/actividade/atividade/movimento/delegação/liberdades_civis/liberdade/delinquência/culpa/iluminação/confronto/recontro/conflito/inimizade/hostilidade/desordem/bagunça/existência/ser/existência/forma_de_vida/nacionalidade/nacionalidade/status_social/posto/lugar/condições_sociais/circunstância/fase/grau/nível/ápice/estado_natural/prisão/cenário/situação/cena/ambiente/ligação/relação/relação/relacionamento/situação/condição/posição/situação/habilidade
plano	programa/configuração/configuração
direção	curso/curso
problema	estrondo/ruído/aflição/azar/má_sorte/infortúnio/problema/dificuldade/obstáculo/problema
forma	ligação/forma_amorfa/forma_distorcida/forma_redonda/forma_angular/linha/figura/forma_natural/plano/sólido/sólida
associação	instituição/instituto/quadrilha/gangue/sindicato/consórcio/clube/sociedade/guilda/ordem
executivo	presidente/diretor/ministro/executivo
entidade	coisa/idéia_abstrata/entidade_abstrata/abstração
época	era/período/idade/velhice/puberdade/infância/idade/dia
coligação	confederação/aliança
educação	experiência/curso/aula
fazenda	plantação/plantio/viveirodeplantas/seda/pano/rede/malha/trama/mohair/mercadoria/artigo/produto/importação/comando_exportar/exportação/crepe/algodão/veludo_cotelê/bens_de_consumo
instituição	estabelecimentos_de_ensino/igrejas/igreja/religião/empresa/companhia
situação	iniqüidade/maldade/destruição/morte/perigo/segurança/aridez/secas/secura/imunidade/ordem/imperfeição/defeito/perfeição/nudez/necessidade/carência/conforto/ascendencia/controle/dominancia/superioridade/domínio/imaturidade/melhoria/melhora/estado/ligação/união/acção/ação/actividade/atividade/movimento/delegação/liberdades_civis/liberdade/delinquência/culpa/iluminação/confronto/recontro/conflito/inimizade/hostilidade/desordem/bagunça/existência/ser/existência/forma_de_vida/circunstância/fase/grau/nível/ápice/estado_natural/prisão/cenário/situação/cena/ambiente/ligação/relação/relação/relacionamento/situação/condição/lugar/posição/situação/habilidade
questão	interrogatório/quesito/indagação/interrogação/pergunta/questão
decisão	alternativa/opção/escolha/intercorrência/eleição/selecção/escolha/passo/movimento/nomeação/designação
companhia	empresa_comercial/empresa/organização_empresarial
trabalhador	trabalhador_especializado/servidor/empregado_doméstico/assalariado/operário/empregado/servidor/criado/assistente/ajudante
região	zona/zona_urbana/áreas_urbanas/área_urbana/região_urbana/campos/gleba/terreno/região/topo/paragem/ponto/parada/vácuo/região_de_espaço/locação/sítio/lugar/lado/localidade/cena/refúgio/quadra/quarteirão/bloco/áreas_de_recreio/praça/espaços_verdes/parque/paisagens_protegidas/parque_público/parque_natural/exterior/lá_fora/camada/estrato/interior/esconderijo/hemisfério/lugar_predileto/região_geográfica/região/área_geográfica/campo/gramado/terreno/campo/extremidade/envolvente/entorno/ambiente/meio/cerque/céu/paraíso/olimpo/alturas/paraíso/domínio/distrito/território/domínio/comarca/districto/circunscrição/circunscrição_administrativa/condado/condados_do_reino_unido/zona_térmica/jazida/campo/terreno/fundo/traseiro/lugar_de_nascimento/terra_natal/local_de_nascimento/profundeza/área/região/território/ambiente/tumba/túmulo/sepultura
hora	hora/meio_dia/meio-dia
agricultura	horticultura
carta	invitação/convite
revista	número
atuação	show/concertos/concerto/concerto_musical/rotina/ato/número/ato/personificação/imitação/caracterização
chapa	placa/tábua/quadro/lousa
porto	cais/porto
ordem	calendário/sequência/série/instituição/instituto/tabela/quadrilha/gangue/camarilha/sindicato/consórcio/clube/sociedade/guilda/ordem/mandamento/ordem/ordem/sistema_de_referencia/sistemas_de_coordenadas
bem	dinheiro/possessão/propriedade/predominância/vantagem/benefício/mercadoria/artigo/produto/importação/comando_exportar/exportação/bens_de_consumo
liderança	gerente/administrador
energia	radiação_solar/radiações/radiação/calor/energia_eléctrica/eletricidade/electricidade/electricidade/potência_eléctrica
artigo	artigo/artigo/louça/mercadoria/artigo/produto/importação/comando_exportar/exportação/bens_de_consumo/carregamento/mercadoria/frete/carga
posto	grau/gradação/posição/primeiro
obra	publicação/edição
formação	nascente/encosta/ladeira/subida/costa/declives/declive/orla/litoral/costa/serra/cadeia_de_montanhas/cadeia_montanhosa/cordilheira/elevação/desembocadura/foz/falésia/alcantilado/penhasco/bicha/linha/fila/bicha/curso/aula
luta	batalha/pugna/peleja/luta/disputa/combate/insurreição/rebelião/revolta/conflito/disputa
controle	orientação/propriedade/possessão
superior	orientador/supervisor
interesse	interesse/caso/preocupação/interesse
fato	ocorrente/acontecimento/ocorrência/ação_em_grupo/ato/ação/feito/acção
propriedade	possessão/riqueza/bem/imobiliária/imóvel/possessão/propriedade/qualidade/carácter_distintivo/característica/qualidade/predominância/vantagem/benefício/grau/grandeza/número/magnitude/fraqueza/força/propriedades_físicas/propriedade_física/propriedades_acústicas/cheiro/odor/constituição/composição/estrutura/maneira/estilo/idade/propriedade/atributo/qualidade/personalidade/temperamento/pessoa/peculiaridade/feição/tempo/forma_geométrica/formato/forma/condição/situação/estado
construção	construção/fabricação
empresário	fornecedor/provedor/proprietário/dono/homemdenegócios/homem_de_negócios/empresário/negociante/comerciante/corretor/intermediário/broker
segurança	segurança/certeza/aprumo/desembaraço/fé/pose/altivez
abertura	fenestra/janela/fresta/buraco/fenda/capialço/colarinho/buraco/furo/vão/saída/escapatória/porta/corte
responsável	gerente/administrador
aprovação	proteção/mecenato
família	genealogia/árvore_genealógica/casamento/casal/povo/família/família/família/categoria_gramatical/género/classe/tipo/categoria/raça/espécies
resultado	efeito/efeitos/influência/vencimento/derrota/perda/vitória/términio/parada/destruição/desolação/demolição/conseqüência/resultado/resultado/placar
documento	registro/reporte/estudo/relatório/relato/missiva/carta/documento_oficial/negócio_jurídico
departamento	ramo/broto/departamento/departamento
número	quadrado/base/marcador/contagem/conta/soma/montante/número/totalizar/extensão/alcance/maioridade/ascendência/maioria/número/aumento/acrescentamento/quantidade/número/magnitude/dimensão/tamanho/medida/dimensão/extensão/amplidão/magnitude/extensão/magnitude/proporção/tamanho/dimensão
momento	saída/início/princípio/começo/hora/segundo/instante/momento/data_limite/prazo_final/data_final/prazo/dia
lugar	posição/foco/foco/passos_de_montanha/passo_de_montanha/região/área/canto/vértice/marina/regiões/região/região/frente/fronte/direita/lugar/posição/lugar/local/posição/lugar/fronteira/centro/ponto_médio/ponto_celestial/floresta/selva/procedência/fonte/raiz/nascente/lar/casa/umbigo/profissão/ofício/profissão/arte/cargo/posição/posto
pai	progenitora/mãe/pai/papá/painho/papai
mato	camellia_sinensis/pimenta/pimentão/rosa/rosas/rosa/algodão
produção	película/filme/produção/cinema/produto/produção/fruto/obra/trabalho/jornal/revista/produção/livros/livro/cultivo/criação/rendimento
operação	ofensiva/ataque/campanha/manobra/combinação
classe	liderança/nobreza/dignidade/posição/hierarquia/classe/posto/grau/gradação/nacionalidade/nacionalidade/status_social/posto/lugar/condições_sociais/primeiro/mulherio/mulher/ordem/mercado/classe_média/burguesia/fraternidade/ordem/irmandade/categoria_gramatical/espécie/género/estilo/tipo/variante/versão/género/classe/espécie/tipo/variedade/género/classe/tipo/categoria/raça/espécies
ponto	passos_de_montanha/passo_de_montanha/regiões/região/região/lugar/fronteira/floresta/selva/lar/casa/virada/ponto_de_viragem/crise
dívida	encargo/imposto/taxa/crédito/empréstimo/crédito/empréstimo/dívidas/dívida/dívida/débito
ensino	curso/aula
exercício	revisão
discurso	preleção/palestra/género_literário/gêneros_literários/gênero_literário/dispositivo/idioma/linguagem/língua_natural/linguagem_natural/língua
orientação	ideologia/perspectiva/posição/visão/mirada
ciência	lingüística/lingüística/linguística/psicologia/psicólogos_por_nacionalidade/ciências_físicas/fisica/física/física/quimica/química/ciências_da_vida/ciência_exacta/matematica/matemática/ciências_exactas/ciências_físicas/ciências_naturais/ciência
esquema	configuração/configuração
crime	furto/roubo/infracção/infração/crime
sociedade	instituição/instituto/quadrilha/gangue/sindicato/consórcio/clube/sociedade/guilda/ordem
pedido	consumo/pergunta/questão/inquérito/apelo/reza/oração/petição/apelo/petição/súplica/invitação/convite/petição
fundo	pé
realização	meio/caminho/jeito/modo/maneira/ferramenta/andada/andar_até_a_primeira_base/mecanismo/mecanica/triunfo/êxito/sucesso/récorde/obtenção/realização/chegar_la/façanha/proeza/batida/rebatida/jogada/façanha/proeza/realização/feito
disputa	conflito/disputa
estado-maior	mediação
necessidade	necessidade/deficiência/escassez/carência/falta/ausência/moralidade/moral/ética/morais/vida
aumento	concentração/aumento/desdobramento_de_ações/engrandecimento/enaltecimento/acumulação/acúmulo/aumento
assistência	piedade/misericórdia/apoio/suporte/consolação/consolo/conforto/socorro/assistência/ajuda/mão/ajuda
pessoa	cientista/governante/governador/parte/dono/proprietário/possuidor/amo/vizinho/homem/pessoa/vida/estudante/aluno/parente/esperança/conhecido/amiga/camarada/amizade/amigo/seguidor/estudante/ser/criatura/criança/autoridade/proponente/representante/advogado/defensor/juiz/árbitro/adjudicator/amizade/conhecido/conhecida/amigo/hebreu/judeu/hebraico/hebreia/judia/hebraica/trabalhador/pessoa_sem_treinamento/infortunado/desventurado/desafortunado/turista/viajante/pessoa_religiosa/súdito/cidadão/macho/varão/homem/chefe/líder/amante/amado/menor/juvenil/jovem/intelectual/intelecto/autóctone/habitante/morador/fêmea/face/rosto/cara/especialista/artista/engenheiro/criativo/creador/criador/competidor/contendor/comunicador/capitalista/anomalia/pessoa_estranha/identidade/personalidade
mudança	avaria/estrago/prejuízo/dano/diferença/transmutação/mudança/transformação/transição/progresso/melhoria/aumento/crescimento/queda/diminuição/abatimento/decréscimo/falecimento/morte/variação/mudança/flutuação/nascimento/surpresa/mudança_de_magnitude/golpe/reorientação/rotação/inclinação/sinal/gesto/agitação/mudança/traslado/movimento/deslocamento/ajuste/alteração/modificação/mudança_de_estado/ascenção/promoção/mudança/conversão/reviravolta
linha	limite/margem_interior/fronteira/borda/reta/recta/arco/curva/direcção/direção/rumo/curso/curvas/curva/encabeçamento/corda
pessoal	ralé/clientela/freguesia/geração/mediação/população/mundo/povo/gente/gente/nação/povo/classe_social/classe/estrato/galera/pessoal/vulgo/povo/nação/gente/inimigo/coorte
preço	taxa/custo/preço/recompensa/pagamento/magnitude/importância/custo/preço/preços/custos
povo	ralé/clientela/freguesia/geração/espectador/audiência/população/mundo/povo/gente/gente/nação/povo/classe_social/classe/estrato/galera/pessoal/vulgo/povo/nação/gente/inimigo/coorte
indicação	identificação/registro/evidência/indicação
terra	areia/planície/campanha/ilha/arvoredo/mata/floresta/bosque/selva/florestas/chão/terra
combate	guerra/conflito/disputa/proteção/defesa/luta/combate/batalha
quadro	tábua_de_passar_roupa
profissional	jurista/advogado/médico/educador/educacionista/pedagogo
inquérito	interrogatório/quesito/indagação/interrogação/pergunta/questão
pagamento	recompensa
exploração	colonialismo
responsabilidade	desvantagem
debate	conversa/negociação/tramitação/debate/discussão
tentativa	atividade_comercial/teste/batalha/luta/esforço/tacada/chute/tentativa/tentativa
possibilidade	oportunidade/chance/potenciabilidade/potencial/suposição/pressuposição/hipótese
representação	fotografia/retrato/imagem/foto/modelo/esquema/mapa/ilustração/figura/desenho/imagem/documentos/documento/reprodução/cópia/retrato/ato/personificação/imitação/caracterização
filha	filha
casa	lar/casa/refúgios_na_montanha/habitação/apartamento/moradia/quartos/edifício_residencial/habitação/casa/vivenda/albergue/hostelalbergue/aposento/habitação/moradia/residência/casa/lar/morada/domicílio/acampamento/apartamento
assunto	história/modo_narrativo/narrativa/narração/proposta/afirmação/declaração/aplauso/aprovação/informação/reconhecimento/significância/significação/intenção/significado/tema/matéria/assunto/tópico/área
distribuição	partilha/partição/divisão/repartição
imposto	taxação/colectas/tributo/taxa/impostos/imposto/imposto
princípio	criação/concepção/alvorecer/amanhecer/manhã/madrugada/princípio/início/começo/origem/começo/gênese/iniciação
caráter	ânimo
transporte	entrega
unidade	molécula/radical/grupo_químico/unidade_de_peso/peso/unidade_métrica/cadeia/totalidade/soma/artefato/objeto_natural/objeto_natural
golpe	porrada/golpe/chute/pontapé
liberdade	independência/liberdade/autonomia/liberalismo
valor	preço/mérito/merecimento/virtude/qualidade/preço/preços
conhecido	conexão/colega/companheiro/amigo/camarada/amigo/irmão/companheiro/colega/camarada/amigo/companheiro/camarada/irmão
virtude	predominância/vantagem/benefício/justiça/honestidade
opinião	ser_sobrenatural/espirito/opinião_pública/crença_religiosa/fé/religião/perspicácia/pensamento/opinião/escola_de_pensamento/doutrina/filosofia/fé/confiança/certeza/convicção/fé/ideia/motivo/tema/sentido/intenção/significado/programa/projeto/intenção/programação/plano/projecto/ideia/opinião/juízo/concepção/idéia/conceito/ideia
êxito	sensação/sucesso/estrondo
conflito	fricção/atrito/batalha/pugna/peleja/luta/disputa/combate/insurreição/rebelião/revolta
encontro	sessão
dom	prêmio/galardão/prémio/apoio_financeiro/ajuda_financeira/ajuda
título	título
seção	conclusão/curva
estudante	pupilo/estudante/aluno
pressão	compactação/esmagamento/pressão/compressão
instalação	água/redes_de_distribuição_de_água/fornecimento_de_água/instalação/estação/posto/fonte/origem/carreiras_de_tiro/aquecimento/calefação/calefacção/centrais_de_aquecimento/pista/campo/sistemas_de_comunicações/aeroporto/aeródromo
livro	obra_de_referência/autoridade/diário
local	marina/frente/fronte/direita/lugar/posição
funcionário	servidor_federal/agente_federal/servidor/official_de_justiça/magistrado/juiz/jurista
médico	ama-seca/aia/enfermeiro/enfermeiros/enfermeira/médico/dr./doutor/médico/odontólogo/dentista
homem	homem/homem/rapaz/menino/moço/menino/rapaz/garoto/cavalheiro/senhor/rapaz/garoto/moço/homem/menino/sujeito/cara
declaração	observação/comentário/resultado/resposta/explicação/explanação/declaração/asserção/descrição/aval/garantia
crescimento	concentração/cultura
escolha	cabimento/possibilidade/voto/eleição/votação/eleição/escolha/decisão/resolução
servidor	secretária_executiva/secretária/secretário/modelo/manequim/servidor/empregado/doméstico
relatório	fofoca/bisbolhetice/bisbilhotice/piada/historieta/anedota
discussão	conversa/negociação/tramitação/debate/discussão
igreja	igreja/templo/igrejas
solução	suspensão/soluto/soluto/solução/solução/liga_metálica/ligas_metálicas/liga/ligas_metálicas
compra	retorno/restituição/herança/espólio
papel	folhas/folha/folha/folha_de_papel/folhas/papel/cartas_geográficas/cartão/carta/lugar/posição/papel
corrente	ribeira/regato/rio/caminho
nível	alcance/auge/ápice
idéia	ideia/motivo/tema/sentido/intenção/significado/programa/projeto/intenção/programação/plano/projecto/suposição/possibilidade/hipótese/teoria/lei_da_natureza/lei/totalidade/componente/soma/número/quantidade/abstrato/abstracto/abstracção/característica/carácter_distintivo/qualidade/propriedade/atributo/classe/família/categoria/concepção/idéia/conceito/ideia
espírito	felicidade/alegria
autoridade	autoridade_civil/mestre/professor/avaliador/julgador
série	sucessão/série/curso
informação	reporte/contas/relatório/relato/artigo/notícias/notícia/segredo/arcano/notícias/informação/base_de_dados/banco_de_dados/fato/material/materiais/estimulante/estímulo/base/fundo_do_ecrã/consideração/circunstância/representante/instância/exemplo/facto/verdade/leitura/dado/dado/datum/informação
texto	linha/melodia/missiva/carta/texto
estabelecimento	estabelecimentos_de_ensino/igrejas/igreja/religião/empresa/companhia/universidade/estabelecimento_comercial/estabelecimento_de_negócios/instituição
assembleia	corte/tribunal_de_justiça/tribunal/juizado/assembléia_legislativa/legislatura/poder_legislativo
idade	era/período
população	clientela/freguesia/geração/população/mundo/povo/gente/gente/nação/povo/classe_social/classe/estrato/galera/pessoal/vulgo/povo/nação/gente/inimigo/coorte
taxa	razão_focal/níveis_de_eficácia/imposto
emprego	oficina/chácara/granja/quinta/sítio/fazenda/central_telefónica/central/central_telefônica/rito/ritual/profissão/ofício/profissão/arte/cargo/posição/posto/hábito/costume
tema	área
viagem	excursão/passeio/parada/etapa/jornada/viagem/andada/passeio/caminhada
campo	ciências_aplicadas/ciência_aplicada/engenharia/ciências_aplicadas/tecnologia/disciplina_cientifica/ciência
produto	película/filme/produção/cinema/produto/produção/fruto/obra/trabalho/jornal/mercadoria/artigo/produto/revista/importação/comando_exportar/exportação/produção/bens_de_consumo/carregamento/mercadoria/frete/carga/livros/livro
comunicação	documento/catequizar/persuasão/convencimento/teste/exame/expressão/discussão/discurso/voz_humana/voz/linguagem/estilo/discurso/língua/arte_dramatica/dramaturgia/teatro/comunicação_visual/comunicação_visual/agouro/presságio/indício/indicação/sinal/anúncio/sinal/mensagem/assunto/tópico/conteúdo/linguagem/discurso/idioma/língua/serviço_postal/correios/correio/mensagem/transmissão
dificuldade	problema/dificuldade/obstáculo/problema/subtileza/sutileza/fineza/rigor
prática	revisão
limite	cota_superior/superfície/fronteira/limite/fronteira/borda/limite/fronteira/borda/margem/limite/delimitação/borda/fronteira/fronteira/limite/borda/aba
conjunto	interseção/organização/sistema/povo/gente/massa/população/população/povo/gente/espaço_topológico/povo/raça/raças_humanas/linhagem/acúmulo/aglomeração/colecção/coleção/grupos_sociais/pessoal/população/povo/gente/grupo_biológico/reino/arranjo/espécie_humana/homem/povo/mundo/humanidade
bloco	laje/placa/bigorna/bigorna
conseqüência	efeito/efeitos/influência
estrutura	calendário/equilíbrio/contrapeso/sistema_de_referencia/sistemas_de_coordenadas/estrutura/arquitectura/arquitectura_do_computador/janela/fenestra/torres/torre/roque/arena/estádio/asilo/refúgio/alpendre/divisória/paredes/parede/obstrução/impedimento/obstáculo/monte/corcova/monumento/monumentos/alojamento/abrigo/casa/pavimento/piso/andar/estabelecimento/defesa/cruz/edifício/prédio/ponte/sacada/varanda/balcão/varanda/arco/arco
ligação	continuidade/ligação/união/coesão/coerência/ligação/ligação/conexão/coalizão/fusão/coligação/amizade/junção/ligação/articulação/relação/relevância/relação/pertinência
edição	jornal/periódico/publicação_periódica/revista/coleção/compêndio/coletânea/livro
protesto	protesto/ação_direta
derrota	capitulação/rendição
fiscalização	verificação/limite/controle/inspeção
matéria	sólido/matéria_sólida/sólida/residuo/líqüido/fluido/sedimento/depósito/área/substância
garantia	aval/garantia
divisão	ramo/broto/departamento/departamento/parte/parcela
motivo	moralidade/moral/ética/morais/vida
contato	pegada/agarrão/pegar/ósculo/beijo/contato/batida
investigação	inquérito/pesquisa/inspecionar/examinar
arma	revólver/arma/revóvel/arma_de_fogo/bomba/munição/munição_de_guerra
resistência	protesto/oposição/confronto
autor	poetas/poeta/poetisa/jornalista/periodista
sucesso	sensação/sucesso/estrondo
nação	ralé
conclusão	vencimento/derrota/perda/vitória/términio/parada/destruição/desolação/demolição/resultado/placar/desaparecimento/morte/homicídio/assassinato/destruição/devastação/demissão
existência	possibilidade/chance/possibilidade/chance/vida/animação/vida/animação/vida/existência/vida/existência/presença/presença/realidade/realidade
causa	ameaça/risco/perigo/princípio_vital/poder/força/manipulador/operador/fado/aventurança/destino/fator/efeito/indivíduo/pessoa/alguém/ser_humano/alma
território	região_de_espaço/localidade/cena/refúgio/quadra/quarteirão/bloco/áreas_de_recreio/jurisdição/lugar_predileto/bairro/vizinhança/jazida/divisão_territorial/divisão_administrativa/distrito_administrativo
origem	causa
fase	alcance/auge/ápice
negócio	expedição/transporte/transportação/finança/negociação/transação/indústria/manufatura
venda	farmácia/farmacia/botica/drograria/drogaria/venda/venda
folha	lauda/escudeiro/página/folhas/folha
corpo	partículas/partículas_sólidas/partícula_subatómica/partícula/partícula_subatômica/companhia/divisão/restos_mortais/corpo/defunto/enchido/cadáver
rocha	pedra/litíase/matacão/rochedo/pedra/rocha/pedregulho
registro	índices/registrador/registo/crónica/crônica/ficheiro/fichário
conceito	ideia/motivo/tema/sentido/intenção/significado/programa/projeto/intenção/programação/plano/projecto/suposição/possibilidade/hipótese/teoria/lei_da_natureza/lei/totalidade/componente/soma/número/quantidade/abstrato/abstracto/abstracção/característica/carácter_distintivo/qualidade/propriedade/atributo/classe/família/categoria/concepção/idéia/conceito/ideia
falta	escassez/ausência
mulher	mulher/esposa/senhora/dama/mulher/dona/dona_de_casa/dona-de-casa/moça/mulher/rapariga/senhorita/garota/madame/senhora/dama
concurso	corrida/partida/luta/combate/jogo/competição/torneio/corrida
mesa	mesa/secretária/escrivaninha
atitude	ponto_de_vista/orientação/respeito/deferência/intolerância/tendência/mentalidade
exemplo	vez/mostra/amostra/exceção/excepção
dinheiro	moeda/cache/numerário/em_espécie/dinheiro/cobres/guito/massa/dinheiro/grana/moeda/dinheiro/divisa/capital/fundo
ambiente	domínio/âmbito/esfera/circunstância/contexto/região_de_espaço/localidade/cena/refúgio/quadra/quarteirão/bloco/áreas_de_recreio/lugar_predileto/jazida
execução	meio/caminho/jeito/modo/maneira/ferramenta/mecanismo/mecanica
praça	largo/piazza/praça/adro
disposição	aspiração/ambição
fusão	confederação/aliança
amigo	conexão/colega/companheiro/amigo/camarada/amigo/irmão/companheiro/colega/camarada/amigo/companheiro/camarada/irmão
juiz	official_de_justiça/magistrado/juiz/jurista
usina	casademoinho/fábrica/manufatura/usina
razão	razão_focal/níveis_de_eficácia
luz	luz_solar/luz_do_sol/sol/luz_da_lua/luar
intenção	moralidade/moral/ética/morais/vida/objetivo/intenção/fim/ponto_de_mira/programa
estrada	direcção/direção/rumo/curso/caminho/rodovia/via/estrada/caminhos/trilhos/caminho/senda/trilho/caminho/estrada/trilha/passagem/caminho/alameda/entrada_de_carros/caminho/entrada/avenida/caminho/acesso/estrada/abordagens
produtor	produtores_de_cinema/cineasta/produtor_cinematográfico
jogo	partida/classe/união/parelha/par/corrida/partida/luta/combate/jogo/competição/torneio/corrida/jogo_de_salão/jogo_de_salão/jogo_de_cartas/esporte
continuidade	trecho/período
lista	lista/conjunto_de_caracteres
visita	visita/visitante/companhia/visita_de_inspeção/visitação/visita
uso	utilização/aplicação/desenvolvimento/exploração/jogar
publicação	jornal/periódico/publicação_periódica/revista/coleção/compêndio/coletânea/livro
qualidade	faceta/qualidade/carácter_distintivo/característica/qualidade/impotência/habilidade/poder/magnitude/importância/custo/preço/preços/custos/valor/importância/moralidade/moral/virtude/elegância/popularidade/regularidade/certeza/diferença/semelhança/similardidade/qualidade/característica/natureza/incompatibilidade/dificuldade/aspecto/aparência/semblante
alteração	avaria/estrago/prejuízo/dano/transmutação/mudança/transformação/transição/aumento/crescimento/queda/diminuição/abatimento/decréscimo/falecimento/morte/variação/mudança/flutuação/nascimento/surpresa
esforço	atividade_comercial/teste/batalha/luta/esforço/tacada/chute/tentativa/tentativa/exercício_físico/exercício_fisico/batalha/luta
quarto	casa_de_banho/banheiro/sala/biblioteca/cozinha/sala/hall/casa_de_banho/banheiro/quarto_de_banho/sala_de_banho/bar
assistente	secretária_executiva/secretária/secretário/modelo/manequim
ativo	crédito/dinheiro/finanças/fundos/fundo_de_maneio/capital/fundos/recurso_material/seguro/fundos_de_investimento/investimento/custo/atribuição
humano	espécie_humana/homem/povo/mundo/humanidade
importância	significação/significado/preço/mérito/merecimento/virtude/qualidade/preço/preços
julgamento	revogação/cálculo/estimativa/avaliação
transferência	entrega
jornada	anoitecer/véspera/tarde/fim_de_tarde/noite/tarde/excursão/passeio
presente	prêmio/galardão/prémio/apoio_financeiro/ajuda_financeira/ajuda
jovem	jovem/menino/criança
efeito	efeito/efeitos/influência
técnica	sistema/arte/habilidade
escritório	órgão/órgão_público/secretaria
proteção	seguro/seguros/proteção/protecção/escudo/amparo/telhado/teto/cortina/cuidado/tutela
meta	objetivo/intenção/fim/ponto_de_mira/arte/habilidade
ataque	tiro/bombardeio/ataque/assalto
instrumento	meios_de_comunicação/mídia/chicote/açoite/chibata/equipamento_militar/arma/armamento/munição/arma/armamento/exaustor/circulador_de_ar/ventilador_pulmonar/ventilador/ferramenta/utensílio/ferramenta/implemento/instrumento/instrumento_musical/artigos_de_toalete/sistema/suporte/encosto/apoio/instrumento_de_cordas/pau/bastão/vara/arpão/lança/lâmpada/luz/barra/limitação/restrição/instrumentos_de_percussão/instrumento_de_percussão/agulha/instrumento_musical/instrumento/mecanismo/instrumentos_de_medida/instrumentos_de_medição/metro/instrumento_de_medida/ferramenta/magnete/íman/ímã/maquinaria/máquina/acendedor/encendedor/isqueiro/botão_de_accionamento/chave/tecla/aparelho/ferramenta/instrumento/instrumento/ferramenta/implemento/aquecedores/aquecedor/guarda/aparelho_de_seguranca/móvel/mobília/mobiliário/leque/ventilador/equipamento/ferramenta/aparelho_eletrônico/equipamento/ferramenta/aparato/aparelho/mecanismo/dispositivo/instrumento/meios_de_transporte/modo_de_transporte/veículo/recipiente/contentor/contêiner/ligação/conector/pente/brocha/escova_de_dentes/pincel/escova
acontecimento	quebra/colapso/revés/cerimónia/cerimônia/festa/celebração/rotulagem/festa/festa/balada/explosão/surto/surto/erupção/epidemia/deflagração/ocasião/ponto/conjuntura/convergência/som/ruído/interrupção/pausa/toque/sorte/destino/fado/vitória/desastre/movimento/instância/ocorrência/exemplo/caso/ocasião/incidente/evento/fogo/incêndio/acidente/coincidência/alteração/mudança/variação/modificação/princípio/início/começo/acontecimento/eventualidade/evento/episódio/coisa/problema/experiência/ocorrente/acontecimento/ocorrência/ação_em_grupo/ato/ação/feito/acção
transformação	progresso/melhoria
grau	alcance/auge/ápice/intensidade
suspensão	vapor
acadêmico	professor_catedrático/professor/catedrático
oportunidade	chance/ouvinte/audiência/dia
espaço	ângulo/ângulos/fenda/vão/extensão/espaço_topológico
colaboração	representação
atribuição	participação_nos_lucros
código	pacote_de_software/software/programa
tipo	espécie/género/estilo/tipo/variante/versão/género/classe/espécie/tipo/variedade
agência	órgão/órgão_público/secretaria
custo	pagamento_adiantado/prejuízo/perda/vermelho/taxa/custo/preço/recompensa/pagamento/ganho/lucro
preparação	cozinha/culinária/exercício/prática
encargo	imposto
desempenho	mecanismo/mecanica
doença	fitopatologia/doenças_das_plantas/tumores/doenças/doença/colapso/doença
via	caminho/rodovia/via/estrada/caminho/estrada/trilha/passagem/caminho/alameda/entrada_de_carros/caminho/entrada/avenida/caminho/acesso/estrada/abordagens
preocupação	preocupação/temor/medo/interesse/caso
liga	aço
passo	velocidade/rapidez/manobra
categoria	resíduo/sobra/excedente/resto/restante/membro/unidade/componente/elemento/componente/item/categoria_gramatical/unidade_da_linguagem/unidade_linguística/espécie/género/estilo/tipo/género/classe/espécie/tipo/variedade/género/classe/tipo/categoria/raça/espécies/substância
verdade	detalhe
experiência	vida/mundo/realidade
moeda	dólar/divisa/prata/peça/moeda/moeda/cache/numerário/em_espécie/dinheiro/cobres/guito/massa/dinheiro/grana/moeda/dinheiro/divisa/capital/fundo
agente	booker/medicamento/produtos_farmacêuticos/remédio/droga/entorpecente
mota	mota/motocicleta/ciclomotor/mota/moto/motocicleta
gasto	custos/preço/custo/gastos
capacidade	faculdade/talento/habilidade/talento/habilidade/meta/técnica/criatividade/criatividade/aptidão/inteligência/liderança/habilidade
atentado	assalto
critério	sistema_monetário
massa	espectador/audiência
máquina	roda/motor/motores/moinhos/moinho/maquinário/máquina/maquinaria/calculadora/computador
contas	fofoca/bisbolhetice/bisbilhotice/piada/historieta/anedota
conhecimento	atitude/ciência/campo/domínio/disciplina/estimulante/estímulo/base/fundo_do_ecrã/consideração/circunstância/representante/instância/exemplo/facto/verdade/dado/datum/informação/informação/conhecimento/objecto_mental/incapacidade/poder/capacidade/talento/habilidade/mente/psique/cabeça
rumo	curso/curso
extensão	altitude/altura/extensão/limite/limitação/fronteira
saber	ciência/campo/domínio/disciplina
dispositivo	figuras_de_linguagem/figura_linguagem/exaustor/circulador_de_ar/ventilador_pulmonar/ventilador/suporte/encosto/apoio/lâmpada/luz/limitação/restrição/instrumento_musical/instrumento/mecanismo/magnete/íman/ímã/maquinaria/máquina/acendedor/encendedor/isqueiro/botão_de_accionamento/chave/tecla/aparelho/ferramenta/instrumento/aquecedores/aquecedor/guarda/aparelho_de_seguranca/leque/ventilador/aparelho_eletrônico/pente
modificação	avaria/estrago/prejuízo/dano/transmutação/mudança/transformação/transição/aumento/crescimento/queda/diminuição/abatimento/decréscimo/falecimento/morte/variação/mudança/flutuação/nascimento/surpresa
aspecto	feiúra/feiura/feiúra/beleza/belo/rosto/semblante/aparência/rosto/face/aparência/rosto/aspecto/aparência
teto	abóbada
residência	lar/casa/edifício_residencial/habitação/casa/vivenda
diferença	diferença/distinção
embarcação	iate/navio_de_guerra/navios_de_guerra/navio_de_guerra/vapor/barco_a_vapor/navios/embarcação/navio/barco/batel/escaler/barco/bote
dado	hora/leitura/dado
transação	comércio/mercantilismo/comercialismo
entrada	registro/matrícula/matricula/inscrição
transmissão	canaleta/canal_da_mancha/canal_de_trasmissão/canal
maneira	caimento/feitio/corte/jeito_pessoal/maneira_pessoal/modo/maneira
pronunciamento	directiva/diretiva/diretriz
defensor	guarda
zona	ilha/separador_central
paz	consenso/acordo
composição	estrutura/arquitectura/arquitectura_do_computador/unificação/junção
atenção	concentração
tratamento	cuidados_médicos/cuidado_médico/cuidados_médicos
tarefa	atividade_comercial/empreendimento_de_risco/bebê/aventura/projeto/tarefa/encargo/missão/guarda/vigia/obrigação/dever/assintência/cuidado/investigação/mão-de-obra/trabalho/procedimento/operação
independência	autonomia/liberalismo
expressão	provérbio/expressão_idiomática/ditado
equipamento	meios_de_comunicação/mídia/equipamento_militar/arma/armamento/munição/exaustor/circulador_de_ar/ventilador_pulmonar/ventilador/artigos_de_toalete/sistema/suporte/encosto/apoio/equipamento_de_esportes/equipamento_esportivo/lâmpada/luz/limitação/restrição/instrumento_musical/instrumento/mecanismo/ferramenta/material/magnete/íman/ímã/maquinaria/máquina/acendedor/encendedor/isqueiro/botão_de_accionamento/chave/tecla/aparelho/ferramenta/instrumento/instrumento/ferramenta/implemento/aquecedores/aquecedor/guarda/aparelho_de_seguranca/parafernália/móvel/mobília/mobiliário/leque/ventilador/equipamento/ferramenta/equipamento_eletrônico/aparelho_eletrônico/equipamento/ferramenta/aparato/aparelho/mecanismo/dispositivo/instrumento/meios_de_transporte/modo_de_transporte/veículo/recipiente/contentor/contêiner/ligação/conector/pente/aparato/equipamento/aparelho
caminho	trilha/direcção/direção/rumo/curso/caminho/rodovia/via/estrada/caminhos/trilhos/caminho/senda/trilho/caminho/estrada/trilha/passagem/caminho/alameda/entrada_de_carros/caminho/entrada/avenida/caminho/acesso/estrada/abordagens/caminho
fronteira	cota_superior/caminho/curso/superfície/rota/caminho/percurso/itinerário/estrada/linha/itinerários/fronteira/limite/círculo_máximo/fronteira/borda/limite/fronteira/borda/margem/limite/delimitação/borda/fronteira/fronteira/limite/borda/aba
reconhecimento	agradecimento/saudação
perda	capitulação/rendição
mensagem	documento/história/modo_narrativo/narrativa/narração/proposta/voz_humana/voz/linguagem/estilo/discurso/língua/comunicação_visual/comunicação_visual/agouro/presságio/indício/indicação/sinal/anúncio/sinal/afirmação/declaração/aplauso/aprovação/informação/reconhecimento/telegrama/significância/significação/intenção/significado/tema/matéria/assunto/tópico/mensagem/assunto/tópico/conteúdo/linguagem/discurso/idioma/língua/correio/mensagem
sangue	família/grupo_sangüíneo/grupo_sanguíneo/grupo_sangüíneo/grupo_sanguíneo
organismo	fungos/fungo/mutante/mutação/mutantes/pessoa/indivíduo/anfitrião/hospedeiro/comensalismo/parasita/microorganismo/microrganismo/vegetal/planta/flora/besta/criatura/ser/bicho/animal/indivíduo/pessoa/alguém/ser_humano/alma/célula/vida/ser/organismo
jornalismo	periódico/folha/jornal
imagem	fotografia/retrato/imagem/foto/modelo/esquema/mapa/ilustração/figura/desenho/imagem/documentos/documento/reprodução/cópia
clima	vento/precipitação/precipitação_atmosférica
bicho	larva/ave_de_caça/caça/presa/predadores/invertebrado/invertebrados/cordados/herbívoro/cria/filhote/prole/macho/fêmea/animal_doméstico/animal_doméstico
navio	iate/navio_de_guerra/navios_de_guerra/navio_de_guerra/vapor/barco_a_vapor/navios/embarcação/navio/barco/batel/escaler/barco/bote/aeroplano/aeronave/avião
legalidade	validade/legalidade
comunidade	voto/júri/júri/grupo_profissional/vocação/associação/assentamento/colônia/aldeia/vila/povoado/bairro/vizinhança/administração/organização
alvo	objetivo/intenção/fim/ponto_de_mira
fábrica	casademoinho/fábrica/manufatura/usina
água	corrente/córrego/mar/poça/charco/lago
palavra	forma_flexionada
mecanismo	exaustor/circulador_de_ar/ventilador_pulmonar/ventilador/suporte/encosto/apoio/lâmpada/luz/limitação/restrição/instrumento_musical/instrumento/mecanismo/aparelho_mecânico/magnete/íman/ímã/maquinaria/máquina/acendedor/encendedor/isqueiro/botão_de_accionamento/chave/tecla/aparelho/ferramenta/instrumento/aquecedores/aquecedor/guarda/aparelho_de_seguranca/leque/ventilador/aparelho_eletrônico/pente
figura	sub-figura/figura_de_duas_dimensões/figura_plana/fotografia/retrato/imagem/foto/modelo/esquema/mapa/ilustração/figura/desenho/imagem/documentos/documento/reprodução/cópia
pe	pata/pezunho/casco/casco
natureza	disposição/temperamento
torres	minarete/farol
cooperação	representação
impedimento	obstáculo/atrapalhação/interferencia/obstáculo/obstáculo/obstáculo/barreira/obstáculo/trava/barra/obstrução
resolução	passo/movimento/nomeação/designação
comerciante	proprietário/dono
criança	rapaz/menino/filha/bebé/nenê/recém-nascido/criancinha/bebê
examinar	inspeção/vistoria/busca/revisão/acompanhamento/comparação
fator	ponto
termo	forma_flexionada
concentração	foco/concentração/concentração
utilização	utilização/aplicação/desenvolvimento/exploração/jogar
cobertura	embalagens/invólucro/cobertura/capa/tampa/cobertor/cobertura/capa/envólucro/proteção/capa/máscara/calçado/calçados/tapete/camada/capa/vestimenta/roupa/vestido/traje/vestuário/camuflagem
instrução	prescrição/normas_jurídicas/norma/regra/experiência/curso/aula
face	dianteira/frente/fundo/parte_de_baixo/parte_inferior
memória	associação/conexão
despesa	custos/preço/custo/gastos
pensamento	ideia/motivo/tema/sentido/intenção/significado/programa/projeto/intenção/programação/plano/projecto/ideia/opinião/juízo/concepção/idéia/conceito/ideia
escritor	poetas/poeta/poetisa/jornalista/periodista
autorização	delegação
cidadão	cidadão/cidadã
evento	ocorrente/acontecimento/ocorrência/ação_em_grupo/ato/ação/feito/acção
reajuste	alinhamento
conjuntura	virada/ponto_de_viragem/crise
infra-estrutura	água/redes_de_distribuição_de_água/fornecimento_de_água/instalação/estação/posto/fonte/origem/carreiras_de_tiro/pista/campo/sistemas_de_comunicações/aeroporto/aeródromo
opção	cabimento/possibilidade
deus	santo/santo
século	era/período
apresentação	exibição/exposição
conquista	andada/andar_até_a_primeira_base/obtenção/realização/chegar_la/façanha/proeza/realização/feito
recuperação	salvamento/salvação
elevação	montanhas/montanha/montanhas/monte/montanha/barranco/ladeira/colina/morro/monte/escalada
personalidade	ânimo/identidade/personalidade
manobra	ofensiva/ataque/campanha/manobra/obstrução
ocupação	desabafo/divertimento/galhofa/diversão/liderança/comportamento/comportamento/conduta/amparo/suporte/auxílio/socorro/ajuda/assistência/preparação/mercado/provimento/abastecimento/fornecimento/posicionamento/colocação/ocultação/adoração/cerimônia/processo/procedimento/agrupamento/organização/calibração/medição/medida/mensuração/manobra/operação/utilização/uso/procurar/buscar/criação/representação/treinamento/preparação/treino/atividade_sensorial/atividade_sensorial/protecção/proteção/controle/controlo/esforço/tentativa/desperdício/delito/transgressão/escrita/profissão/ofício/profissão/arte/cargo/posição/posto/trabalho/tarefa/animação/atuação/representação/interpretação/música/vez/jogo/jogo/recreaçao/diversão/hábito/costume/operação
ajuda	piedade/misericórdia/apoio/suporte/consolação/consolo/conforto/socorro/assistência/ajuda/mão/ajuda
prédio	teatro/casa/templo/departamento/colégio/escolas/escola/restaurante/igreja/casadeoração/lugares_de_prática_religiosa/templo/edifício_ministerial/ministério/edifício_residencial/habitação/casa/vivenda/hotel/salão_de_convenções/hall/centro_de_convenções/estufa/plantel/viveiro/clube/centro
programação	programa
periódico	número
doce	caramelo/bala
alternativa	cabimento/possibilidade
ausência	escassez
canal	orifício/ducto/duto/pipeline/condutas/canais/conduto/cano/chaminés_de_fábrica/canal/tubo/cachimbo
acidente	acidente
contabilidade	conta_bancária
ascensão	escalada
postura	ponto_de_vista
rodovia	entrada_de_carros/caminho/entrada/avenida
melhoria	anexo/asa/reparo/reparação/conserto/reforma/retificação/correção/limpeza/limpada/desenvolvimento
transição	pulo/salto
aquisição	doação/presente/dádiva/brinde/dom/acolhimento/recebimento/retorno/restituição/herança/espólio
implementação	meio/caminho/jeito/modo/maneira/ferramenta
moral	justiça/honestidade
expectativa	esperança
profissão	política/pedagogia/profissão/pintura/ofício/profissão/arte/cargo/posição/posto
demanda	consumo
avô	avó/vovó/vovozinha/vovô/avô
confronto	fricção/atrito
honra	renome/celebridade/fama/glória
abuso	perseguição
segmento	curva
vantagem	predominância/vantagem/benefício
método	sistema/sistema
habitação	refúgios_na_montanha/edifício_residencial/habitação/casa/vivenda
depósito	armazenamento/depósito
veículo	veículo/viatura/sedan/transporte_público/transportes_públicos/transportes_públicos/transporte_publico/jipe/taxi/táxi/calhambeque/carro/ambulância/ambulancia/hospital_militar_móvel
mãe	progenitora/mãe/pai/papá/painho/papai
auxílio	apoio/suporte/socorro/assistência/ajuda/mão/ajuda
hierarquia	grau/gradação/primeiro
apelo	pergunta/questão/inquérito/apelo/reza/oração/petição/apelo/petição/súplica/invitação/convite/petição
fracasso	derrota/perda
objeto	resto/lua/terra/solo/solos/relevo_(geografia)/chão/terra_firme/terra/relevo/solo/formação/formação_geológica/afeição/paixão/amor/paixão/coisas/parte/porção/locação/ponto/lugar/localização/todo/unidade
característica	faceta/qualidade/carácter_distintivo/característica/qualidade/propriedade/atributo/qualidade/incompatibilidade/personalidade/temperamento/pessoa/peculiaridade/feição/tempo/forma_geométrica/formato/forma/condição/situação/estado
disciplina	ciências_aplicadas/ciência_aplicada/engenharia/ciências_aplicadas/tecnologia/disciplina_cientifica/ciência
instância	vez/mostra/amostra/exceção/excepção
etapa	serviço_militar/turno_de_serviço/estágio/período/fase/sono/sesta/hora/tempo/juventude/pré-história/idade/tempo/período/escala_de_tempo_geológico/era/época/século/idade/temporada/tempo/estação/tempo/estação/temporada/estação_do_ano/estação/tempo/sazão/período/momento/hora/período/prazo/mês/dia/trimestre/século/século/centúria/séculos/década/decênio/ano/ano/ano/semana/noite/noite/noitada/noite/fim_de_tarde/noitada/tarde/noite/manhã/jornada/dia/dia/período_da_vida/época/período/passado/vida/vida/duração_de_uma_vida/vida/semana/duração/continuidade/época/momento/período/tempo/era/licença/horas_de_trabalho
conteúdo	garrafa/botelha/cesto/cesto/história/modo_narrativo/narrativa/narração/proposta/afirmação/declaração/aplauso/aprovação/informação/reconhecimento/significância/significação/intenção/significado/tema/matéria/assunto/tópico
pecuária	horticultura
hipótese	suposição/pressuposição/hipótese/base/fundação
comarca	jurisdição/bairro/vizinhança/divisão_territorial/divisão_administrativa/distrito_administrativo
interferência	obstrução
guarda	security_office/guarda/guarda/vigília/sentinela/guarda
esfera	pérola/gota
pretensão	concupiscência/cio/eros/desejo/saudade/anseio/anelo/desejo/afã/ambição/aspiração/pretensão
colocação	curso/espaço/posição/espaçamento/armazenamento/depósito
ingresso	registro/matrícula/matricula/inscrição
coisa	unidade/pedaço/tomo/secção/parte/porção/massa_de_água/água/corpo_de_água/assunto/conteúdo/tópico
estação	inverno/estio/verão/primavera/outono
denominação	título
dúvida	descrença/dúvida
documentação	reporte/estudo/relatório/relato/documento_oficial/negócio_jurídico
alimentação	repasto/refeição/prato/petisco/guloseima/prato
terreno	campos/locação/sítio/lugar/praça/espaços_verdes/parque/paisagens_protegidas/parque_público/parque_natural/campo/gramado/terreno/campo
combustível	cozedura/lenha/querosene/fuelóleo/petróleo/gasolina/benzina/coque
mal	fratura/fractura
concepção	suposição/possibilidade/hipótese/teoria/lei_da_natureza/lei/totalidade/componente/soma/número/quantidade/abstrato/abstracto/abstracção/característica/carácter_distintivo/qualidade/propriedade/atributo/classe/família/categoria
cerimônia	boda/casamento/boda/funeral/enterro/funeral/cerimônia_religiosa/cerimônia_religiosa
obtenção	triunfo/êxito/sucesso/récorde
esperança	esperança
sinal	marca/selo/marcadores/numeral/número/aceno/emblema/símbolos/símbolo/sinal/simbolo/selo/símbolo/mancha/marca/estigma/evidência/indicação/número_telefônico/número/telefone
gerente	executivo/diretor_executivo/administrador/diretor/gerente/director/dirigente/gestor/administrador_academico
duração	trecho/período
obstáculo	problema/dificuldade/obstáculo/problema/obstáculo/atrapalhação/interferencia/obstáculo/guarda-lama/barreira/paliçada/cerca/estacada/obstáculo/obstáculo/barreira/obstáculo/trava/barra
requerimento	pergunta/questão/inquérito/apelo/reza/oração/petição/apelo/petição/súplica/invitação/convite/petição
pacote	baralho
ar	céu
simpatia	empatia/piedade/compaixão/afeição
círculo	camarilha
administrador	executivo/diretor_executivo/administrador/diretor/gerente/director/dirigente/gestor/administrador_academico
domínio	jurisdição/reino/bairro/vizinhança/divisão_territorial/divisão_administrativa/distrito_administrativo/ciências_aplicadas/ciência_aplicada/engenharia/ciências_aplicadas/tecnologia/disciplina_cientifica/ciência
comportamento	jeito_pessoal/maneira_pessoal/modo/maneira/ofensa/injúria/desfeita
química	substâncias_explosivas/explosivo
chegada	vencimento/derrota/perda/vitória/términio/parada/destruição/desolação/demolição/resultado/placar/retorno/regresso/vinda/volta/entrada/ingresso
recursos	crédito/dinheiro/finanças/fundos/fundo_de_maneio/capital/fundos/recurso_material/seguro/fundos_de_investimento/investimento/custo/atribuição
letra	letra/caractér/carácter/caracter
parente	tio/esposa/esposo/marido/cônjuge/cónjuge/consorte/descendente/descendência/filho/parente/família/parente/primo/prima/antecessor/ancestral/antepassado
antecessor	progenitor/antepassado
álcool	conhaque/brandy/álcool/bebida_alcoólica/vinho/fermentação
espécie	variante/versão
esporte	esporte/remo
erro	bobagem/gafe/fiasco/negligência/descuido/erro/mancha/mácula/derrota/perda
aeroporto	aeródromo/aeroporto
batalha	guerra/conflito/disputa/proteção/defesa/luta/combate/batalha
barra	pau
solicitação	pergunta/questão/inquérito/apelo/reza/oração/petição/apelo/petição/súplica/invitação/convite/petição
armamento	revólver/arma/revóvel/arma_de_fogo/bomba/munição/munição_de_guerra
arte	arte_gráfica/pintura
treinamento	exercício/prática
divisa	dólar/moeda/cache/numerário/em_espécie/dinheiro/cobres/guito/massa/dinheiro/grana/moeda/dinheiro/divisa/capital/fundo
pesar	remorso/pesar/tristeza/mágoa/terpena/tristeza/desgosto/amargura/pesar/dor/coração_partido/mágoa/pesar/tristeza/desgosto/dor
aula	seminário
afirmação	observação/comentário/resultado/resposta/explicação/explanação/declaração/asserção/descrição
estilo	género_literário/gêneros_literários/gênero_literário/dispositivo/caimento/feitio/corte
teoria	suposição/pressuposição/hipótese
circunstância	evento/caso/justificação/justificativa
amizade	companherismo/conexão/colega/companheiro/amigo/camarada/amigo/irmão/companheiro/colega/camarada/amigo/companheiro/camarada/irmão
peça	dólar/artigo/pano
especialista	autoridade/experiente/perito
onda	pulsação
aparelho	chicote/açoite/chibata/arma/armamento/exaustor/circulador_de_ar/ventilador_pulmonar/ventilador/suporte/encosto/apoio/lâmpada/luz/limitação/restrição/instrumento_musical/instrumento/mecanismo/instrumentos_de_medida/instrumentos_de_medição/metro/instrumento_de_medida/magnete/íman/ímã/maquinaria/máquina/acendedor/encendedor/isqueiro/botão_de_accionamento/chave/tecla/aparelho/ferramenta/instrumento/aquecedores/aquecedor/guarda/aparelho_de_seguranca/leque/ventilador/aparelho_eletrônico/pente
anúncio	pôster/poster/anúncio/cartaz/letreiro
doação	prêmio/galardão/prémio/apoio_financeiro/ajuda_financeira/ajuda
alimento	bebida/lacticínio/produto_lácteo/laticínio/ovo/ingrediente/farinhas/cereal/ração/rações_para_animais/repasto/refeição/suprimentos/provisões/alimentos/alimento/produtos_alimentares/nutriente/alimentação/alimento/comida/nutrição/prato/petisco/guloseima/prato/comestivel/alimento
agitação	agitação/sacolejo
começo	criação/concepção/causa/alvorecer/amanhecer/manhã/madrugada/princípio/início/começo/origem/começo/gênese/iniciação/estabelecimento/constituição/organização
procedimento	jeito_pessoal/maneira_pessoal/modo/maneira/cálculo
igual	associado
edifício	equilíbrio/contrapeso/torres/torre/roque/teatro/casa/templo/arena/estádio/asilo/refúgio/departamento/colégio/escolas/escola/restaurante/alpendre/igreja/casadeoração/lugares_de_prática_religiosa/templo/divisória/paredes/parede/obstrução/impedimento/obstáculo/monte/corcova/edifício_ministerial/ministério/monumento/monumentos/alojamento/abrigo/casa/edifício_residencial/habitação/casa/vivenda/hotel/salão_de_convenções/hall/centro_de_convenções/estufa/plantel/viveiro/pavimento/piso/andar/estabelecimento/defesa/cruz/clube/centro/edifício/prédio/ponte/sacada/varanda/balcão/varanda/arco/arco
morto	restos_mortais/corpo/defunto/enchido/cadáver
faixa	arco/colarinho/gola
ritmo	velocidade/taxa_de_mortalidade/mortalidade/velocidade/rapidez
carro	sedan/jipe/taxi/táxi/calhambeque/carro/ambulância/ambulancia/hospital_militar_móvel
sentimento	espírito/estado_emocional/humor/entusiasmo/compaixão/simpatia/piedade/camaradagem/humor/aversão/ódio/afeto/afeição/amor/apego/carinho/afecção/afetividade/afeição/amor/esperança/tristeza/pesar/alegria/felicidade/alegria/ansiedade/preocupação/ânsia/consternação/temor/medo/terror/cólera/raiva/ira/zanga/expectativa/espanto/admiração/surpresa/auto-estima/orgulho/vergonha/indiferença/gratidão/aversão/afeição/angústia/dor/dor/alegria/prazer/anseio/apetite/pretensão/desejo/emoção/comoção/abalo/sentimento/afeto/afete/emoção/afeição
relacionamento	romance/romance
música	composição_musical/composição_musical/seção/parte
diminuição	perda/deterioração/diminuição/declínio
bolsa	bolsa/algibeira/bolso
riqueza	sumptuosidade/suntuosidade/opulência/luxo/riqueza/dinheiro
quantidade	intervalo_de_tempo/tempo/intervalo/tempo/turno/jogo/rodada/momento/instante/unidades_de_tempo/unidade_de_tempo/soma/montante/número/totalizar/número/aumento/acrescentamento
esposo	mulher/esposa
desejo	concupiscência/cio/eros/anelo/saudade/nostalgia/desejo/saudade/anseio/anelo/desejo/afã/ambição/aspiração/pretensão
assalto	assalto
artista	intérprete/musico/músico/músico
fruto	espiga/fruta
consequência	efeito/efeitos/influência
droga	narcótico/produtos_farmacêuticos/medicamento/remédio/droga_medicinal/intoxicante
marido	mulher/esposa
sentença	revogação
ofício	profissão/pintura/ofício/profissão/arte/cargo/posição/posto
menor	jovem/menino/criança
imóvel	terras/fazenda
litoral	beira-mar/orla_marítima/litoral/costa
designação	encargo/missão/guarda/vigia
camada	superfície/pigmento/pintura/cor/tinta
língua	género_literário/gêneros_literários/gênero_literário/dispositivo/idioma/linguagem/língua_natural/linguagem_natural/língua
proporção	razão_focal/níveis_de_eficácia
projeção	saliência/protuberância/montículo/giba/excrescência
cálculo	operação/cáculo
capitalista	empresário
vara	porrete/clava
dimensão	altitude/altura
leitura	hora
coalizão	confederação/aliança
hostilidade	violência/força
automóvel	sedan/jipe/taxi/táxi/calhambeque/carro/ambulância/ambulancia/hospital_militar_móvel
estoque	infraestructura/infraestrutura/infra-estrutura
esposa	mulher/esposa/dona_de_casa/dona-de-casa
assento	assento/cadeira
criador	fazedor/artista
mão-de-obra	empenho/esforço
seleção	voto/eleição/votação/eleição/escolha/decisão/resolução
interpretação	ato/personificação/imitação/caracterização
contínuo	história
associado	membro
ocorrência	quebra/colapso/revés/explosão/surto/surto/erupção/epidemia/deflagração/ocasião/ponto/conjuntura/convergência/som/ruído/interrupção/pausa/toque/sorte/destino/fado/vitória/desastre/movimento/vez/instância/ocorrência/exemplo/caso/ocasião/incidente/evento/fogo/incêndio/acidente/coincidência/alteração/mudança/variação/modificação/princípio/início/começo/acontecimento/eventualidade/evento/episódio/coisa/problema/experiência
amado	amante/amor
partida	corrida/partida/luta/combate/jogo/competição/torneio/corrida/envio/expedição/despacho/saída/despedida/partida
par	associado
crônica	biografia
banda	faixa
anulação	cancelamento
jurisdição	diocese/diocese
indício	evidência/indicação
governante	castelão/senhor
terras	plantação/plantio/viveirodeplantas
resto	fósseis/fóssil/fósseis/fossil
impressão	ruga/sulco/entusiasmo/compaixão/simpatia/piedade/camaradagem/humor/afeto/afeição/amor/apego/carinho/afecção/afetividade/esperança/tristeza/pesar/felicidade/alegria/expectativa/espanto/admiração/surpresa/auto-estima/orgulho/vergonha/indiferença/gratidão/aversão/afeição/angústia/dor/dor/alegria/prazer/anseio/apetite/pretensão/desejo/emoção/comoção/abalo/sentimento/afeto/afete/emoção/afeição
fenômeno	sorte/fortuna/ensejo/azar/sorte/consequência/conseqüência/resultado/fim/efeito/fenômeno_natural/fenómeno_natural
quantia	intervalo_de_tempo/tempo/intervalo/tempo/turno/jogo/rodada/momento/instante/unidades_de_tempo/unidade_de_tempo
laço	nó_de_correr/forca/laço/nó
conduta	jeito_pessoal/maneira_pessoal/modo/maneira/ofensa/injúria/desfeita/caminho
empenho	exercício_físico/exercício_fisico/batalha/luta
convicção	ser_sobrenatural/espirito/opinião_pública/crença_religiosa/fé/religião/perspicácia/pensamento/opinião/escola_de_pensamento/doutrina/filosofia/fé/confiança/certeza/convicção/fé
alcance	extensão/limite/limitação/fronteira
descendente	criança/menino/filho
totalidade	unidade
explicação	teoria
convergência	reunião/encontro
componente	metade/jogo/turno/resíduo/sobra/excedente/resto/restante/membro/unidade/componente/elemento/componente/item/unidade_da_linguagem/unidade_linguística/fator/parte/componente/traseiro/ponto/pixel/elemento_de_imagem/píxel/hardware/adição/melhoria/substância
regiões	região_geográfica/região/área_geográfica/domínio/distrito/território/domínio/comarca/districto/circunscrição/circunscrição_administrativa/área/região/território/ambiente
comunicado	catequizar/persuasão/convencimento/teste/exame/expressão/discussão/discurso/arte_dramatica/dramaturgia/teatro/serviço_postal/correios/correio/transmissão
obrigação	encargo/imposto/taxa/dívidas/dívida/dívida/débito/tarefa/designação/papel/função/serviço/incumbência
agressão	violência/força
demonstração	reflexão/manifestação
mercadoria	mercadoria/artigo/produto/importação/comando_exportar/exportação/bens_de_consumo/carregamento/mercadoria/frete/carga
barreira	guarda-lama/barreira/paliçada/cerca/estacada
solo	areia/solo/terra/planície/campanha/ilha/arvoredo/mata/floresta/bosque/selva/florestas/chão/terra
símbolo	marca/selo/marcadores/símbolo/emblema/numeral/número/selo/símbolo/mancha/marca/estigma
oficina	oficina/chácara/granja/quinta/sítio/fazenda/central_telefónica/central/central_telefônica
deficiência	escassez
soma	soma/montante/número/totalizar
fuga	escapada/fuga/escape
festa	boda/casamento/boda/funeral/enterro/funeral/cerimónia/cerimônia/festa/celebração/rotulagem/festa/festa/festa/balada/festival
declínio	perda/deterioração
ajudante	secretária_executiva/secretária/secretário/modelo/manequim
suporte	degrau/suporte/perna/pé/pé/base/pedestal/endosso/adesão/aderência
indivíduo	cientista/governante/governador/parte/dono/proprietário/possuidor/amo/vizinho/homem/pessoa/vida/estudante/aluno/parente/esperança/conhecido/amiga/camarada/amizade/amigo/seguidor/estudante/ser/criatura/criança/autoridade/proponente/representante/advogado/defensor/juiz/árbitro/adjudicator/amizade/conhecido/conhecida/amigo/hebreu/judeu/hebraico/hebreia/judia/hebraica/trabalhador/pessoa_sem_treinamento/infortunado/desventurado/desafortunado/turista/viajante/pessoa_religiosa/súdito/cidadão/macho/varão/homem/chefe/líder/amante/amado/menor/juvenil/jovem/intelectual/intelecto/autóctone/habitante/morador/fêmea/face/rosto/cara/especialista/artista/engenheiro/criativo/creador/criador/competidor/contendor/comunicador/capitalista/anomalia/pessoa_estranha
deslocamento	migração/manobra/precipitação/aceleração/regresso/retorno/descensão/elevação/ascensão/caçada/perseguição/travessia/viagem/locomoção/progressão/avanço
enfermidade	tumores/doenças/doença/colapso
débito	crédito/empréstimo
inteligência	astucidade/astúcia/sagacidade/inteligência/cérebro/agudeza/agudez/inteligência
discordância	controvérsia/discordância/querela/discussão/disputa
desastre	vencimento/derrota/perda/força_maior
cabeça	gerente/administrador
asilo	tenda/barraca
repartição	parte/parcela
competição	corrida/partida/luta/combate/jogo/competição/torneio/corrida
finança	investimento
consideração	justificação/justificativa
habitante	europeu
chance	chance/ouvinte/audiência/dia/oportunidade/chance/potenciabilidade/potencial/promoção/liquidação
utilidade	função/propósito
sala	casa_de_banho/banheiro/sala/biblioteca/cozinha/sala/hall/casa_de_banho/banheiro/quarto_de_banho/sala_de_banho/bar
pedagogia	curso/aula
dano	fratura/fractura
morador	europeu
temor	pânico/terror/medo/tremor/tremura/arrepio/calafrio/tremedeira
seguidor	discípulo/adepto/apóstolo/aluno/estudante/seguidor
multidão	tropa/multidão/leva/legião/multidão/horda/turba/massa/multidão/exército
relato	fofoca/bisbolhetice/bisbilhotice/piada/historieta/anedota
gesto	gesto/gesto
deterioração	ruína/cárie/ferimento
fornecedor	fornecedor/conexão
bens	crédito/dinheiro/finanças/fundos/fundo_de_maneio/capital/fundos/recurso_material/seguro/fundos_de_investimento/investimento/custo/atribuição/película/filme/produção/cinema/produto/produção/fruto/obra/trabalho/jornal/mercadoria/artigo/produto/revista/importação/comando_exportar/exportação/produção/bens_de_consumo/livros/livro
show	atuação/programa/emissão/película/filme/produção/cinema
munição	bomba/munição/munição_de_guerra
líquido	água
loja	farmácia/farmacia/botica/drograria/drogaria
linguagem	género_literário/gêneros_literários/gênero_literário/dispositivo/idioma/linguagem/língua_natural/linguagem_natural/língua
fé	ser_sobrenatural/espirito/opinião_pública/crença_religiosa/fé/religião/perspicácia/pensamento/opinião/escola_de_pensamento/doutrina/filosofia/fé/confiança/certeza/convicção/fé
rendimento	acumulação/colheita/safra
gente	ralé/clientela/freguesia/geração/espectador/audiência/população/mundo/povo/gente/gente/nação/povo/classe_social/classe/estrato/galera/pessoal/vulgo/povo/nação/gente/inimigo/coorte
pedra	pedra/litíase/matacão/rochedo/pedra/rocha/pedregulho
evidência	sintoma/identificação/registro/pista/trilha/refutação/prova/confirmação
preços	magnitude/importância/custo/preço/preços/custos
inspeção	verificação/limite/controle/inspeção
circunscrição	jurisdição/bairro/vizinhança/divisão_territorial/divisão_administrativa/distrito_administrativo
prata	dólar
leis	constituição
harmonia	consenso/acordo
ideia	suposição/possibilidade/hipótese/teoria/lei_da_natureza/lei/totalidade/componente/soma/número/quantidade/abstrato/abstracto/abstracção/característica/carácter_distintivo/qualidade/propriedade/atributo/classe/família/categoria/preparação/planejamento/razoamento/raciocinio/argumentação/raciocínio
gastos	taxa/custo/preço/recompensa/pagamento
escassez	escassez
agrupamento	agregação/coleção/reunião
separação	separação/partição/segmentação/divisão/divisão
incapacidade	bloqueio
falha	negligência/bobagem/gafe/fiasco/negligência/descuido/erro/mancha/mácula/engano/falha/equívoco/erro/derrota/perda/fracasso/falha/erro
estrela	estrela/planeta
delito	adulteração/falsificação/desonestidade/transgressão/comportamento_errado
anseio	concupiscência/cio/eros/anelo/saudade/nostalgia/desejo/saudade/anseio/anelo/desejo/afã/ambição/aspiração/pretensão
raça	espécie/género/estilo/tipo/género/classe/espécie/tipo/variedade
hotel	hotel/pousada/albergaria/hospedaria/albergue
capa	embalagens/invólucro/cobertura/capa/tampa/proteção/protecção/escudo/amparo/cobertor/cobertura/capa/envólucro/telhado/teto/proteção/capa/pigmento/pintura/cor/tinta/máscara/calçado/calçados/tapete/camada/capa/vestimenta/roupa/vestido/traje/vestuário/camuflagem/cortina
era	era/período/dia
medicamento	calmante/sedativo/produtos_farmacêuticos/remédio/terapia/medicamento/narcótico/produtos_farmacêuticos/medicamento/remédio/droga_medicinal/intoxicante/analgésicos/analgésico
formato	ligação/forma_amorfa/forma_distorcida/forma_redonda/forma_angular/linha/figura/forma_natural/plano/sólido/sólida
destruição	desolação/ruína
alguém	cientista/governante/governador/parte/dono/proprietário/possuidor/amo/vizinho/homem/pessoa/vida/estudante/aluno/parente/esperança/conhecido/amiga/camarada/amizade/amigo/seguidor/estudante/ser/criatura/criança/autoridade/proponente/representante/advogado/defensor/juiz/árbitro/adjudicator/amizade/conhecido/conhecida/amigo/hebreu/judeu/hebraico/hebreia/judia/hebraica/trabalhador/pessoa_sem_treinamento/infortunado/desventurado/desafortunado/turista/viajante/pessoa_religiosa/súdito/cidadão/macho/varão/homem/chefe/líder/amante/amado/menor/juvenil/jovem/intelectual/intelecto/autóctone/habitante/morador/fêmea/face/rosto/cara/especialista/artista/engenheiro/criativo/creador/criador/competidor/contendor/comunicador/capitalista/anomalia/pessoa_estranha
adulto	mulher/profissional_liberal/profissional/velho/idoso/homem/personagem/anfitrião/hospedeiro/tipo/figura
vinda	retorno/regresso/vinda/volta/entrada/ingresso
feito	atos_da_fala/acto_de_fala/comunicado/comunicação/uma_comunicação/distribuição/ação_em_grupo/parada/paralisação/paralização/atrapalhação/impedimento/interferência/ociosidade/habitação/permanência/juízo/critica/julgamento/uso/atividade/ocupação/rejeição/andada/andar_até_a_primeira_base/falha/insucesso/obtenção/realização/chegar_la/toque/contato/façanha/proeza/escape/escapatória/fuga/recuperação/impulsão/propulsão/efetuação/execução/realização/implementação/batida/rebatida/jogada/eliminação/disposição/descobrimento/descoberta/partida/causa/causalidade/aquisição/acção/ação/atividade/ato/façanha/proeza/realização/feito
amor	lealdade
sólido	pó/cristal/vidro/plastico/plástico/plásticos/cubo/bloco/poliedro/poliedros/cilindro/concavidade/convexidade
carne	corte_de_carne/corte
animal	larva/ave_de_caça/caça/presa/predadores/invertebrado/invertebrados/cordados/herbívoro/cria/filhote/prole/macho/fêmea/animal_doméstico/animal_doméstico
móvel	guardarroupas/estante/armário/guarda-roupas/mesa/mesa/assento/cadeira/lâmpada/lâmpadas/mobiliário/alfaia/movéis/móvel/mobília/reposteiro/cortina/cômoda/cômodas/aparelhador/gaveteiro/cómoda
andar	mansarda/ático/trapeira/sótão/porão/cave
produtores	produtores_de_cinema/cineasta/produtor_cinematográfico
cultivo	horticultura/cultivo/pecuária/agricultura
socorro	piedade/misericórdia/apoio/suporte/consolação/consolo/conforto/socorro/assistência/ajuda/mão/ajuda
remédio	calmante/sedativo/produtos_farmacêuticos/remédio/terapia/medicamento/narcótico/produtos_farmacêuticos/medicamento/remédio/droga_medicinal/intoxicante/analgésicos/analgésico
processamento	processamento_de_dados
laboratório	oficina/chácara/granja/quinta/sítio/fazenda/central_telefónica/central/central_telefônica
juízo	cálculo/estimativa/avaliação
intensidade	força/violência
crença	ser_sobrenatural/espirito/opinião_pública/crença_religiosa/fé/religião/perspicácia/pensamento/opinião/escola_de_pensamento/doutrina/filosofia/fé/confiança/certeza/convicção/fé
compreensão	atitude/informação/conhecimento/objecto_mental/conhecimento/sentimento_de_si/saber/consciência/incapacidade/poder/capacidade/talento/habilidade/mente/psique/cabeça
intervalo	suspensão/pausa/interrupção/horário
educador	professor/acadêmico/professor_universitário
bebida	chá/café/leite
triunfo	sensação/sucesso/estrondo
tecido	equilíbrio/contrapeso/torres/torre/roque/arena/estádio/seda/asilo/refúgio/alpendre/pano/divisória/paredes/parede/obstrução/impedimento/obstáculo/rede/malha/trama/monte/corcova/mohair/monumento/monumentos/alojamento/abrigo/casa/pavimento/piso/andar/estabelecimento/defesa/cruz/crepe/algodão/veludo_cotelê/edifício/prédio/ponte/sacada/varanda/balcão/varanda/arco/arco
relevo	planície/campanha/ilha/arvoredo/mata/floresta/bosque/selva/florestas/chão/terra
status	liderança/nobreza/dignidade/posição/hierarquia/classe/posto/nacionalidade/nacionalidade/status_social/posto/lugar/condições_sociais
costume	ritual/rito/ritual/maltrato/escravidão/hábito/costume/hábito/emprego/costume
localização	curso/espaço/passos_de_montanha/passo_de_montanha/regiões/região/região/lugar/fronteira/floresta/selva/lar/casa/posição/espaçamento
corrida	estafeta
carência	necessidade/escassez/deficiência/escassez/carência/falta/ausência
acumulação	estoque/colocação/depósito/acúmulo/acumulação
traço	bochecha/têmpora/testa/mento/chinchilla/queixo
cor	pigmento/pigmentos/corantes_têxteis/tintura/cor/corante/tom/tintura/matiz/pigmento/pintura/cor/tinta
coesão	continuidade
visitante	visita/visitante/companhia
feição	conduta/procedimento/maneira/comportamento/bobeira/sensatez/sagacidade/sapiência/sabedoria/modalidade/disciplina/firmeza/disposição/egocentrismo/egoísmo/atividade/natureza/índole/caráter/personalidade
desacordo	controvérsia/discordância/querela/discussão/disputa
cavalo	garanhão/cavalo
noção	atitude/informação/conhecimento/objecto_mental/incapacidade/poder/capacidade/talento/habilidade/mente/psique/cabeça
moradia	edifício_residencial/habitação/casa/vivenda
inexistência	impossibilidade
homicídio	assassínio/homicídio/assassinato
domicílio	lar/casa/edifício_residencial/habitação/casa/vivenda
bala	caramelo/bala
teste	verificação/limite/controle/inspeção
ong	comité/comitê
negociador	representante/intermediário/mediador/intercessor
medo	pânico/terror/medo/tremor/tremura/arrepio/calafrio/tremedeira
insucesso	negligência/engano/falha/equívoco/erro/fracasso/falha/erro
rota	direcção/direção/rumo/curso
pergunta	interrogatório/quesito/indagação/interrogação/pergunta/questão
cuidado	tratamento
conexão	coesão/coerência/ligação/oposição/comparação/reciprocidade/relação_de_negócios/relação_de_grandeza/parentesco/relação/relação/afinidade/parentesco/relação_linguística/relação/ligação/fundação/ligação/relação/parentesco/relacionamento/possessão/propriedade/relação_social/propriedade/bem/posse
petição	pergunta/questão/inquérito/apelo/bênção/reza/oração/petição/apelo/petição/súplica/invitação/convite/petição
partilha	doação
intérprete	músico/instrumentista/instrumentalista/tocador/artista/intérprete/actor/ator
certeza	certeza/aprumo/desembaraço/fé/pose/altivez
vegetal	epifitismo/epífito/planta_venenosa/traqueófitos/planta_vascular/planta_decorativa/planta_de_dentro_de_casa/folhas/vegetal
usuário	consumidor
regulação	alinhamento/restrição/limitação
habilidade	técnica/método/método/metodo/métodos/faculdade/talento/habilidade/técnica/controle/aptidão/arte/habilidade/habilidade/talento/habilidade/meta/técnica/criatividade/criatividade/aptidão/inteligência/liderança/habilidade
desenho	fotografia/retrato/imagem/foto/modelo/esquema/mapa/ilustração/figura/desenho/imagem/documentos/documento/reprodução/cópia
aparato	exaustor/circulador_de_ar/ventilador_pulmonar/ventilador/suporte/encosto/apoio/lâmpada/luz/limitação/restrição/instrumento_musical/instrumento/mecanismo/magnete/íman/ímã/maquinaria/máquina/acendedor/encendedor/isqueiro/botão_de_accionamento/chave/tecla/aparelho/ferramenta/instrumento/aquecedores/aquecedor/guarda/aparelho_de_seguranca/leque/ventilador/aparelho_eletrônico/pente
rito	nupcias/casamento/liturgia
melhoramento	reparo/reparação/conserto/reforma/retificação/correção/limpeza/limpada/desenvolvimento
célula	célula_germinativa
variação	avaria/estrago/prejuízo/dano/diferença/transmutação/mudança/transformação/transição/aumento/crescimento/queda/diminuição/abatimento/decréscimo/falecimento/morte/variação/mudança/flutuação/nascimento/surpresa
objeção	queixa
motor	motor/motores/máquina
imobiliária	terras/fazenda
equívoco	bobagem/gafe/fiasco/negligência/descuido/erro/mancha/mácula
substância	sólido/matéria_sólida/sólida/toxinas/tóxico/veneno/peçonha/residuo/fluído/líqüido/fluido/levedura/leveduras/lubrificante/lubrificantes/combustível/material_com_que_se_aquece/carburante/elemento_químico/elemento_químico/elemento_químico/átomo/mistura/solução/misturas_químicas/materiais/sedimento/depósito/proto-plasma/proto-plasma/protoplasma/substâncias_explosivas/explosivo/comida/alimento/nutriente/substância
sintoma	inflamação/dor_de_cabeça/dor/cefaleia
roque	minarete/farol
motivação	moralidade/moral/ética/morais/vida
jurisprudência	direito_civil/direito_romano-germânico
argumentação	política_pública/política/raciocínio/argumentação
contorno	curvatura
combinação	unificação/junção
coleção	informação/dados/lei/jurisprudência/ciências_jurídicas/cobertura_vegetal/flora/vegetação/circulação/trânsito/tránsito/trânsito/tráfego/transito/exposição/exposições/miscelanea/potpourri/mistura/encepamento/frota/galáxia/nebulosa/via_láctea/embrulho/embalagem/pacote/família/grupo/classe/categoria/jogo/grupo/biota/biologia/mitologia/mitologia/biblioteca/biblioteca/biblioteca_de_rotinas/combinação/cúmulo/acúmulo/pilha/monte/grupo/montão/aglomeração/mão/pacote/bloco/grupo/conjunto/universo/reunião
som	anilhagem/rufo/batida/ruído/gorjeio/trinado/chilro/voz/som/toque
incerteza	descrença/dúvida
orientador	chefe/supervisor/capataz
injúria	desconsideração/injúria/ofensa/afronta/insulto/perseguição
alma	cientista/governante/governador/parte/dono/proprietário/possuidor/amo/vizinho/homem/pessoa/vida/estudante/aluno/parente/esperança/conhecido/amiga/camarada/amizade/amigo/seguidor/estudante/ser/criatura/criança/autoridade/proponente/representante/advogado/defensor/juiz/árbitro/adjudicator/amizade/conhecido/conhecida/amigo/hebreu/judeu/hebraico/hebreia/judia/hebraica/trabalhador/pessoa_sem_treinamento/infortunado/desventurado/desafortunado/turista/viajante/pessoa_religiosa/súdito/cidadão/macho/varão/homem/chefe/líder/amante/amado/menor/juvenil/jovem/intelectual/intelecto/autóctone/habitante/morador/fêmea/face/rosto/cara/especialista/artista/engenheiro/criativo/creador/criador/competidor/contendor/comunicador/capitalista/anomalia/pessoa_estranha
distúrbio	doença
comoção	espírito/estado_emocional/humor/aversão/ódio/afeição/amor/alegria/ansiedade/preocupação/ânsia/consternação/temor/medo/terror/cólera/raiva/ira/zanga
ódio	aversão/ressentimento/hostilidade/repulsa/inimizade
piso	mansarda/ático/trapeira/sótão/porão/cave
provedor	fornecedor/conexão
músico	compositor/compositor
materiais	corante/cor/colorante/tinta/papel/fibra/fibras/thread/resíduo/resíduo_sólido/lixo/solo/condutor/substância_química/química/substâncias_químicas/substância/material_animal/cimento/materiais_aderentes/pedra/rocha/minérios/mineral/matéria_mineral/matéria-prima/partícula/átomo
obstrução	obstáculo/atrapalhação/interferencia/obstáculo/obstáculo/obstáculo/barreira/obstáculo/trava/barra
menino	garoto/filho/menino/rapaz/menino/filha/bebé/nenê/recém-nascido/criancinha/bebê
falsificação	enganação/dissimulação
conformidade	consenso/acordo
tragédia	força_maior
percepção	sensação/sensação/cheiro/odor/ouvida/escuta/olhada/olhar
iluminação	escuridão/trevas
hábito	ritual/rito/ritual/maltrato/escravidão/hábito/costume/hábito/emprego/costume
avó	avó/vovó/vovozinha/vovô/avô
variedade	variante/versão
migração	emigração/expatriação
alegria	prazer/alegria/deleite
metro	relógio/relógio_de_pulso
condutor	cobre/cobre
torre	minarete/farol
saudação	cartão_de_visitas
instante	saída/início/princípio/começo/hora/segundo/instante/momento/data_limite/prazo_final/data_final/prazo
acúmulo	informação/dados/lei/jurisprudência/ciências_jurídicas/cobertura_vegetal/flora/vegetação/circulação/trânsito/tránsito/trânsito/tráfego/transito/exposição/exposições/miscelanea/potpourri/mistura/encepamento/frota/galáxia/nebulosa/via_láctea/embrulho/embalagem/pacote/família/grupo/classe/categoria/jogo/grupo/biota/biologia/mitologia/mitologia/biblioteca/biblioteca/biblioteca_de_rotinas/combinação/cúmulo/acúmulo/pilha/monte/grupo/montão/aglomeração/mão/pacote/bloco/grupo/conjunto/universo/colocação/depósito/acúmulo/acumulação
supervisor	chefe/supervisor/capataz
moralidade	justiça/honestidade
quantitativo	intervalo_de_tempo/tempo/intervalo/tempo/turno/jogo/rodada/momento/instante/unidades_de_tempo/unidade_de_tempo
celebração	festival
abrigo	seguro/seguros/habitação/apartamento/moradia/quartos/albergue/hostelalbergue/aposento/habitação/moradia/residência/casa/lar/morada/domicílio/acampamento/apartamento
terror	pânico/terror/medo/tremor/tremura/arrepio/calafrio/tremedeira
ofensa	desconsideração/injúria/ofensa/afronta/insulto/infracção/infração/crime
navios	iate/navio_de_guerra/navios_de_guerra/navio_de_guerra/vapor/barco_a_vapor/navios/embarcação/navio/barco/batel/escaler/barco/bote
exibição	exibição/exposição
calamidade	força_maior
abalo	espírito/estado_emocional/humor/aversão/ódio/afeição/amor/alegria/ansiedade/preocupação/ânsia/consternação/temor/medo/terror/cólera/raiva/ira/zanga
pão	pãozinho
fumo	rolo_de_tabaco
atmosfera	céu
semelhança	semelhança/similardidade/identidade
rodada	partida
disco	ponto
saco	bolsa
roupa	uniforme/fardamento/farda/fato/traje/terno/vestido/saia/camisa/chapéu/artigo_de_vestuário/roupa/vestuário/roupa/traje/vestuário/vestido
queixa	reivindicação
coerência	continuidade
tópico	história/modo_narrativo/narrativa/narração/proposta/afirmação/declaração/aplauso/aprovação/informação/reconhecimento/significância/significação/intenção/significado/tema/matéria/assunto/tópico/área
requisição	pergunta/questão/inquérito/apelo/reza/oração/petição/apelo/petição/súplica/invitação/convite/petição
placa	placa/tábua/quadro/lousa
percurso	direcção/direção/rumo/curso
ordenação	sequência/sucessão
metais	estanho/estanho/chumbo/chumbo/ferro/ferro/ferro/ferro/cobre/cobre/cobre/cobre
maquinaria	motor/motores/moinhos/moinho/maquinário/máquina/maquinaria/calculadora/computador
flora	epifitismo/epífito/planta_venenosa/traqueófitos/planta_vascular/planta_decorativa/planta_de_dentro_de_casa/mata/bosque/floresta/chaparral
edificação	construção/fabricação
depressão	vale/baixada/leito/fundo
comunicador	escritor/autor/negociador
calçado	tamanco/calçado/bota
auto	sedan/jipe/taxi/táxi/calhambeque/carro/ambulância/ambulancia/hospital_militar_móvel
índole	disposição/temperamento
árbitro	official_de_justiça/magistrado/juiz/jurista
ritual	nupcias/casamento/solenidade
repetição	repetição/recorrência
mobiliário	guardarroupas/estante/armário/guarda-roupas/mesa/mesa/assento/cadeira/lâmpada/lâmpadas/mobiliário/alfaia/movéis/móvel/mobília/reposteiro/cortina/cômoda/cômodas/aparelhador/gaveteiro/cómoda
inclinação	aceno
ensinamento	curso/aula
endereço	domicílio/residência/casa
dor	tristeza/desgosto/amargura/pesar/dor/coração_partido
arranjo	ordem/formação/array/ordem
rosto	aparência/expressão/rosto
municipalidade	distrito/arraial/aldeia/povoado/vila/burgo/metrópole/metrópoles/cidade
metal	estanho/chumbo/ferro/ferro/cobre/cobre
locação	passos_de_montanha/passo_de_montanha/regiões/região/região/lugar/fronteira/floresta/selva/lar/casa
lar	edifício_residencial/habitação/casa/vivenda
grandeza	extensão/alcance/quantidade/número/magnitude/dimensão/tamanho/medida/dimensão/extensão/amplidão/magnitude/extensão/magnitude/proporção/tamanho/dimensão
entretenimento	apresentação/exibição/divertimento/distração/distracção
chapéu	chapéu/sombreiro
belas-artes	arte_gráfica
velocidade	velocidade/taxa_de_mortalidade/mortalidade
precipitação	neve/nevada/chuva
planta	epifitismo/epífito/planta_venenosa/traqueófitos/planta_vascular/planta_decorativa/planta_de_dentro_de_casa/casademoinho/fábrica/manufatura/usina
inspecionar	inspeção/vistoria/busca/revisão/acompanhamento/comparação
fraqueza	letargia/lassidão
compressão	compactação/esmagamento
barco	iate/navio_de_guerra/navios_de_guerra/navio_de_guerra/vapor/barco_a_vapor/barco/navios/embarcação/navio/barco/balsa/canoa/batel/escaler/barco/bote/barca/bateira/barcaça
anatomia	traço/articulações/articulação/canela/banda/traseiro/fundilhos/nalga/nádega/anca/bunda/traseiro/rabo/bumbum/popô/bunda/ânus/nádegas/costas/ventre/abdome/estômago/barriga/abdómen/tronco/abdômen/seio/peito/corpo/tronco/torso/ombro/órgão_biologico/órgão/tecidos/tecido_celular/tecido/tecido/sistema/lombo
ápice	alcance/auge/ápice
vistoria	verificação/limite/controle/inspeção
piedade	empatia/compaixão/piedade/compaixão/afeição
oração	bênção
motores	motor/motores/máquina
interação	ligação/contato
humor	felicidade/alegria
fronteiras	superfície/fronteira/limite/fronteira/borda/limite/fronteira/borda/margem/limite/delimitação/borda/fronteira
fibra	bisso
diversão	esporte/apresentação/exibição/divertimento/distração/distracção/brincadeira/entreterimento/jogo/passatempo/brincadeira/jogo/hobby/passatempo/aposta/jogo_de_azar/divertimento/entreterimento/escapismo/diversão/divertimento/entretenimento/entreterimento/dança/baile/festa/festividade/celebração/sacanagem/travessura/gozação/trote
criado	secretária_executiva/secretária/secretário/modelo/manequim
tronco	galho/ramo/galho
superfície	fundo/lado/esfera_celeste/firmamento/céu/lado/face/tabuleiro_de_jogos/tabuleiro
reorientação	reversão
folhas	lauda/escudeiro/página/folhas/folha
pano	seda/vela/pano/patch/remendo/rede/malha/trama/mohair/lenço/resto/sobra/crepe/algodão/veludo_cotelê
juvenil	jovem/menino/criança
flutuação	diferença
entorpecente	narcótico/produtos_farmacêuticos/medicamento/remédio/droga_medicinal/intoxicante
caracterização	personagem/papel
artefato	material_de_construção/materiais_de_construção/estrada/caminho/via/superfície/estrutura/tecido/edifício/banda/placa/lousa/chapa/brinquedo/abertura/linha/fio/corda/calceteiro/apetrecho/equipamento/instrumento/objeto_fixo/instalação/infra-estrutura/pano/tecido/fazenda/têxteis/tecido_têxtil/buracos_escavados/ornato/ornamento/decoração/adorno/criação/cobertura/capa/objecto_posto_à_venda/fazenda/bens/bem/produto/artigo/mercadoria/bloco/artigo
têxteis	seda/pano/rede/malha/trama/mohair/crepe/algodão/veludo_cotelê
templo	igreja/templo/igrejas
sequência	sucessão/série/curso
perna	perna
livros	diário
fio	corda
contaminação	poluição/contaminação
concórdia	consenso/acordo
competidor	concorrente/desafiante/rival/competidor/contendor/opositor/adversário/oponente/desportista/atleta
cobre	moeda/cache/numerário/em_espécie/dinheiro/moeda/dinheiro/divisa
trâmite	caminho
serventuário	servidor_federal/agente_federal/servidor/official_de_justiça/magistrado/juiz/jurista
parede	muralha/parede/muro
magnitude	significação/significado/altitude/altura/extensão/alcance/quantidade/número/magnitude/dimensão/tamanho/medida/dimensão/extensão/amplidão/magnitude/extensão/magnitude/proporção/tamanho/dimensão
ilustração	fotografia/retrato/imagem/foto/modelo/esquema/mapa/ilustração/figura/desenho/imagem/documentos/documento/reprodução/cópia
honestidade	justiça/justeza
doenças	fitopatologia/doenças_das_plantas
brinquedo	pião/ursinho_de_pelúcia/urso_de_pelúcia/ursídeos/urso_de_pelúcia/boneco/boneca/bola
vão	buraco/rasgo/rasgão/fenda/boca/racha/fissura/fresta/greta/fenda/buraco
vestuário	uniforme/fardamento/farda/fato/traje/terno/vestido/saia/camisa/chapéu/artigo_de_vestuário/roupa/vestuário/roupa/traje/vestuário/vestido
verbo	forma_flexionada
software	sub-rotina/sub-rotina/função/subrotina/programa_de_computador/programa_de_computador/programa
protetor	guarda
pau	porrete/clava
cadáver	restos_mortais/corpo/defunto/enchido/cadáver
azar	infortúnio/acidente
arco	arco/arco-íris
vergonha	ignomínia/desgraça/vergonha
tribo	genealogia/árvore_genealógica/família
travessia	parada/etapa/jornada/viagem/andada/passeio/caminhada
transtorno	doença
raciocínio	política_pública/política/raciocínio/argumentação
nutrição	repasto/refeição/prato/petisco/guloseima/prato
negociante	proprietário/dono
negação	abjuração/negação
mistura	suspensão/soluto/soluto/solução/solução/liga_metálica/ligas_metálicas/liga/ligas_metálicas
lesão	fratura/fractura
intolerância	fanatismo/fanatismo
insolvência	bancarrota/falência
gleba	campos/locação/sítio/lugar/praça/espaços_verdes/parque/paisagens_protegidas/parque_público/parque_natural/campo/gramado/terreno/campo
fruta	espiga/tâmara/maçã/fruta
escada	escadas/degrau/lance_de_escadas/escada_rolante
talento	vontade/sentido/inteligência/entendimento/razão/memória/linguagem/idioma/discurso/língua/faculdade/talento/arte/habilidade/habilidade/talento/habilidade/meta/técnica/criatividade/criatividade/aptidão/inteligência/liderança/habilidade
idioma	provérbio/expressão_idiomática/ditado/locução/provérbio/ditado/idioma/expressão/debate/discussão/conversação/conversa/idioma/linguagem/língua_natural/linguagem_natural/língua
escadaria	escadas/degrau/lance_de_escadas/escada_rolante
aparência	feiúra/feiura/feiúra/beleza/belo/aparência/expressão/rosto/rosto/semblante/aparência/rosto/face/aparência/rosto/aspecto/aparência
temperamento	identidade/personalidade
suposição	suposição/pressuposição/hipótese/base/fundação
ferramenta	chicote/açoite/chibata/arma/armamento/exaustor/circulador_de_ar/ventilador_pulmonar/ventilador/ferramenta/utensílio/ferramenta/implemento/instrumento/instrumento_musical/suporte/encosto/apoio/pau/bastão/vara/equipamento_de_esportes/equipamento_esportivo/arpão/lança/lâmpada/luz/barra/limitação/restrição/agulha/instrumento_musical/instrumento/mecanismo/instrumentos_de_medida/instrumentos_de_medição/metro/instrumento_de_medida/material/magnete/íman/ímã/maquinaria/máquina/acendedor/encendedor/isqueiro/botão_de_accionamento/chave/tecla/aparelho/ferramenta/instrumento/aquecedores/aquecedor/guarda/aparelho_de_seguranca/parafernália/leque/ventilador/equipamento_eletrônico/aparelho_eletrônico/pente/brocha/escova_de_dentes/pincel/escova/aparato/equipamento/aparelho
esmagamento	trituração/pulverização
endosso	cuidado/auspício
emoção	espírito/estado_emocional/humor/entusiasmo/compaixão/simpatia/piedade/camaradagem/humor/aversão/ódio/afeto/afeição/amor/apego/carinho/afecção/afetividade/afeição/amor/esperança/tristeza/pesar/alegria/felicidade/alegria/ansiedade/preocupação/ânsia/consternação/temor/medo/terror/cólera/raiva/ira/zanga/expectativa/espanto/admiração/surpresa/auto-estima/orgulho/vergonha/indiferença/gratidão/aversão/afeição/angústia/dor/dor/alegria/prazer/anseio/apetite/pretensão/desejo/emoção/comoção/abalo/sentimento/afeto/afete/emoção/afeição
emblema	marca/selo/marcadores/numeral/número/selo/símbolo/mancha/marca/estigma
decomposição	ruína/cárie
cônjuge	mulher/esposa
saudade	anelo/saudade/nostalgia
sacramento	batismo
refúgio	tenda/barraca
rapaz	garoto/filho/menino
placar	conseqüência/resultado
peculiaridade	conduta/procedimento/maneira/comportamento/bobeira/sensatez/sagacidade/sapiência/sabedoria/modalidade/disciplina/firmeza/disposição/egocentrismo/egoísmo/atividade/natureza/índole/caráter/personalidade
pecado	pecado_capital/pecado_mortal/pecado_capital/queda/decadência
manufatura	produção
implemento	ferramenta/utensílio/ferramenta/implemento/instrumento/instrumento_musical/pau/bastão/vara/arpão/lança/barra/agulha/brocha/escova_de_dentes/pincel/escova
gênese	causa
camarada	colega/companheiro/amigo/camarada/amigo/irmão/companheiro/colega/camarada/amigo/companheiro/camarada/irmão
amiga	colega/companheiro/amigo/camarada/amigo/irmão/companheiro/colega/camarada/amigo/companheiro/camarada/irmão
abatimento	diminuição/declínio
vocábulo	forma_flexionada
turista	visita/visitante/estrangeira/estrangeiro
trilha	caminhos/trilhos/caminho/senda/trilho
tomo	tira/fatia/segmento/canto/anatomia/parte_do_corpo
repulsa	enjôo/náusea
planície	charneca/brejos/páramo/planície/planícies
orla	beira-mar/orla_marítima/litoral/costa
liturgia	liturgia
linhagem	família
furo	buraco
disfarce	máscara
degradação	desmoralização
criativo	fazedor/artista
calçados	tamanco/calçado/bota
alojamento	habitação/apartamento/moradia/quartos/albergue/hostelalbergue/aposento/habitação/moradia/residência/casa/lar/morada/domicílio/acampamento/apartamento
sabor	moda/tendências/estilo
peito	peito
pedaço	gota/tira/fatia/segmento/canto/porção/anatomia/parte_do_corpo/pano
laticínio	queijo/manteiga/creme/nata/leite
indiferença	afastamento/apatia/indiferença
discrepância	controvérsia/discordância/querela/discussão/disputa
demolição	desolação/ruína
cozinha	cozinha/culinária
performance	mecanismo/mecanica
parentesco	paternidade
medição	unidade_de_peso/peso/unidade_métrica
iniciação	causa
flanco	base
discórdia	controvérsia/discordância/querela/discussão/disputa
confinamento	custódia/detenção
conduto	ducto/duto/pipeline/condutas/canais/conduto/cano/chaminés_de_fábrica/canal/tubo/cachimbo
calça	calça/perna
viajante	visita/visitante/estrangeira/estrangeiro
shopping	boutique/venda/loja
imaginação	creatura_imaginaria/ser_imaginario
buraco	ranhura/buraco
brincadeira	flerte
autoridades	estado/palácio
atributo	qualidade/carácter_distintivo/característica/qualidade/grau/grandeza/número/magnitude/fraqueza/força/propriedades_físicas/propriedade_física/propriedades_acústicas/cheiro/odor/constituição/composição/estrutura/maneira/estilo/idade/propriedade/atributo/qualidade/personalidade/temperamento/pessoa/peculiaridade/feição/tempo/forma_geométrica/formato/forma/condição/situação/estado
agregação	reunião
viatura	sedan/jipe/taxi/táxi/calhambeque/carro/ambulância/ambulancia/hospital_militar_móvel
transgressão	crime/ofensa/pecado/adulteração/falsificação/desonestidade/imoralidade/imoralidade/maldade/transgressão/comportamento_errado
tabaco	rolo_de_tabaco
sabedoria	prudência
porção	resíduo/sobra/excedente/resto/restante/membro/unidade/componente/elemento/componente/tira/fatia/segmento/canto/drinque/bebida/pedaço/fatia/item/unidade_da_linguagem/unidade_linguística/anatomia/parte_do_corpo/seção/segmento/peça/pedaço/componente/parte/apêndice/substância
osso	dentes/dente
mutação	esdrúxulo/monstro
ira	cólera/raiva/ira/fúria
imoralidade	aposta/jogo_de_azar
festividade	festival
engano	bobagem/gafe/fiasco/negligência/descuido/erro/mancha/mácula
dígito	dedo/dedo_da_mão
descrição	caraterização/caracterização/descrição
criatividade	invenção/concepção/inovação/invenção/concepção/inovação/imaginação/imaginação
corda	fio/fio_têxtil/lã/corda
clã	genealogia/árvore_genealógica/família
causador	ameaça/risco/perigo/princípio_vital/poder/força/manipulador/operador/fado/aventurança/destino/indivíduo/pessoa/alguém/ser_humano/alma
catástrofe	força_maior
aposento	casa_de_banho/banheiro/sala/biblioteca/cozinha/edifício_residencial/habitação/casa/vivenda/sala/hall/casa_de_banho/banheiro/quarto_de_banho/sala_de_banho/bar
amante	homem/amante/amor
aceno	marca/selo/marcadores/numeral/número/selo/símbolo/mancha/marca/estigma
tristeza	remorso/pesar/tristeza/mágoa/terpena/tristeza/desgosto/amargura/pesar/dor/coração_partido/mágoa/pesar/tristeza/desgosto/dor
sensação	som/gosto/sabor
relógio	pulso_de_disparo/relógio/relógios
mágoa	tristeza/desgosto/amargura/pesar/dor/coração_partido
itinerário	direcção/direção/rumo/curso
infinito	espaço_topológico
hidrocarboneto	querosene/fuelóleo/petróleo/gasolina/benzina
guardião	guarda
fatia	parte/seção
córrego	ribeira/regato/rio
contendor	concorrente/desafiante/rival/competidor/contendor/opositor/adversário/oponente/desportista/atleta
chão	planície/campanha/ilha/arvoredo/mata/floresta/bosque/selva/florestas/chão/terra
abstrato	coisa/direito
traje	uniforme/fardamento/farda/chapéu/artigo_de_vestuário/roupa/vestuário/roupa/traje/vestuário/vestido
toque	colisão/pegada/agarrão/pegar/ósculo/beijo/contato/batida
topo	capitel
tinta	pigmento/pigmentos/corantes_têxteis/tintura/cor/corante/pigmento/pintura/cor/tinta
súdito	cidadão/cidadã
pedagogo	professor/acadêmico/professor_universitário
ingrediente	aromatizante/condimento/tempero
impotência	fraqueza
flagelo	força_maior
descendência	criança/menino/filho/família
cólera	cólera/raiva/ira/fúria
borda	cota_superior
apêndice	cabo/trinco/taramela/alça
antepassado	avó/avós/avô/progenitor/antepassado
anomalia	excêntrico/geek
adição	anexo/asa
prazer	prazer/alegria/deleite
ocultação	camuflagem
locomoção	passo/corrida/passo/caminhada
industria	expedição/transporte/transportação/finança/indústria/manufatura
fluido	líquido/gás
dedo	dedo/dedo_da_mão
comida	bebida/queijo/manteiga/ração/rações_para_animais/hortifruti/hortifruto/vianda/carne/fornada/chocolate/repasto/refeição/suprimentos/provisões/alimentos/alimento/produtos_alimentares/nutriente/alimentação/alimento/comida/nutrição/prato/petisco/guloseima/prato/comestivel/alimento
colo	peito
bioma	arvoredo/mata/floresta/bosque/selva/florestas/arvoredo/mata/floresta/bosque/selva/florestas
aversão	aversão/ressentimento/hostilidade/repulsa/inimizade/enjôo/náusea/repugnância/náusea/repulsa/abominação/asco/nojo/aversão
astro	estrela/planeta
aeródromo	aeródromo/aeroporto
adulteração	enganação/dissimulação
vegetação	mata/bosque/floresta/chaparral
tubo	vaso
ruído	anilhagem/rufo/batida/ruído/gorjeio/trinado/chilro/ruído/baterpalmas/explosão
romaria	parada/desfile/procissão/marcha/passeata
psicopata	psicose/megalomania
persuasão	arma/recurso
pavimento	mansarda/ático/trapeira/sótão/porão/cave
ociosidade	retardar/adiar/atraso/pausa/intervalo
morada	edifício_residencial/habitação/casa/vivenda
louça	vidro
locução	provérbio/expressão_idiomática/ditado
gordura	óleo/tecido_adiposo/lípidos/gordura
gestos	gesto
fibras	bisso
estrato	superfície/mulherio/mulher/ordem/mercado/classe_média/burguesia/fraternidade/ordem/irmandade
desonestidade	traição
desconsideração	esnobada/desprezo
curva	arco
curiosidade	interesse/interesse
cortina	reposteiro/cortina
convencimento	arma/recurso
catástrofes	força_maior
carburante	cozedura/lenha/querosene/fuelóleo/petróleo/gasolina/benzina/coque
apetite	concupiscência/cio/eros/desejo/saudade/anseio/anelo/desejo/afã/ambição/aspiração/pretensão
apatia	afastamento
ancestral	progenitor/antepassado
vulgo	ralé
vestido	uniforme/fardamento/farda/chapéu/artigo_de_vestuário/roupa/vestuário/roupa/traje/vestuário/vestido
vaso	vaso_sanguíneo/vaso_sangüíneo/vaso_sanguíneo/frasco/garrafa/garrafa/biberão/botelha/banheira
termino	desaparecimento/morte/homicídio/assassinato/destruição/devastação/demissão
tabuleiro	tabuleiro_de_xadrez
sacola	bolsa
procissão	parada/desfile/procissão/marcha/passeata
prenome	nome_comercial/título/prenome/nome_próprio/antenome/primeiro_nome/nome/denominação/nome_de_batismo/título/sobrenome/apelido/cognome/nome_de_família
perfeição	sonho
paredes	muralha/parede/muro
métodos	sistema
moita	camellia_sinensis/pimenta/pimentão/rosa/rosas/rosa/algodão
inseto	rainha/sota/operário/himenópteros
imitação	paródia/imitação/mímica
facto	detalhe
espaçamento	distância/distância/espaçamento/composição
desonra	ignomínia/desgraça/vergonha
desgosto	tristeza/desgosto/amargura/pesar/dor/coração_partido
custos	taxa/custo/preço/recompensa/pagamento
criatura	larva/ave_de_caça/caça/presa/predadores/invertebrado/invertebrados/cordados/herbívoro/cria/filhote/prole/macho/fêmea/animal_doméstico/animal_doméstico
conhecida	conexão
boxe	combate/luta
ansiedade	preocupação/temor/medo
abstração	conjunto/comunicação/mensagem/conexão/relação/grupo/agrupação/conjunto/propriedade/característica/atributo/predicado/característica_psicológica
ânsia	preocupação/temor/medo
verdura	folhas/vegetal
varão	homem/homem/rapaz/menino/moço/menino/rapaz/garoto/rapaz/garoto/moço/homem/menino/sujeito/cara
traumatismo	fratura/fractura
símbolos	marca/selo/marcadores/numeral/número/selo/símbolo/mancha/marca/estigma
propulsão	tiro/pontaria/pulo/salto/alcar/elevação/levantamento/tração/puxão/impulso/impulsão/empurrão/rolamento/impulsão/forca/empurrão/impulso
pressuposição	base/fundação
motocicleta	mota/motocicleta/ciclomotor/mota/moto/motocicleta
moto	mota/motocicleta/ciclomotor/mota/moto/motocicleta
maldade	responsabilidade
listagem	lista/conjunto_de_caracteres
jejum	greve_de_fome/greve_de_fome
horticultura	floricultura
fungo	bolor/micetes/mofo/líquenes/líquenes/líquen
explanação	teoria
espirito	fantasma/alma/espírito/anjo/deus/deusa/deidades/divinidade/deus/divindade/deidade
esconderijo	esconderijo
erva	relva/grama/ervas/erva/gramínea/gramíneas
discordo	controvérsia/discordância/querela/discussão/disputa
decoração	joalheria/jóia/joalharia/ornamento/decoração/ornamento/ornamento/decoração
culinária	cozinha/culinária
contêiner	vaso/vasilha/vasilhame/recipiente/pacote/embalagem/molde/copo/envelope/sobrescrito/sobrecarta/lata/vasilha/lata/caixa_de_lata/vasilha/caixa/cesto/cesta/sacola/bolsa/saco
cobertor	camuflagem
certame	corrida/partida/luta/combate/jogo/competição/torneio/corrida
abstinência	jejum
tábua	tábua_de_passar_roupa
treino	exercício/prática
traslado	migração/manobra/precipitação/aceleração/regresso/retorno/descensão/elevação/ascensão/caçada/perseguição/travessia/viagem/locomoção/progressão/avanço
torneio	corrida/partida/luta/combate/jogo/competição/torneio/corrida
terminação	desaparecimento/morte/homicídio/assassinato/destruição/devastação/demissão
telhado	abóbada
tampa	tampa
secção	tira/fatia/segmento/canto/anatomia/parte_do_corpo
santificação	consagração
rotação	torção/giro
regulamentos	restrição/limitação
recompensa	compensação_por_danos/compensação/remuneração/compensação/recompensa
recipiente	vaso/vasilha/vasilhame/recipiente/pacote/embalagem/molde/copo/envelope/sobrescrito/sobrecarta/lata/vasilha/lata/caixa_de_lata/vasilha/caixa/cesto/cesta/sacola/bolsa/saco
raiva	cólera/raiva/ira/fúria
prato	salada/doce/sobremesa/sopa
perspicácia	ideia/opinião/juízo
padrões	sistema_monetário
nicho	ábside/abside
missiva	invitação/convite
microorganismo	protoctista/prototista
mercantilismo	pagamento/venda/industria/comércio/negócio/empresa
melodia	encabeçamento
maquinário	moinhos/moinho
macho	homem/homem/rapaz/menino/moço/menino/rapaz/garoto/rapaz/garoto/moço/homem/menino/sujeito/cara/cavalo
itinerários	direcção/direção/rumo/curso
infortúnio	infortúnio
imaturidade	infância/infância
genitor	genitor/mãe/pai/progenitor/progenitora/mãe/pai/papá/painho/papai
fragmento	gota/órgão_vegetal/órgão/chapéu/porção
façanha	andada/andar_até_a_primeira_base/obtenção/realização/chegar_la/façanha/proeza/batida/rebatida/jogada/façanha/proeza/realização/feito
familia	genealogia/árvore_genealógica/família
espião	espião
escape	escapada/fuga/escape
embarcações	iate/navios/embarcação/navio/barco/batel/escaler/barco/bote
efetuação	meio/caminho/jeito/modo/maneira/ferramenta
duto	ducto/duto/pipeline/condutas/canais/conduto/cano/chaminés_de_fábrica/canal/tubo/cachimbo
divindade	santo
divertimento	apresentação/exibição/divertimento/distração/distracção
ditado	provérbio/expressão_idiomática/ditado
desfeita	desconsideração/injúria/ofensa/afronta/insulto
contratador	constructor/construtor/empreiteiro
consorte	mulher/esposa
concha	concha
cheiro	fragância/aroma
causalidade	efeito
carruagem	táxi
brinde	prêmio/galardão/prémio/apoio_financeiro/ajuda_financeira/ajuda
bagunça	doença
avós	avó/vovó/vovozinha/vovô/avô
ativos	crédito/dinheiro/finanças/fundos/fundo_de_maneio/capital/fundos/recurso_material/seguro/fundos_de_investimento/investimento/custo/atribuição
aglomeração	informação/dados/lei/jurisprudência/ciências_jurídicas/cobertura_vegetal/flora/vegetação/circulação/trânsito/tránsito/trânsito/tráfego/transito/exposição/exposições/miscelanea/potpourri/mistura/encepamento/frota/galáxia/nebulosa/via_láctea/embrulho/embalagem/pacote/família/grupo/classe/categoria/jogo/grupo/biota/biologia/mitologia/mitologia/biblioteca/biblioteca/biblioteca_de_rotinas/combinação/cúmulo/acúmulo/pilha/monte/grupo/montão/pedaço/torrão/bola/grupo/aglomeração/mão/pacote/bloco/grupo/conjunto/universo
afeição	lealdade
vivenda	refúgios_na_montanha
tórax	peito
turba	tropa/multidão/leva/legião/multidão/horda/turba/massa/multidão/exército
tumores	neoplasia/tumores/tumor
traseiro	pé
tez	tom/tintura/matiz
tapete	capacho/tapete/carpete
semblante	feiúra/feiura/feiúra/beleza/belo/aparência/expressão/rosto/rosto/semblante/aparência/rosto/face/aparência/rosto/aspecto/aparência
secreção	hormônios/hormônio/hormona
sagacidade	prudência
roedor	rattus/rato/ratazana/rato/ratazana/mus/mouse/rato_do_computador/camundongo
reza	bênção
repugnância	enjôo/náusea
radiações	radiação_electromagnética/onda_eletromagnética/radiação_eletromagnética
radiação	radiação_electromagnética/onda_eletromagnética/radiação_eletromagnética
pugna	conflito/disputa
pugilismo	combate/luta
psicopatia	psicose/megalomania
provérbio	provérbio/expressão_idiomática/ditado
prosa	não-ficção
projecto	programa
progenitor	progenitora/mãe/genitor/pai/papá/painho/papai
porrada	chute/pontapé
poliedro	pirâmide
personificação	imitação/mímica
ornamento	joalheria/jóia/joalharia/emblema/naipe/ornamento/decoração/ornamento
náusea	enjôo/náusea
nojo	enjôo/náusea
mímica	paródia
mutantes	esdrúxulo/monstro
legume	folhas/vegetal
larva	verme/larva/lagarta/larva
intercorrência	cabimento/possibilidade
hortaliça	folhas/vegetal
genealogia	família/sangue/descendência/linhagem
extremidade	limite/final/fim/limite/fronteira/fronteiras
elegância	fulgor
dádiva	prêmio/galardão/prémio/apoio_financeiro/ajuda_financeira/ajuda
documentos	missiva/carta/documento/documentação/inscrição/seção/parte/texto
divisória	muralha/parede/muro
deusa	santo
defunto	restos_mortais/corpo/defunto/enchido/cadáver
danificação	ferimento
crónica	biografia
critica	cálculo/estimativa/avaliação
crista	crista
consternação	pânico/terror/medo/tremor/tremura/arrepio/calafrio/tremedeira
compactação	trituração/pulverização
catequizar	arma/recurso
cataclismo	força_maior
boutique	farmácia/farmacia/botica/drograria/drogaria
bote	barco/balsa/barca/bateira/barcaça
bobeira	absurdidade
besta	larva/ave_de_caça/caça/presa/predadores/invertebrado/invertebrados/cordados/herbívoro/cria/filhote/prole/macho/fêmea/animal_doméstico/animal_doméstico
balada	festa
atrocidade	atrocidade
apodrecimento	ruína/cárie
amplidão	altitude/altura
adorno	ornamento/decoração/ornamento