ser	indivíduo/pessoa/alguém/ser_humano/alma
ano	ano/tempo/etapa/período/tempo/etapa/período/tempo/etapa/período
ter	incluir/abarcar/conter/ter
presidente	chefe/líder
partido	organização
dia	dia/tempo/etapa/período/tempo/etapa/período/tempo/etapa/período/oportunidade/chance
estado	autoridades/governo/regime
rio	corrente/córrego
político	chefe/líder
eleger	seleccionar/escolher/selecionar/seleccionar/escolher/selecionar
comissão	organização
assumir	antecipar
cargo	ofício/trabalho/serviço/emprego/função/lugar/profissão/ocupação
legenda	organização
passar	oferecer/dar_de_presente/dar/regalar/entregar/ganhar_terreno/viajar/ir/caminhar/andar/viajar/ir/caminhar/andar/viajar/ir/caminhar/andar
primeiro	posição/hierarquia/classe/posto
filho	descendente/descendência/filho/parente
membro	porção/parte/componente/categoria
fazer	mudar/modificar/alterar/atuar/comportar-se/agir/parecer
deixar	passar/entregar/ceder/dar/oferecer/dar_de_presente/dar/regalar/entregar/deslocar/mexer/mover/mudar/modificar/alterar
mês	tempo/etapa/período
poder	gastar/despender/compreensão/conhecimento/noção/cognição/causa/causador
exercer	trabalhar
realizar	terminar/acabar/encerrar/finalizar
todo	objeto/objeto_físico
governador	indivíduo/pessoa/alguém/ser_humano/alma
projeto	pensamento/idéia/conceito/opinião
política	raciocínio/argumentação/profissão
empresa	estabelecimento/instituição/instituto/organização/comércio/mercantilismo/comercialismo
apoio	auxílio/socorro/ajuda/assistência
promover	aconselhar/sugerir/propor
fim	meta/alvo/intenção/objectivo/fenômeno/fenómeno
obter	receber/obter/comprar/adquirir/receber/obter/comprar/adquirir
vez	instância/ocorrência/exemplo/caso/ocasião
iniciar	discutir/iniciar/começar
campanha	relevo_(geografia)/chão/terra_firme/terra/relevo/solo/manobra/operação
votar	seleccionar/escolher/selecionar
assembléia	assembléia_legislativa/legislatura/poder_legislativo
criar	criar/produzir/fazer/construir
curso	rota/caminho/percurso/itinerário/estrada/linha/itinerários/pedagogia/ensino/formação/educação/didáctica/ensinamento/instrução
ministério	edifício/prédio
função	pacote_de_software/software/programa/obrigação/dever
período	idade/tempo/período/escala_de_tempo_geológico/era/época/século/duração/continuidade/tempo/etapa/período/tempo/etapa/período/tempo/etapa/período/tempo/etapa/período/tempo/etapa/período/tempo/etapa/período
partir	deslocar/mexer/mover/deslocar/mexer/mover
jornal	publicação/edição
grupo	acúmulo/aglomeração/colecção/coleção/acúmulo/aglomeração/colecção/coleção/acúmulo/aglomeração/colecção/coleção/acúmulo/aglomeração/colecção/coleção
chefe	orientador/supervisor/chefe/líder/indivíduo/pessoa/alguém/ser_humano/alma
dar	prover/suprir/abastecer/fornecer/passar/entregar/ceder/dar/oferecer/dar_de_presente/dar/regalar/entregar/oferecer/dar_de_presente/dar/regalar/entregar
escola	edifício/prédio
diretor	gerente/administrador
apresentar	mencionar/citar/aludir/falar/contar/dizer
formar	mudar/modificar/alterar
voltar	trazer/tirar/transportar/levar
força	força/força/agressão/hostilidade/causa/causador
receber	receber/obter/comprar/adquirir
nome	nome_de_batismo/primeiro_nome/nome_próprio/prenome/nome/antenome
atividade	peculiaridade/feição/ato/ação/feito/acção/ato/ação/feito/acção
distrito	regiões/região
líder	chefe/líder/indivíduo/pessoa/alguém/ser_humano/alma
substituir	substituir/mudar/modificar/alterar
publicar	criar/produzir/fazer/construir
parte	fatia/música/indivíduo/pessoa/alguém/ser_humano/alma/objeto/objeto_físico
programa	espectáculo/show/pacote_de_software/software/programa/código/programa/projeto/intenção/programação/plano/projecto/pensamento/idéia/conceito/opinião
instituto	organização/sociedade/ordem/união/associação
secretário	servidor/criado/assistente/ajudante
ação	ato/ação/feito/acção
vir	viajar/ir/caminhar/andar
cadeira	assento/cadeira/mobiliário/alfaia/movéis/móvel/mobília
considerar	sentir/experimentar/achar/pensar/achar/pensar
lei	acúmulo/aglomeração/colecção/coleção/concepção/idéia/conceito/ideia
medida	grandeza/número/magnitude
manter	ter/ter/ter/manter/guardar/segurar/reter/sentir/experimentar/teimar/insistir
administração	gestão/administração
aliança	organização
sistema	técnica/método/método/metodo/métodos
base	composto_químico/substância_química/suporte/encosto/apoio
organização	organização
tempo	tempo/etapa/período/tempo/etapa/período/tempo/etapa/período/tempo/etapa/período/tempo/etapa/período/tempo/etapa/período
união	organização/jogo/grupo
declarar	falar/contar/dizer
ato	ato/ação/feito/acção
exército	serviço_militar/serviço_militar/montão/multidão/turba
arena	estrutura/tecido/edifício
objetivo	meta/alvo/intenção/objectivo
frente	lado/face
transferir	passar/entregar/ceder/dar
vida	tempo/etapa/período/tempo/etapa/período/tempo/etapa/período/intenção/motivação/motivo/necessidade/indivíduo/pessoa/alguém/ser_humano/alma
área	regiões/região
reunião	assembléia/reunião
indústria	industria/comércio/negócio/empresa
guerra	batalha/combate
concluir	mudar/modificar/alterar
estudo	documento/documentação
representante	indivíduo/pessoa/alguém/ser_humano/alma
serviço	serviço_religioso/serviço/obrigação/dever
gestão	gestão/administração
posição	classe/condição/posição/status/estado/estado/estado/situação/condição/ofício/trabalho/serviço/emprego/função/lugar/profissão/ocupação
professor	autoridade
comércio	transação/comércio/mercantilismo/comercialismo
economia	organização/sistema
caso	preocupação/interesse
lado	superfície/superfície
vitória	vitória/final/conclusão/resultado/fim/chegada
trabalhar	trabalhar
ir	ganhar_terreno/viajar/ir/caminhar/andar/viajar/ir/caminhar/andar/viajar/ir/caminhar/andar/viajar/ir/caminhar/andar/viajar/ir/caminhar/andar/viajar/ir/caminhar/andar/acontecer/ocorrer/suceder/passar
colégio	edifício/prédio
plano	pensamento/idéia/conceito/opinião
direção	rota/caminho/percurso/itinerário/estrada/linha/itinerários
problema	dificuldade/obstáculo/problema
associação	organização
executivo	gerente/administrador
ocorrer	acontecer/ocorrer/suceder/passar
época	tempo/etapa/período/tempo/etapa/período/tempo/etapa/período
coligação	organização
representar	falar/contar/dizer
fazenda	oficina/laboratório/emprego/locais_de_trabalho/trabalho
maioria	número
instituição	organização/sociedade/ordem/união/associação
situação	situação/condição/estado/estado/situação/condição
decidir	seleccionar/escolher/selecionar
organizar	solicitar/pedir/requerer/requisitar
retornar	trazer/tirar/transportar/levar
defesa	estrutura/tecido/edifício/batalha/combate
começar	iniciar/começar
seguir	viajar/ir/caminhar/andar/viajar/ir/caminhar/andar
encontrar	receber/obter/comprar/adquirir/receber/obter/comprar/adquirir
companhia	visita/visitante/estabelecimento/instituição/instituto/organização/organização
trabalhador	indivíduo/pessoa/alguém/ser_humano/alma
região	regiões/região/regiões/região/locação/ponto/lugar/localização/locação/ponto/lugar/localização
hora	hora/tempo/etapa/período/tempo/etapa/período
carta	papel/texto
ligar	prender/fixar
revista	publicação/edição
permitir	deixar/permitir/consentir
atuação	espectáculo/show
enviar	transmitir
tarde	tempo/etapa/período
chapa	organização
ordem	estado/estado/situação/condição/organização/sociedade/ordem/união/associação/organização/classe_social/classe/estrato/classe_social/classe/estrato/ordem/comando/ordem/comando
bem	possessão/propriedade
liderança	classe/condição/posição/status/estado/chefe/líder
servir	trabalhar
armar	prover/suprir/abastecer/fornecer
artigo	informação
posto	classe/condição/posição/status/estado/classe/condição/posição/status/estado/instalação/infra-estrutura/ofício/trabalho/serviço/emprego/função/lugar/profissão/ocupação
formação	objeto/objeto_físico
petróleo	combustível/material_com_que_se_aquece/carburante
luta	certame/partida/concurso/competição/torneio/jogo/batalha/combate/esforço/tentativa
continuar	viajar/ir/caminhar/andar
renunciar	passar/entregar/ceder/dar
controle	estado/estado/situação/condição
superior	chefe/líder
interesse	preocupação/interesse
centro	edifício/prédio
fato	informação
propriedade	concepção/idéia/conceito/ideia
procurar	buscar/procurar
dirigir	governar/reger/viajar/ir/caminhar/andar
pedir	elicitar/provocar/incitar/estimular/concitar/solicitar/pedir/requerer/requisitar
marcar	conter/limitar/restringir/mudar/modificar/alterar
segurança	segurança/estado/estado/situação/condição
escolher	resolver/decidir/seleccionar/escolher/selecionar/seleccionar/escolher/selecionar/seleccionar/escolher/selecionar
morte	alteração/mudança/variação/modificação
responsável	chefe/líder
instalar	colocar/carregar/botar/pôr/colocar/carregar/botar/pôr
família	parente/família/tribo/familia/clã/família/acúmulo/aglomeração/colecção/coleção/concepção/idéia/conceito/ideia
sessão	encontro/reunião
década	tempo/etapa/período
destinar	planejar
provocar	aporrinhar/chatear/importunar/irritar/vexar/incomodar/molestar/perturbar/aborrecer/amolar/agastar/elicitar/provocar/incitar/estimular/concitar
cultura	ontogenia/ontogénese/crescimento
resultado	resultado/placar/final/conclusão/resultado/fim/chegada/fenômeno/fenómeno
documento	comunicação/mensagem
departamento	departamento/divisão/departamento/divisão/edifício/prédio
número	aceno/emblema/símbolos/símbolo/sinal/simbolo/sinal/soma/número/quantidade/concepção/idéia/conceito/ideia/grandeza/número/magnitude
momento	tempo/etapa/período/tempo/etapa/período
lugar	classe/condição/posição/status/estado/locação/ponto/lugar/localização/objeto/objeto_físico
pai	genitor/mãe/pai/progenitor
ver	aperceber/entender/perceber/aperceber-se/aperceber/entender/perceber/aperceber-se/conjeturar/pensar/imaginar/conjecturar/achar/pensar
produção	espectáculo/show/indústria/manufatura
classe	classe/condição/posição/status/estado/jogo/grupo/acúmulo/aglomeração/colecção/coleção/pessoal/população/povo/gente/classe/família/categoria/concepção/idéia/conceito/ideia
ponto	região/área/objeto/objeto_físico
exercício	treinamento/preparação/treino
advogado	profissional_liberal/profissional/indivíduo/pessoa/alguém/ser_humano/alma
jornalista	escritor/autor
discurso	comunicação/mensagem/comunicação/mensagem
orientação	atitude
ciência	disciplina_cientifica/ciência/campo/domínio/disciplina
crime	crime/ofensa
sociedade	organização/sociedade/ordem/união/associação/organização
santo	deus/deusa/deidades/divinidade/deus/divindade/deidade
aceitar	receber/obter/comprar/adquirir/deixar/permitir/consentir
belo	aspecto/aparência/semblante
fundo	depressão/lado/face
anunciar	jogar/falar/contar/dizer
central	oficina/laboratório/emprego/locais_de_trabalho/trabalho
delegação	organização
realização	conquista/façanha/realização/feito/conquista/façanha/realização/feito/ato/ação/feito/acção
disputa	batalha/pugna/peleja/luta/disputa/combate
necessidade	necessidade/carência/estado/estado/situação/condição
mercado	classe_social/classe/estrato
aumento	alteração/mudança/variação/modificação/aumento/acrescentamento
assistência	auxílio/socorro/ajuda/assistência
pessoa	indivíduo/pessoa/alguém/ser_humano/alma/causa/causador
sentido	pensamento/idéia/conceito/opinião
mudança	alteração/mudança/variação/modificação/alteração/mudança/variação/modificação
linha	texto
pessoal	organização/pessoal/população/povo/gente
elaborar	explicar
preço	despesa/gasto/valor/importância/valor/importância
povo	família/pessoal/população/povo/gente/pessoal/população/povo/gente/pessoal/população/povo/gente/humano/ser_humano
indicação	agouro/presságio/indício/indicação/sinal/comunicação/mensagem
terra	relevo_(geografia)/chão/terra_firme/terra/relevo/solo/objeto/objeto_físico/objeto/objeto_físico
colocar	colocar/carregar/botar/pôr/colocar/carregar/botar/pôr/colocar/carregar/botar/pôr/prender/fixar/cobrir/tampar
tropa	montão/multidão/turba
combate	certame/partida/concurso/competição/torneio/jogo/batalha/combate
profissional	adulto/de_maior
incluir	incluir/abarcar/conter
adotar	seleccionar/escolher/selecionar
pagamento	comércio/mercantilismo/comercialismo
missão	organização
conceder	admitir/confessar/reconhecer
prisão	situação/condição
acompanhar	viajar/ir/caminhar/andar
clube	organização/sociedade/ordem/união/associação/edifício/prédio
tentativa	esforço/tentativa/esforço/tentativa
possibilidade	concepção/idéia/conceito/ideia/alternativa/opção/escolha/intercorrência/eleição
atingir	receber/obter/comprar/adquirir/receber/obter/comprar/adquirir/tocar/bater/terminar/acabar/encerrar/finalizar/afetar/impactar
sindicato	organização/sociedade/ordem/união/associação
filha	criança/menino/filho
prender	segurar/agarrar/capturar/pegar
sair	deslocar/mexer/mover
casa	domicílio/residência/casa/endereço/estrutura/tecido/edifício/alojamento/abrigo/casa/aposento/habitação/moradia/residência/casa/lar/morada/domicílio/edifício/prédio/edifício/prédio/locação/ponto/lugar/localização
encerrar	mudar/modificar/alterar
assunto	comunicação/mensagem
distribuição	ato/ação/feito/acção
caráter	peculiaridade/feição
transporte	industria/comércio/negócio/empresa
unidade	porção/parte/componente/categoria/objeto/objeto_físico
golpe	mudança
liberdade	liberdades_civis/liberdade
conhecido	indivíduo/pessoa/alguém/ser_humano/alma/indivíduo/pessoa/alguém/ser_humano/alma
virtude	valor/importância
opinião	crença/opinião/fé/convicção
conflito	batalha/pugna/peleja/luta/disputa/combate
encontro	assembléia/reunião
dom	aquisição
título	nome_de_batismo/primeiro_nome/nome_próprio/prenome/nome/antenome
seção	fatia/música
estudante	indivíduo/pessoa/alguém/ser_humano/alma/indivíduo/pessoa/alguém/ser_humano/alma
instalação	instalação/infra-estrutura
livro	publicação/edição
café	bebida
transformar	forjar/formar/modelar/moldar/mudar/modificar/alterar/mudar/modificar/alterar/mudar/modificar/alterar
sofrer	sentir/experimentar
médico	profissional_liberal/profissional
homem	amante/adulto/de_maior/humano/ser_humano/indivíduo/pessoa/alguém/ser_humano/alma/indivíduo/pessoa/alguém/ser_humano/alma
manifestação	software_de_demonstração/demo/demonstração
comitê	organização
convite	missiva/carta
crescimento	alteração/mudança/variação/modificação
prazo	tempo/etapa/período
convidar	solicitar/pedir/requerer/requisitar/solicitar/pedir/requerer/requisitar
morais	intenção/motivação/motivo/necessidade
embaixada	organização
elemento	porção/parte/componente/categoria
servidor	servidor/empregado_doméstico/servidor_público/funcionário/serventuário/trabalhador/trabalhador
relatório	documento/documentação
dólar	divisa/prata/peça/moeda
igreja	estabelecimento/instituição/instituto/edifício/prédio
solução	substância
diário	livros/livro
combater	disputar/lutar/brigar
crédito	dívidas/dívida/dívida/débito
papel	papel/materiais/obrigação/dever
engenharia	campo/domínio/disciplina
tecnologia	campo/domínio/disciplina
idéia	pensamento/idéia/conceito/opinião
espírito	emoção/comoção/abalo/sentimento
solicitar	solicitar/pedir/requerer/requisitar
parecer	combinar/corresponder/concordar
proprietário	homemdenegócios/homem_de_negócios/empresário/negociante/comerciante/indivíduo/pessoa/alguém/ser_humano/alma
data	dia
autoridade	especialista/livro/indivíduo/pessoa/alguém/ser_humano/alma
informação	acúmulo/aglomeração/colecção/coleção/informação/compreensão/conhecimento/noção/cognição
estabelecimento	estrutura/tecido/edifício
surgir	parecer
caber	servir/ficar/caber
idade	tempo/etapa/período/tempo/etapa/período
população	pessoal/população/povo/gente
aumentar	acrescer/acrescentar/crescer/aumentar/mudar/modificar/alterar
operário	trabalhador/hemípteros/inseto/insetos/insecto/insectos
emprego	hábito/costume
negar	manter/guardar/segurar/reter
tema	pensamento/idéia/conceito/opinião
campo	instalação/infra-estrutura
comunicação	ato/ação/feito/acção
exigir	exigir/demandar/solicitar/pedir/requerer/requisitar
prática	treinamento/preparação/treino
planejamento	ideia
limite	fronteira/limite
viajar	viajar/ir/caminhar/andar/viajar/ir/caminhar/andar
conjunto	acúmulo/aglomeração/colecção/coleção
entregar	passar/entregar/ceder/dar/passar/entregar/ceder/dar/passar/entregar/ceder/dar/oferecer/dar_de_presente/dar/regalar/entregar/oferecer/dar_de_presente/dar/regalar/entregar
dirigente	gerente/administrador
bloco	acúmulo/aglomeração/colecção/coleção
conseqüência	resultado/placar/fenômeno/fenómeno
estrutura	constituição/composição/estrutura
palácio	autoridades/governo/regime
ligação	ligação/conexão/interação
protesto	protesto
suceder	acontecer/ocorrer/suceder/passar
influência	consequência/conseqüência/resultado/fim/efeito
derrota	final/conclusão/resultado/fim/chegada
conquistar	atuar/comportar-se/agir/parecer
rede	pano/tecido/fazenda/têxteis/tecido_têxtil
fonte	instalação/infra-estrutura
mudar	substituir
mostrar	expor/apresentar/exibir/mostrar
reduzir	reduzir/diminuir/reduzir/diminuir/reduzir/diminuir/mudar/modificar/alterar
abandonar	cessar/acabar/parar/terminar/desistir/finalizar/deixar/descontinuar/passar/entregar/ceder/dar
motivo	pensamento/idéia/conceito/opinião
decretar	resolver/decidir
engenheiro	indivíduo/pessoa/alguém/ser_humano/alma
contato	interação/ato/ação/feito/acção
arma	arma/armamento/aparelho/ferramenta/instrumento
revisão	exercício/prática
ampliar	mudar/modificar/alterar
empréstimo	dívidas/dívida/dívida/débito
resistência	oposição
ganhar	receber/obter/comprar/adquirir/receber/obter/comprar/adquirir/receber/obter/comprar/adquirir/receber/obter/comprar/adquirir
cumprir	terminar/acabar/encerrar/finalizar
nação	pessoal/população/povo/gente/pessoal/população/povo/gente
preparar	leccionar/instruir/ensinar/lecionar/mudar/modificar/alterar
causa	ato/ação/feito/acção
leite	bebida
território	regiões/região/regiões/região
origem	instalação/infra-estrutura
fase	tempo/etapa/período
negócio	comércio/mercantilismo/comercialismo
terminar	mudar/modificar/alterar
venda	shopping/centros_comerciais/shopping_center/venda/comércio/mercantilismo/comercialismo
autorizar	deixar/permitir/consentir
folha	papel/folha/folha_de_papel/folhas/papel
respeito	atitude
reconhecer	lembrar-se/lembrar/recordar/recordar-se
corpo	forças_armadas/exército/morto/cadáver/defunto/corpo/restos_mortais
vale	depressão
rocha	materiais/pedra/rocha
resolver	entender/compreender/comprender/melhorar/aperfeiçoar
implantar	prender/fixar
cruz	estrutura/tecido/edifício
conceito	pensamento/idéia/conceito/opinião
responder	falar/contar/dizer
falta	necessidade/carência
mulher	mulher/mulher/mulher/esposa/esposo/marido/cônjuge/cónjuge/consorte/adulto/de_maior/classe_social/classe/estrato
mesa	mobiliário/alfaia/movéis/móvel/mobília/mobiliário/alfaia/movéis/móvel/mobília
atitude	compreensão/conhecimento/noção/cognição
gás	líqüido/fluido/estados_físicos_da_matéria/fases_da_matéria
reação	oposição
exemplo	chefe/líder
dinheiro	cobre/dinheiro/moeda/divisa/cobre/dinheiro/moeda/divisa
tendência	atitude
ambiente	situação/condição/regiões/região
execução	ato/ação/feito/acção
praça	praça
disposição	peculiaridade/feição/ato/ação/feito/acção
suspender	pendurar
editar	criar/produzir/fazer/construir
saída	partida
julgar	raciocinar/cogitar/pensar/refletir
amigo	indivíduo/pessoa/alguém/ser_humano/alma/indivíduo/pessoa/alguém/ser_humano/alma
juiz	servidor_público/funcionário/serventuário/indivíduo/pessoa/alguém/ser_humano/alma
lutar	disputar/lutar/brigar
usina	planta/fábrica/usina
estender	estressar/tensionar
mão	acúmulo/aglomeração/colecção/coleção/auxílio/socorro/ajuda/assistência
intelectual	indivíduo/pessoa/alguém/ser_humano/alma
adesão	apoio/suporte
queda	alteração/mudança/variação/modificação/pecado
intenção	meta/alvo/intenção/objectivo/pensamento/idéia/conceito/opinião/pensamento/idéia/conceito/opinião
pôr	colocar/carregar/botar/pôr/colocar/carregar/botar/pôr/colocar/carregar/botar/pôr
mundo	pessoal/população/povo/gente/humano/ser_humano
jogo	acúmulo/aglomeração/colecção/coleção/certame/partida/concurso/competição/torneio/jogo
correio	mensagem
continuidade	tempo/etapa/período
referir	conectar/associar/relacionar
lista	lista/listagem/lista_numerada
manhã	tempo/etapa/período
conduzir	mudar/modificar/alterar
transmitir	passar/entregar/ceder/dar
visita	visita/visitante/visita
uso	ato/ação/feito/acção
qualidade	característica/carácter_distintivo/qualidade/propriedade/atributo/característica/carácter_distintivo/qualidade/propriedade/atributo/concepção/idéia/conceito/ideia/valor/importância
contribuir	pagar/mudar/modificar/alterar
esforço	esforço/tentativa/mão-de-obra/trabalho
assistente	trabalhador
conter	incluir/abarcar/conter/incluir/abarcar/conter/negar
julgamento	ato/ação/feito/acção
jornada	tempo/etapa/período
presente	aquisição
empregado	servidor/empregado_doméstico/trabalhador
admitir	admitir/confessar/reconhecer/deixar/permitir/consentir/deixar/permitir/consentir
jovem	indivíduo/pessoa/alguém/ser_humano/alma
efeito	consequência/conseqüência/resultado/fim/efeito/fenômeno/fenómeno
semana	tempo/etapa/período/tempo/etapa/período
item	porção/parte/componente/categoria
dispor	gastar/despender/colocar/carregar/botar/pôr
proteção	aprovaçã0/aprovação/batalha/combate
canalizar	governar/reger
permanência	ato/ação/feito/acção
limitar	reduzir/diminuir
dividir	expulsar/receber/obter/comprar/adquirir
ataque	ataque/manobra/operação
notícia	informação
transformação	alteração/mudança/variação/modificação
pagar	pagar/pagar
beneficiar	receber/obter/comprar/adquirir
grau	posição/hierarquia/classe/posto
modelo	servidor/criado/assistente/ajudante/chefe/líder
querer	ansiar/desejar/querer/ansiar/desejar/querer/ansiar/desejar/querer/ansiar/desejar/querer/ansiar/desejar/querer/ansiar/desejar/querer
completar	mudar/modificar/alterar
material	informação/equipamento/ferramenta
violência	agressão/hostilidade
ala	órgão_biologico/órgão
tipo	adulto/de_maior/classe/família/categoria
adquirir	receber/obter/comprar/adquirir/receber/obter/comprar/adquirir/atuar/comportar-se/agir/parecer
custo	despesa/gasto
preparação	ideia
ameaça	causa/causador
deter	manter/guardar/segurar/reter
exceção	representante/instância/exemplo
corte	vianda/carne
doença	enfermidade/doença
licença	tempo/etapa/período
preocupação	emoção/comoção/abalo/sentimento
aplicar	cobrir/tampar
categoria	acúmulo/aglomeração/colecção/coleção/classe/família/categoria/concepção/idéia/conceito/ideia
registrar	escrever/redigir
experiência	instrução/educação
moeda	cobre/dinheiro/moeda/divisa/cobre/dinheiro/moeda/divisa
agente	representante
mota	mota/moto/motocicleta
acumular	colocar/carregar/botar/pôr/acrescer/acrescentar/crescer/aumentar
sustentar	ter/sentir/experimentar/teimar/insistir
reivindicar	solicitar/pedir/requerer/requisitar/solicitar/pedir/requerer/requisitar
capacidade	compreensão/conhecimento/noção/cognição
legião	montão/multidão/turba
benefício	bem/recurso/virtude/vantagem/propriedade
consumidor	usuário/utilizador/utente
entender	entender/compreender/comprender/entender/compreender/comprender/entender/compreender/comprender/entender/compreender/comprender
demonstrar	revalidar/corroborar/provar/confirmar/suportar/sustentar/substanciar
massa	montão/multidão/turba
unir	juntar/unir/ligar/reunir/juntar/unir/ligar/reunir/juntar/unir/ligar/reunir
concordar	combinar/corresponder/concordar
máquina	maquinaria/máquina
conhecimento	compreensão/conhecimento/noção/cognição
rumo	rota/caminho/percurso/itinerário/estrada/linha/itinerários
extensão	espaço/grandeza/número/magnitude/grandeza/número/magnitude/grandeza/número/magnitude
trazer	mudar/modificar/alterar
abrigar	prover/suprir/abastecer/fornecer
aspecto	aspecto/aparência/semblante
residência	endereço/alojamento/abrigo/casa
intensificar	acrescer/acrescentar/crescer/aumentar
diferença	variação/mudança/flutuação
embarcação	embarcações/embarcação/barco/navio/navios
relacionar	raciocinar/cogitar/pensar/refletir
entrada	caminho/rodovia/via/estrada
ética	intenção/motivação/motivo/necessidade
prosseguir	viajar/ir/caminhar/andar/acontecer/ocorrer/suceder/passar
maneira	peculiaridade/feição
defensor	indivíduo/pessoa/alguém/ser_humano/alma
zona	região/área
significar	significar
montar	ascender/subir/viajar/ir/caminhar/andar
composição	posição/espaçamento
velho	adulto/de_maior
pressionar	tocar/bater
estimular	elicitar/provocar/incitar/estimular/concitar
tratamento	gestão/administração/assintência/cuidado
tarefa	obrigação/dever
independência	liberdades_civis/liberdade/vitória
equipamento	equipamento/ferramenta
caminho	caminho/rodovia/via/estrada/trâmite/curso_de_ação/conduta/curso/caminho/corrente
regulamentar	resolver/decidir
fronteira	fronteira/limite/locação/ponto/lugar/localização
concentrar	raciocinar/cogitar/pensar/refletir
sentar	colocar/carregar/botar/pôr
perda	final/conclusão/resultado/fim/chegada
mensagem	comunicação/mensagem/comunicação/mensagem
fortalecer	mudar/modificar/alterar
aluno	indivíduo/pessoa/alguém/ser_humano/alma
efetuar	terminar/acabar/encerrar/finalizar
confiança	crença/opinião/fé/convicção
risco	causa/causador
esperar	ansiar/desejar/querer/ansiar/desejar/querer/ansiar/desejar/querer/antecipar
navio	embarcações/embarcação/barco/navio/navios
doutrina	crença/opinião/fé/convicção
derrubar	virar-se/tornar-se/virar
atacar	disputar/lutar/brigar/afetar/impactar
prova	evidência
falar	leccionar/instruir/ensinar/lecionar
circular	viajar/ir/caminhar/andar
rosa	arvoreta/arbusto/moita/mato/arvoreta/arbusto/moita/mato
fábrica	planta/fábrica/usina
desejar	ansiar/desejar/querer/ansiar/desejar/querer/ansiar/desejar/querer/ansiar/desejar/querer/ansiar/desejar/querer/ansiar/desejar/querer
água	líquido/instalação/infra-estrutura
superar	elicitar/provocar/incitar/estimular/concitar
governar	governar/reger
operar	tratar
vigor	força
seminário	curso/aula
mecanismo	performance/execução/desempenho/realização
figura	adulto/de_maior
crescer	acrescer/acrescentar/crescer/aumentar
natureza	peculiaridade/feição
torres	estrutura/tecido/edifício
geração	pessoal/população/povo/gente
impedimento	estrutura/tecido/edifício/ato/ação/feito/acção
consumo	demanda/pedido
introduzir	falar/contar/dizer
criança	descendente/descendência/filho/indivíduo/pessoa/alguém/ser_humano/alma
noite	tempo/etapa/período/tempo/etapa/período/tempo/etapa/período/tempo/etapa/período
aparecer	surgir/aparecer
filosofia	crença/opinião/fé/convicção
associar	raciocinar/cogitar/pensar/refletir
ordenar	arranjar/dispor
executar	penalizar/punir/castigar/o_fazendeiro_matou_um_porco_para_o_natal./matar/o_fazendeiro_matou_um_porco_para_o_natal./matar/terminar/acabar/encerrar/finalizar
concentração	concentração/concentração/atenção/assembléia/reunião
cogitar	raciocinar/cogitar/pensar/refletir
baixar	viajar/ir/caminhar/andar/mudar/modificar/alterar
comprar	receber/obter/comprar/adquirir
recomendar	aconselhar/sugerir/propor
face	superfície/aspecto/aparência/semblante/indivíduo/pessoa/alguém/ser_humano/alma
sítio	oficina/laboratório/emprego/locais_de_trabalho/trabalho
primo	parente
ferro	metais/metais/metal/metais/metais/metal
escolar	lustrar/refinar/polir
pensamento	crença/opinião/fé/convicção
acrescentar	acrescer/acrescentar/crescer/aumentar
frota	acúmulo/aglomeração/colecção/coleção
autorização	gestão/administração
circulação	acúmulo/aglomeração/colecção/coleção
acontecer	acontecer/ocorrer/suceder/passar
convencer	persuadir
cidadão	indivíduo/pessoa/alguém/ser_humano/alma
parlamento	assembléia_legislativa/legislatura/poder_legislativo
agravar	mudar/modificar/alterar
avaliação	juízo/critica/julgamento
situar	colocar/carregar/botar/pôr
posicionar	colocar/carregar/botar/pôr
levantar	colocar/carregar/botar/pôr/mencionar/citar/aludir
notícias	informação/informação
cenário	situação/condição
século	tempo/etapa/período/tempo/etapa/período/tempo/etapa/período
apresentação	diversão/divertimento/entretenimento/entreterimento
investir	gastar/despender
recorrer	acontecer/ocorrer/suceder/passar
fornecer	prover/suprir/abastecer/fornecer
avaliar	raciocinar/cogitar/pensar/refletir
recuperação	ato/ação/feito/acção
prorrogar	adiar
personalidade	personalidade/temperamento/pessoa/peculiaridade/feição
manobra	manobra/operação
audiência	oportunidade/chance
seguro	proteção/abrigo
ocupação	ato/ação/feito/acção
nascimento	alteração/mudança/variação/modificação
ajuda	doação/presente/dádiva/brinde/dom/auxílio/socorro/ajuda/assistência/auxílio/socorro/ajuda/assistência
juventude	tempo/etapa/período
gastar	gastar/despender/pagar/pagar
prédio	estrutura/tecido/edifício
bairro	distrito/território/domínio/comarca/districto/circunscrição/circunscrição_administrativa
acelerar	apressar/correr/viajar/ir/caminhar/andar
programação	pensamento/idéia/conceito/opinião
periódico	publicação/edição
ausência	necessidade/carência
facilitar	ajudar/assistir/auxiliar/socorrer/solidarizar_se/acorrer
prejuízo	alteração/mudança/variação/modificação
figurar	conjeturar/pensar/imaginar/conjecturar
melhoria	estado/estado/situação/condição/componente/parte
consórcio	organização/sociedade/ordem/união/associação
ceder	oferecer/dar_de_presente/dar/regalar/entregar
transição	alteração/mudança/variação/modificação
aquisição	ato/ação/feito/acção
implementação	ato/ação/feito/acção
moral	intenção/motivação/motivo/necessidade
telegrama	mensagem
profissão	ofício/trabalho/serviço/emprego/função/lugar/profissão/ocupação/ofício/trabalho/serviço/emprego/função/lugar/profissão/ocupação
forçar	prender/fixar
ilha	relevo_(geografia)/chão/terra_firme/terra/relevo/solo/zona
vantagem	bem/recurso/virtude/vantagem/propriedade
recuperar	receber/obter/comprar/adquirir
habitação	alojamento/abrigo/casa/alojamento/abrigo/casa/aposento/habitação/moradia/residência/casa/lar/morada/domicílio/edifício/prédio/ato/ação/feito/acção
emissão	espectáculo/show
depósito	matéria/substância
empregador	chefe/líder
mãe	genitor/mãe/pai/progenitor
misturar	mudar/modificar/alterar
hierarquia	classe/condição/posição/status/estado
desistir	cessar/acabar/parar/terminar/desistir/finalizar/deixar/descontinuar/passar/entregar/ceder/dar
achar	receber/obter/comprar/adquirir/antecipar/achar/pensar
cobrar	cobrar
casamento	cerimónia/cerimônia/festa/rito/ritual
liberar	passar/entregar/ceder/dar
atrair	elicitar/provocar/incitar/estimular/concitar
sentir	aperceber/entender/perceber/aperceber-se
característica	característica/carácter_distintivo/qualidade/propriedade/atributo/concepção/idéia/conceito/ideia
disciplina	peculiaridade/feição
planejar	raciocinar/cogitar/pensar/refletir
mineral	materiais
reagir	atuar/comportar-se/agir/parecer
jurista	profissional_liberal/profissional/servidor_público/funcionário/serventuário
voz	comunicação/mensagem
lembrar	dar/legar/entregar/passar/deixar
conteúdo	comunicação/mensagem
hipótese	suposição/possibilidade/hipótese/teoria/concepção/idéia/conceito/ideia
diminuir	reduzir/diminuir/reduzir/diminuir/desabar/decrescer/minguar/diminuir/desabar/decrescer/minguar/diminuir/mudar/modificar/alterar
comarca	regiões/região
interferência	ato/ação/feito/acção
inimigo	pessoal/população/povo/gente
guarda	guarda
abranger	incluir/abarcar/conter
refletir	raciocinar/cogitar/pensar/refletir
falecimento	alteração/mudança/variação/modificação
questionar	ruminar/ponderar/cogitar/especular/contemplar/refletir
prêmio	doação/presente/dádiva/brinde/dom
pretensão	anseio/apetite/pretensão/desejo
mata	relevo_(geografia)/chão/terra_firme/terra/relevo/solo/cobertura_vegetal/flora/vegetação
matar	o_fazendeiro_matou_um_porco_para_o_natal./matar
corresponder	combinar/corresponder/concordar
exposição	acúmulo/aglomeração/colecção/coleção
estágio	tempo/etapa/período
estação	tempo/etapa/período/tempo/etapa/período/tempo/etapa/período/instalação/infra-estrutura
europeu	habitante/morador
denominação	nome_de_batismo/primeiro_nome/nome_próprio/prenome/nome/antenome
restringir	reduzir/diminuir
consultar	perguntar/indagar
administrar	tratar
excluir	expulsar
dúvida	dúvida/incerteza
alimentação	comida/alimento/nutriente
esclarecer	explicar
carga	mercadoria/artigo/produto
concepção	pensamento/idéia/conceito/opinião
monte	acúmulo/aglomeração/colecção/coleção/estrutura/tecido/edifício
cerimônia	acontecimento/festa
expor	explicar
obtenção	conquista/façanha/realização/feito
esperança	esperança/indivíduo/pessoa/alguém/ser_humano/alma
destino	causa/causador
sinal	sinal/mudança/comunicação/mensagem/comunicação/mensagem
pimenta	arvoreta/arbusto/moita/mato
imprimir	criar/produzir/fazer/construir
envio	partida
compreender	incluir/abarcar/conter/entender/compreender/comprender/entender/compreender/comprender/entender/compreender/comprender
preservar	manter/guardar/segurar/reter/cozinhar/preparar
gerente	líder/responsável/cabeça/chefe/liderança/gerente/administrador
mérito	valor/importância
afetar	afetar/impactar/mudar/modificar/alterar/mudar/modificar/alterar
duração	tempo/etapa/período
mencionar	conectar/associar/relacionar
obstáculo	estrutura/tecido/edifício
atravessar	passar/atravessar/ir/caminhar/andar/viajar/ir/caminhar/andar/deslocar/mexer/mover
altura	dimensão/extensão/amplidão/magnitude
alertar	avisar/alertar/advertir
pacote	acúmulo/aglomeração/colecção/coleção/acúmulo/aglomeração/colecção/coleção
pensar	antecipar
equilíbrio	estrutura/tecido/edifício
trocar	substituir/mudar/modificar/alterar
ouvir	aperceber/entender/perceber/aperceber-se/aperceber/entender/perceber/aperceber-se
administrador	líder/responsável/cabeça/chefe/liderança/gerente/administrador
domínio	estado/estado/situação/condição/regiões/região/regiões/região
atrito	confronto/recontro/conflito
comportamento	peculiaridade/feição
química	materiais
passado	tempo/etapa/período
letra	grafema/letra
juntar	juntar/unir/ligar/reunir/juntar/unir/ligar/reunir/juntar/unir/ligar/reunir
aguardar	ansiar/desejar/querer
cair	viajar/ir/caminhar/andar/expirar/morrer/bater_as_botas/falecer/comer_capim_pela_raiz/perecer/mudar/modificar/alterar
somar	acrescer/acrescentar/crescer/aumentar
parente	parente/parente/indivíduo/pessoa/alguém/ser_humano/alma
cobrir	cobrir/tampar/cobrir/tampar
avançar	viajar/ir/caminhar/andar
antecessor	parente
ultrapassar	ganhar_terreno
interessar	elicitar/provocar/incitar/estimular/concitar
álcool	bebidas_alcoólicas/álcool/bebida_alcoólica/álcoois/bebida_alcoólica
interpretar	entender/compreender/comprender
traduzir	entender/compreender/comprender/mudar/modificar/alterar
tiro	ataque
solucionar	entender/compreender/comprender
esporte	esporte/jogo
foco	concentração
influenciar	afetar/impactar
ramo	caule/tronco/departamento/divisão
dispensar	tratar
erro	engano/falha/equívoco/erro
aeroporto	instalação/infra-estrutura
repetir	soltar/emitir/acontecer/ocorrer/suceder/passar
desaparecer	deslocar/mexer/mover/desaparecer/sumir
largo	praça
batalha	batalha/combate/esforço/tentativa
vencimento	final/conclusão/resultado/fim/chegada
dono	homemdenegócios/homem_de_negócios/empresário/negociante/comerciante/indivíduo/pessoa/alguém/ser_humano/alma
converter	substituir/mudar/modificar/alterar
armamento	aparelho/ferramenta/instrumento
entrega	transporte/transferência
arte	talento/habilidade/meta/técnica/criação/ofício/trabalho/serviço/emprego/função/lugar/profissão/ocupação
ambulância	auto/veículo/carro/automóvel/viatura
adiar	adiar
restante	porção/parte/componente/categoria
divisa	cobre/dinheiro/moeda/divisa
senhora	mulher/mulher
perseguição	injúria/abuso
perigo	estado/estado/situação/condição/causa/causador
enfraquecer	desabar/decrescer/minguar/diminuir/mudar/modificar/alterar/mudar/modificar/alterar
aula	pedagogia/ensino/formação/educação/didáctica/ensinamento/instrução
ponte	estrutura/tecido/edifício
perceber	aperceber/entender/perceber/aperceber-se
assassinar	o_fazendeiro_matou_um_porco_para_o_natal./matar
melhorar	melhorar/aperfeiçoar/mudar/modificar/alterar
seguros	proteção/abrigo
potência	força
paralisação	ato/ação/feito/acção
unificar	mudar/modificar/alterar
estilo	comunicação/mensagem
teoria	concepção/idéia/conceito/ideia
requerer	exigir/demandar/solicitar/pedir/requerer/requisitar
elogiar	estimar/avaliar/medir
devolver	trazer/tirar/transportar/levar
circunstância	estado/estado/situação/condição
amizade	indivíduo/pessoa/alguém/ser_humano/alma/indivíduo/pessoa/alguém/ser_humano/alma
teatro	edifício/prédio
palestra	discurso
especialista	indivíduo/pessoa/alguém/ser_humano/alma
algodão	arvoreta/arbusto/moita/mato/pano/tecido/fazenda/têxteis/tecido_têxtil
aparelho	equipamento/ferramenta
anúncio	comunicação/mensagem
doação	aquisição
alimento	comida/alimento/nutriente/comida/alimento/nutriente/comida/alimento/nutriente
agitação	mudança
trecho	duração/continuidade
procedimento	peculiaridade/feição
edifício	estrutura/tecido/edifício
aspiração	anseio/apetite/pretensão/desejo/disposição
carro	auto/veículo/carro/automóvel/viatura
diminuição	alteração/mudança/variação/modificação
riqueza	possessão/propriedade
quantidade	concepção/idéia/conceito/ideia/grandeza/número/magnitude
esposo	parente
reclamar	solicitar/pedir/requerer/requisitar
fugir	escapulir/escapar/fugir
eliminação	ato/ação/feito/acção
aprofundar	acrescer/acrescentar/crescer/aumentar
desejo	anseio/apetite/pretensão/desejo/anseio/apetite/pretensão/desejo
revogação	julgamento/sentença
artista	intérprete/indivíduo/pessoa/alguém/ser_humano/alma
consequência	fenômeno/fenómeno
imunidade	estado/estado/situação/condição
avenida	caminho/rodovia/via/estrada
romance	relação/relacionamento/relação/relacionamento
quadrilha	organização/sociedade/ordem/união/associação
marido	parente
ofício	ofício/trabalho/serviço/emprego/função/lugar/profissão/ocupação
ofensiva	manobra/operação
merecimento	valor/importância
irmã	membro
menor	indivíduo/pessoa/alguém/ser_humano/alma
imóvel	possessão/propriedade
alimentar	prover/suprir/abastecer/fornecer
designação	obrigação/dever
língua	linguagem/discurso/idioma/língua/órgão_biologico/órgão/comunicação/mensagem/comunicação/mensagem
descoberta	ato/ação/feito/acção
apreender	segurar/agarrar/capturar/pegar
proporção	grandeza/número/magnitude
cálculo	processo/procedimento/juízo/critica/julgamento
humanidade	humano/ser_humano
acertar	tocar/bater/mudar/modificar/alterar
capitalista	indivíduo/pessoa/alguém/ser_humano/alma
secretária	servidor/criado/assistente/ajudante
montante	soma/número/quantidade
dimensão	grandeza/número/magnitude/grandeza/número/magnitude/grandeza/número/magnitude
conservar	manter/guardar/segurar/reter/cozinhar/preparar/preservar/conservar
confiar	passar/entregar/ceder/dar/deixar/permitir/consentir
rejeição	ato/ação/feito/acção
influir	afetar/impactar
coalizão	organização
perseguir	viajar/ir/caminhar/andar
neutralizar	o_fazendeiro_matou_um_porco_para_o_natal./matar
incumbência	obrigação/dever
jardim	campos
comissionar	passar/entregar/ceder/dar
esposa	mulher/esposa/esposo/marido/cônjuge/cónjuge/consorte/parente
cuidar	governar/reger
abordar	discutir
justificativa	consideração/circunstância
contrair	desabar/decrescer/minguar/diminuir
escapar	escapulir/escapar/fugir
cinema	espectáculo/show
assento	assento/cadeira/mobiliário/alfaia/movéis/móvel/mobília
tirar	cerrar/fechar
criador	indivíduo/pessoa/alguém/ser_humano/alma
vizinho	indivíduo/pessoa/alguém/ser_humano/alma
floresta	relevo_(geografia)/chão/terra_firme/terra/relevo/solo/cobertura_vegetal/flora/vegetação/locação/ponto/lugar/localização
burguesia	classe_social/classe/estrato
sufocar	o_fazendeiro_matou_um_porco_para_o_natal./matar
nacionalidade	classe/condição/posição/status/estado/classe/condição/posição/status/estado
mestre	autoridade
secas	estado/estado/situação/condição
associado	igual/pário/par
doméstico	servidor/empregado_doméstico
amado	indivíduo/pessoa/alguém/ser_humano/alma
incumbir	passar/entregar/ceder/dar
adaptar	alterar/variar/mudar/modificar
poeta	escritor/autor
partida	certame/partida/concurso/competição/torneio/jogo/partida/ato/ação/feito/acção
fundir	forjar/formar/modelar/moldar/modelar/formar
correr	manar/fluir/correr/manar/fluir/correr/apressar/correr/passar/atravessar/correr/viajar/ir/caminhar/andar/deslocar/mexer/mover
batizar	denominar/chamar/nomear
par	jogo/grupo
marca	aceno/emblema/símbolos/símbolo/sinal/simbolo/aceno/emblema/símbolos/símbolo/sinal/simbolo
cena	situação/condição
bater	deslocar/mexer/mover/deslocar/mexer/mover/cerrar/fechar/bater/colidir/atingir/tocar/bater/tocar/bater/tocar/bater
remeter	transmitir
jurisdição	distrito/território/domínio/comarca/districto/circunscrição/circunscrição_administrativa
indício	comunicação/mensagem
obedecer	obedecer/confromar-se/adequar-se/ajustar/adaptar-se
governante	indivíduo/pessoa/alguém/ser_humano/alma
separar	expulsar/deslocar/mexer/mover
resto	porção/parte/componente/categoria/objeto/objeto_físico
espalhar	separar/partir/viajar/ir/caminhar/andar
laço	laço
conduta	peculiaridade/feição
empenho	mão-de-obra/trabalho
convicção	crença/opinião/fé/convicção
alcance	grandeza/número/magnitude
arrecadar	cobrar
identidade	personalidade/temperamento/pessoa
descendente	parente
compensar	pagar
totalidade	concepção/idéia/conceito/ideia
psicologia	disciplina_cientifica/ciência
componente	porção/parte/componente/categoria/porção/parte/componente/categoria/concepção/idéia/conceito/ideia
reintegrar	pagar
regiões	locação/ponto/lugar/localização
comunicado	ato/ação/feito/acção
centrar	raciocinar/cogitar/pensar/refletir
baixada	depressão
apressar	viajar/ir/caminhar/andar/viajar/ir/caminhar/andar
marchar	ir/caminhar/andar
mercadoria	mercadoria/artigo/produto
solo	materiais/objeto/objeto_físico/objeto/objeto_físico
trânsito	acúmulo/aglomeração/colecção/coleção/acúmulo/aglomeração/colecção/coleção
símbolo	aceno/emblema/símbolos/símbolo/sinal/simbolo/sinal
oficina	oficina/laboratório/emprego/locais_de_trabalho/trabalho
deficiência	necessidade/carência
magistrado	servidor_público/funcionário/serventuário
explosão	ruído
excedente	porção/parte/componente/categoria
soma	soma/número/quantidade/concepção/idéia/conceito/ideia
surpresa	alteração/mudança/variação/modificação
senhor	homem
ignorar	tratar
fuga	ato/ação/feito/acção
festa	acontecimento/festa/acontecimento/festa/acontecimento/festa
farmácia	boutique/venda/loja
ajudante	trabalhador
suporte	suporte/encosto/apoio/auxílio/socorro/ajuda/assistência
filme	espectáculo/show
contemplar	raciocinar/cogitar/pensar/refletir
biografia	crónica/crônica
indivíduo	causa/causador
religião	estabelecimento/instituição/instituto/crença/opinião/fé/convicção
inteligência	inteligência/inteligência
atrasar	adiar
tráfego	acúmulo/aglomeração/colecção/coleção
cabeça	chefe/líder/compreensão/conhecimento/noção/cognição
asilo	estrutura/tecido/edifício
competição	certame/partida/concurso/competição/torneio/jogo
atenuar	melhorar/aperfeiçoar
finança	industria/comércio/negócio/empresa
coletânea	publicação/edição
cientista	indivíduo/pessoa/alguém/ser_humano/alma
ascender	ascender/subir/viajar/ir/caminhar/andar
telefone	sinal
habitante	indivíduo/pessoa/alguém/ser_humano/alma
chance	oportunidade/chance
anexo	adição/melhoria
sala	quarto/aposento/sala/quarto/aposento/sala
pedagogia	profissão
expandir	explicar
dano	alteração/mudança/variação/modificação
morador	indivíduo/pessoa/alguém/ser_humano/alma
esvaziar	mudar/modificar/alterar
caminhar	ir/caminhar/andar/ir/caminhar/andar/viajar/ir/caminhar/andar/viajar/ir/caminhar/andar
temor	emoção/comoção/abalo/sentimento
seguidor	indivíduo/pessoa/alguém/ser_humano/alma
multidão	montão/multidão/turba/montão/multidão/turba/montão/multidão/turba
doar	pagar
tutela	protecção/proteção
relato	documento/documentação
operador	causa/causador
encarar	virar-se/tornar-se/virar
gesto	mudança
corrigir	mudar/modificar/alterar
subir	ascender/subir/ascender/subir/viajar/ir/caminhar/andar
líquido	líqüido/fluido
loja	shopping/centros_comerciais/shopping_center
linguagem	linguagem/discurso/idioma/língua/comunicação/mensagem/comunicação/mensagem
fé	crença/opinião/fé/convicção/crença/opinião/fé/convicção/crença/opinião/fé/convicção
confirmação	evidência
gente	pessoal/população/povo/gente/pessoal/população/povo/gente/pessoal/população/povo/gente
assentar	colocar/carregar/botar/pôr
pedra	materiais/pedra/rocha/pedra/rocha
evidência	agouro/presságio/indício/indicação/sinal
estádio	estrutura/tecido/edifício
apartamento	alojamento/abrigo/casa/alojamento/abrigo/casa
restaurante	edifício/prédio
expedição	industria/comércio/negócio/empresa/partida
estreitar	mudar/modificar/alterar
preços	valor/importância
circunscrição	regiões/região
cimento	materiais
personagem	adulto/de_maior
livrar	passar/entregar/ceder/dar
liquidar	o_fazendeiro_matou_um_porco_para_o_natal./matar
bombardeio	ataque
ideia	pensamento/idéia/conceito/opinião/pensamento/idéia/conceito/opinião
gastos	despesa/gasto
escassez	deficiência/escassez/carência/falta/ausência/necessidade/carência
dignidade	classe/condição/posição/status/estado
agitar	deslocar/mexer/mover/deslocar/mexer/mover
aperfeiçoar	melhorar/aperfeiçoar/mudar/modificar/alterar
reproduzir	criar/produzir/fazer/construir/criar/produzir/fazer/construir
estacionar	colocar/carregar/botar/pôr
despedida	partida
modalidade	peculiaridade/feição
incapacidade	compreensão/conhecimento/noção/cognição
falha	ato/ação/feito/acção
anseio	anseio/apetite/pretensão/desejo
raça	classe/família/categoria
hotel	hotel/edifício/prédio
reflexão	software_de_demonstração/demo/demonstração
era	idade/tempo/período/escala_de_tempo_geológico/era/época/século/tempo/etapa/período/tempo/etapa/período
confessar	admitir/confessar/reconhecer/admitir/confessar/reconhecer
biblioteca	acúmulo/aglomeração/colecção/coleção/acúmulo/aglomeração/colecção/coleção/quarto/aposento/sala
medicamento	produtos_farmacêuticos/medicamento/remédio/droga_medicinal/medicamento/produtos_farmacêuticos/remédio/droga/entorpecente
inclinar	inclinar/debruçar
suprir	prover/suprir/abastecer/fornecer/prover/suprir/abastecer/fornecer
selecionar	resolver/decidir
destruição	final/conclusão/resultado/fim/chegada
declinar	desabar/decrescer/minguar/diminuir
alguém	causa/causador
perito	especialista
feito	conquista/façanha/realização/feito
amor	emoção/comoção/abalo/sentimento
sólido	matéria/substância
resumir	reduzir/diminuir
penetrar	entrar
lamentar	sentir/experimentar
glória	honra
perguntar	ruminar/ponderar/cogitar/especular/contemplar/refletir
cartão	papel
andar	estrutura/tecido/edifício/viajar/ir/caminhar/andar/viajar/ir/caminhar/andar/viajar/ir/caminhar/andar/viajar/ir/caminhar/andar/viajar/ir/caminhar/andar
rigor	dificuldade
poupar	manter/guardar/segurar/reter
plantio	terras/fazenda
gasolina	combustível/material_com_que_se_aquece/carburante
esconder	disfarçar/mascarar/esconder/encobrir/esconder/encobrir/omitir/tampar/tapar/acobertar/ocultar/esconder/encobrir/omitir/tampar/tapar/acobertar/ocultar
confundir	elicitar/provocar/incitar/estimular/concitar
amparar	prover/suprir/abastecer/fornecer
socorro	auxílio/socorro/ajuda/assistência
remédio	produtos_farmacêuticos/medicamento/remédio/droga_medicinal/medicamento/produtos_farmacêuticos/remédio/droga/entorpecente
juízo	ato/ação/feito/acção
intensidade	grau
gerir	governar/reger
trimestre	tempo/etapa/período
medir	resolver/decidir
instruir	leccionar/instruir/ensinar/lecionar
emprestar	mudar/modificar/alterar
regularizar	arranjar/dispor/resolver/decidir
educador	profissional_liberal/profissional
bebida	porção/comida/alimento/nutriente
relevo	objeto/objeto_físico
pé	suporte/encosto/apoio/suporte/encosto/apoio
horto	campos
costume	hábito/costume
avistar	aperceber/entender/perceber/aperceber-se
adequar	alterar/variar/mudar/modificar
abater	desabar/decrescer/minguar/diminuir
totalizar	soma/número/quantidade
preceder	falar/contar/dizer
mediação	pessoal/estado-maior/equipe_de_funcionários
idoso	adulto/de_maior
guardar	ter/manter/guardar/segurar/reter/sentir/experimentar
reter	negar/ter/manter/guardar/segurar/reter/manter/guardar/segurar/reter
localização	objeto/objeto_físico
cruzar	criar/reproduzir/dobrar
corrida	certame/partida/concurso/competição/torneio/jogo/certame/partida/concurso/competição/torneio/jogo
carência	necessidade/carência/estado/estado/situação/condição
assalariado	trabalhador
areia	solo/terra
universo	acúmulo/aglomeração/colecção/coleção
jogar	jogar/competir/concorrer
cor	materiais/camada/capa
coesão	ligação/conexão
visitante	visita/visitante
significado	pensamento/idéia/conceito/opinião/magnitude/importância
gestor	gerente/administrador
estimativa	juízo/critica/julgamento
cavalo	cavalo/égua
rapidez	ritmo/passo
moradia	alojamento/abrigo/casa/alojamento/abrigo/casa
minimizar	reduzir/diminuir
incompatibilidade	qualidade/característica
domicílio	endereço/alojamento/abrigo/casa
apelido	nome_de_batismo/primeiro_nome/nome_próprio/prenome/nome/antenome
teste	esforço/tentativa
matemática	disciplina_cientifica/ciência
fortuna	fenômeno/fenómeno
supor	antecipar/antecipar/antecipar/resolver/solucionar
medo	consternação/temor/medo/terror/emoção/comoção/abalo/sentimento
insucesso	ato/ação/feito/acção
girar	girar/virar/virar-se/tornar-se/virar/deslocar/mexer/mover
reger	governar/reger
infração	crime/ofensa
cuidado	protecção/proteção
conexão	amizade/conhecido/conhecida/amigo
ajustar	servir/ficar/caber/mudar/modificar/alterar/alterar/variar/mudar/modificar
moça	mulher
intérprete	intérprete
certeza	crença/opinião/fé/convicção
acrescer	acrescer/acrescentar/crescer/aumentar
vegetal	legume/hortaliça/vegetal/verdura/hortifruti/hortifruto
tamanho	grandeza/número/magnitude/grandeza/número/magnitude
escolas	edifício/prédio
culpa	estado/estado/situação/condição
sorte	fenômeno/fenómeno/fenômeno/fenómeno
habilidade	talento/habilidade/meta/técnica/compreensão/conhecimento/noção/cognição
forjar	forjar/formar/modelar/moldar/forjar/formar/modelar/moldar
emendar	melhorar/aperfeiçoar
aparato	equipamento/ferramenta
judeu	indivíduo/pessoa/alguém/ser_humano/alma
dobrar	virar-se/tornar-se/virar/dobrar/dobrar
caça	besta/criatura/ser/bicho/animal
variação	alteração/mudança/variação/modificação
segredo	informação
satisfazer	combinar/corresponder/concordar
motor	maquinaria/máquina
imobiliária	possessão/propriedade
computador	maquinaria/máquina
colapso	enfermidade/doença
ator	intérprete
substância	materiais/porção/parte/componente/categoria/matéria/substância
sintoma	evidência
roque	estrutura/tecido/edifício
parar	cessar/acabar/parar/terminar/desistir/finalizar/deixar/descontinuar
jurisprudência	acúmulo/aglomeração/colecção/coleção
gerenciamento	gestão/administração
finalizar	mudar/modificar/alterar
dados	acúmulo/aglomeração/colecção/coleção
argumentação	ideia
aliviar	ajudar/assistir/auxiliar/socorrer/solidarizar_se/acorrer/melhorar/aperfeiçoar
lixo	materiais
elenco	organização
dona	mulher
combinação	acúmulo/aglomeração/colecção/coleção
coleção	publicação/edição
aventura	projeto/tarefa
reconquistar	receber/obter/comprar/adquirir
erguer	colocar/carregar/botar/pôr
trama	pano/tecido/fazenda/têxteis/tecido_têxtil
sepultar	esconder/encobrir/omitir/tampar/tapar/acobertar/ocultar
restituir	pagar
injúria	ofensa/injúria/desfeita/comportamento/conduta
dispersar	separar/partir
compositor	musico/músico/músico
alugar	receber/obter/comprar/adquirir
alma	causa/causador
tocar	apresentar/fazer/desempenhar/tocar/bater
equiparar	mudar/modificar/alterar
cultivar	lustrar/refinar/polir
consumir	gastar/despender
arrastar	tirar/puxar/arredar
ódio	emoção/comoção/abalo/sentimento
piso	estrutura/tecido/edifício
mentalidade	atitude
atirar	ferir/lesar/machucar/lesionar
plantação	terras/fazenda
ouvinte	oportunidade/chance
músico	intérprete/artista/artista
materiais	informação/substância
enterro	cerimónia/cerimônia/festa
obstrução	estrutura/tecido/edifício
menino	descendente/descendência/filho/criança/menino/filho
felicidade	espírito/estado_emocional/humor
deteriorar	decair/piorar
carregar	transportar/levar/carregar/completar/encher/completar/encher/mudar/modificar/alterar
salvação	recuperação
ponderar	ruminar/ponderar/cogitar/especular/contemplar/refletir/raciocinar/cogitar/pensar/refletir
oscilar	deslocar/mexer/mover
hábito	hábito/costume
despacho	partida
adoecer	decair/piorar
especular	antecipar/raciocinar/cogitar/pensar/refletir
equipar	prover/suprir/abastecer/fornecer
clientela	pessoal/população/povo/gente
capturar	segurar/agarrar/capturar/pegar/jogar
aparelhar	prover/suprir/abastecer/fornecer
alegria	espírito/estado_emocional/humor/alegria/prazer/emoção/comoção/abalo/sentimento
suportar	deixar/permitir/consentir
metro	aparelho/ferramenta/instrumento
manobrar	governar/reger
firmeza	peculiaridade/feição
desativar	mudar/modificar/alterar
demandar	solicitar/pedir/requerer/requisitar
condutor	materiais
virar	virar-se/tornar-se/virar/virar-se/tornar-se/virar/virar-se/tornar-se/virar/deslocar/mexer/mover/deslocar/mexer/mover
torre	estrutura/tecido/edifício
resíduo	materiais/porção/parte/componente/categoria
predominância	bem/recurso/virtude/vantagem/propriedade
parada	região/área/final/conclusão/resultado/fim/chegada/ato/ação/feito/acção
acúmulo	acúmulo/aglomeração/colecção/coleção
supervisor	orientador/supervisor
renome	honra
moralidade	intenção/motivação/motivo/necessidade
minar	explorar
lidar	governar/reger
configuração	plano/esquema/plano/esquema
amenizar	melhorar/aperfeiçoar/desabar/decrescer/minguar/diminuir
alimentos	comida/alimento/nutriente
prover	prover/suprir/abastecer/fornecer
fama	honra
escravidão	hábito/costume
celebração	acontecimento/festa
abrigo	estrutura/tecido/edifício
terror	consternação/temor/medo/terror/emoção/comoção/abalo/sentimento
ribeira	corrente/córrego
perturbar	elicitar/provocar/incitar/estimular/concitar
ofensa	ofensa/injúria/desfeita/comportamento/conduta
navios	embarcações/embarcação/barco/navio/navios
malha	pano/tecido/fazenda/têxteis/tecido_têxtil
exibição	diversão/divertimento/entretenimento/entreterimento
errar	viajar/ir/caminhar/andar
compatibilizar	combinar/corresponder/concordar
coletar	cobrar
apertar	tocar/bater/mudar/modificar/alterar
verão	estação_do_ano/estação/tempo/sazão/período
protelar	adiar
indenizar	pagar
encobrir	esconder/encobrir/omitir/tampar/tapar/acobertar/ocultar/esconder/encobrir/omitir/tampar/tapar/acobertar/ocultar
disfarçar	esconder/encobrir/omitir/tampar/tapar/acobertar/ocultar
decadência	pecado
chocar	bater/colidir/atingir
ambição	anseio/apetite/pretensão/desejo/disposição
acampamento	alojamento/abrigo/casa
explosivo	substância_química/química/substâncias_químicas/substância
enterrar	esconder/encobrir/omitir/tampar/tapar/acobertar/ocultar
confinar	reduzir/diminuir
cineasta	produtor/produtores
queixa	objeção
pressupor	antecipar
giro	rotação
coerência	ligação/conexão
bar	quarto/aposento/sala
tópico	comunicação/mensagem
rainha	hemípteros/inseto/insetos/insecto/insectos
presa	besta/criatura/ser/bicho/animal
monumento	estrutura/tecido/edifício
metais	elemento_químico/elemento_químico/elemento_químico/elemento_químico
matéria-prima	materiais
maquinaria	maquinaria/máquina
indispor	mudar/modificar/alterar
flora	acúmulo/aglomeração/colecção/coleção
descer	viajar/ir/caminhar/andar
comunicador	indivíduo/pessoa/alguém/ser_humano/alma
biologia	acúmulo/aglomeração/colecção/coleção
apostar	jogar
alarmar	avisar/alertar/advertir
índole	peculiaridade/feição
árbitro	indivíduo/pessoa/alguém/ser_humano/alma
vagar	viajar/ir/caminhar/andar/viajar/ir/caminhar/andar/viajar/ir/caminhar/andar
táxi	auto/veículo/carro/automóvel/viatura
sal	composto_químico/substância_química
ritual	hábito/costume
repetição	repetição
pânico	consternação/temor/medo/terror
inclinação	mudança
dor	sintoma
amadurecer	amadurecer
acordar	melhorar/aperfeiçoar
rosto	aspecto/aparência/semblante/aspecto/aparência/semblante/aspecto/aparência/semblante/indivíduo/pessoa/alguém/ser_humano/alma
queimar	tratar
plantar	colocar/carregar/botar/pôr/colocar/carregar/botar/pôr
metal	elemento_químico/elemento_químico
locação	objeto/objeto_físico
lar	domicílio/residência/casa/alojamento/abrigo/casa/locação/ponto/lugar/localização
céu	atmosfera/ar/superfície
velocidade	ritmo/passo
precipitação	fenômeno_meteorológico/tempo/condições_meteorológicas/clima
pista	evidência/instalação/infra-estrutura
partilhar	receber/obter/comprar/adquirir
ofender	provocar/magoar/ofender/elicitar/provocar/incitar/estimular/concitar
irritar	aporrinhar/chatear/importunar/irritar/vexar/incomodar/molestar/perturbar/aborrecer/amolar/agastar
festival	festa/festividade/celebração
erradicar	o_fazendeiro_matou_um_porco_para_o_natal./matar
barco	embarcações/embarcação/barco/navio/navios/embarcações/embarcação/barco/navio/navios/batel/escaler/barco/bote
superioridade	estado/estado/situação/condição
progredir	viajar/ir/caminhar/andar/mudar/modificar/alterar
perfazer	melhorar/aperfeiçoar
motores	maquinaria/máquina
humor	emoção/comoção/abalo/sentimento
fibra	materiais
enaltecer	estimar/avaliar/medir
criado	trabalhador
ascendência	número
adicionar	acrescer/acrescentar/crescer/aumentar/mudar/modificar/alterar
tolerar	deixar/permitir/consentir
superfície	camada/estrato
sobrenome	nome_de_batismo/primeiro_nome/nome_próprio/prenome/nome/antenome
ruína	destruição/desolação/demolição
pegar	segurar/agarrar/capturar/pegar
harmonizar	combinar/corresponder/concordar
granja	oficina/laboratório/emprego/locais_de_trabalho/trabalho
folhas	papel/legume/hortaliça/vegetal/verdura/folha/folha_de_papel/folhas/papel
tumor	tumores
subornar	pagar
sobra	porção/parte/componente/categoria
selo	aceno/emblema/símbolos/símbolo/sinal/simbolo/aceno/emblema/símbolos/símbolo/sinal/simbolo
pano	peça/pedaço/pano/tecido/fazenda/têxteis/tecido_têxtil
olhar	aperceber/entender/perceber/aperceber-se
moinho	maquinário/máquina/maquinaria
leito	depressão
juvenil	indivíduo/pessoa/alguém/ser_humano/alma
flutuação	alteração/mudança/variação/modificação
eros	anseio/apetite/pretensão/desejo
emigração	migração
decênio	tempo/etapa/período
chácara	oficina/laboratório/emprego/locais_de_trabalho/trabalho
assemelhar	parecer/assemelhar-se/assemelhar-se_a/assemelhar/combinar/corresponder/concordar
treinar	leccionar/instruir/ensinar/lecionar/leccionar/instruir/ensinar/lecionar/lustrar/refinar/polir
templo	edifício/prédio/edifício/prédio
significação	magnitude/importância
perna	perna/membro/suporte/encosto/apoio
minérios	materiais
maioridade	número
competidor	indivíduo/pessoa/alguém/ser_humano/alma
cobre	condutor/condutor/metais/metais/metal/metais/metais/metal
canção	composição_musical/composição_musical
alienar	passar/entregar/ceder/dar
vizinhança	distrito/território/domínio/comarca/districto/circunscrição/circunscrição_administrativa
vento	fenômeno_meteorológico/tempo/condições_meteorológicas/clima
sinalizar	colocar/carregar/botar/pôr
selva	relevo_(geografia)/chão/terra_firme/terra/relevo/solo/locação/ponto/lugar/localização
retrucar	falar/contar/dizer
quinta	oficina/laboratório/emprego/locais_de_trabalho/trabalho
parede	estrutura/tecido/edifício
mostra	representante/instância/exemplo
magnitude	grandeza/número/magnitude/grandeza/número/magnitude/grandeza/número/magnitude
exacerbar	mudar/modificar/alterar
doenças	enfermidade/doença
desfilar	ir/caminhar/andar
descrença	dúvida/incerteza
vão	espaço
validar	revalidar/corroborar/provar/confirmar/suportar/sustentar/substanciar
software	código
pintura	camada/capa/ofício/profissão/arte
negligência	engano/falha/equívoco/erro
lua	objeto/objeto_físico
delimitar	conter/limitar/restringir
composto	composto_químico/substância_química
chibata	aparelho/ferramenta/instrumento
cadáver	morto/cadáver/defunto/corpo/restos_mortais
azar	problema/fenômeno/fenómeno
arco	arco/curva/estrutura/tecido/edifício/estrutura/tecido/edifício
raciocínio	ideia
piorar	decair/piorar/decair/piorar/mudar/modificar/alterar
nutrição	comida/alimento/nutriente
mistura	acúmulo/aglomeração/colecção/coleção/substância
lente	órgão_biologico/órgão
intolerância	atitude
fruta	fruto/fruta/hortifruti/hortifruto
frete	mercadoria/artigo/produto
educar	leccionar/instruir/ensinar/lecionar/lustrar/refinar/polir
despachar	transmitir/o_fazendeiro_matou_um_porco_para_o_natal./matar
chumbo	metais/metais/metal
atropelar	ferir/lesar/machucar/lesionar
arriscar	procurar/tentar/procurar/tentar
ângulo	espaço
voar	viajar/ir/caminhar/andar/controlar/operar
temporada	tempo/etapa/período/tempo/etapa/período
talento	compreensão/conhecimento/noção/cognição
subverter	mudar/modificar/alterar
salvamento	recuperação
recompensar	pagar
paternidade	parentesco/relação
idioma	linguagem/discurso/idioma/língua/comunicação/mensagem
fraternidade	classe_social/classe/estrato
cara	indivíduo/pessoa/alguém/ser_humano/alma
aparência	aspecto/aparência/semblante/aspecto/aparência/semblante/aspecto/aparência/semblante
anexar	juntar/unir/ligar/reunir
suposição	suposição/possibilidade/hipótese/teoria/concepção/idéia/conceito/ideia
rodar	girar/virar/viajar/ir/caminhar/andar
revólver	arma/armamento
reinar	governar/reger
rebaixar	provocar/magoar/ofender
justificação	consideração/circunstância
fratura	machucado/traumatismo/dano/mal/lesão
experiente	especialista
endosso	apoio/suporte
emblema	sinal/ornamento
desconsiderar	tratar
cônjuge	parente
coque	combustível/material_com_que_se_aquece/carburante
amostra	representante/instância/exemplo
afronta	ofensa/injúria/desfeita
sonhar	aperceber/entender/perceber/aperceber-se
saudade	anseio/apetite/pretensão/desejo
refúgio	estrutura/tecido/edifício
rapaz	criança/menino/filho
primavera	estação_do_ano/estação/tempo/sazão/período
postergar	adiar
placar	final/conclusão/resultado/fim/chegada
persuadir	persuadir
melhora	estado/estado/situação/condição
meio-dia	hora
manufatura	planta/fábrica/usina/industria/comércio/negócio/empresa
mandamento	ordem/comando
louvar	estimar/avaliar/medir
hall	quarto/aposento/sala/edifício/prédio
gritar	gritar/urrar/berrar
ensejo	fenômeno/fenómeno
encetar	discutir
embalagem	acúmulo/aglomeração/colecção/coleção
camarada	indivíduo/pessoa/alguém/ser_humano/alma
amiga	indivíduo/pessoa/alguém/ser_humano/alma
albergaria	hotel
abatimento	alteração/mudança/variação/modificação
turista	indivíduo/pessoa/alguém/ser_humano/alma
trilha	caminho/curso/evidência
sacada	estrutura/tecido/edifício
refinar	melhorar/aperfeiçoar
possuidor	indivíduo/pessoa/alguém/ser_humano/alma
planície	relevo_(geografia)/chão/terra_firme/terra/relevo/solo
ironizar	tratar
igrejas	estabelecimento/instituição/instituto
florestas	relevo_(geografia)/chão/terra_firme/terra/relevo/solo
endurecer	mudar/modificar/alterar/atuar/comportar-se/agir/parecer
criativo	indivíduo/pessoa/alguém/ser_humano/alma
conforto	estado/estado/situação/condição
confidenciar	passar/entregar/ceder/dar
assaltar	disputar/lutar/brigar
arruinar	malograr/fracassar/falhar/quebrar_a_cara
alojamento	estrutura/tecido/edifício
vinho	bebidas_alcoólicas/álcool/bebida_alcoólica/álcoois/bebida_alcoólica
trancar	prender/fixar
tombar	expirar/morrer/bater_as_botas/falecer/comer_capim_pela_raiz/perecer
rosas	arvoreta/arbusto/moita/mato
pedaço	porção
materializar	acontecer/ocorrer/suceder/passar
insulto	ofensa/injúria/desfeita
guiar	governar/reger/governar/reger
focar	focar/centrar/concentrar/raciocinar/cogitar/pensar/refletir
empurrar	forçar/empurrar
desobrigar	passar/entregar/ceder/dar
demolição	final/conclusão/resultado/fim/chegada
cérebro	inteligência
cozinha	quarto/aposento/sala
colidir	bater/colidir/atingir/tocar/bater
circunscrever	reduzir/diminuir
auferir	receber/obter/comprar/adquirir/receber/obter/comprar/adquirir
assediar	aporrinhar/chatear/importunar/irritar/vexar/incomodar/molestar/perturbar/aborrecer/amolar/agastar
segurar	ter/manter/guardar/segurar/reter/segurar/agarrar/capturar/pegar/segurar/agarrar/capturar/pegar
reparar	melhorar/aperfeiçoar
mentir	desinformar/enganar
julgador	autoridade
jipe	auto/veículo/carro/automóvel/viatura
dizimar	o_fazendeiro_matou_um_porco_para_o_natal./matar
convir	combinar/corresponder/concordar
balizar	raciocinar/cogitar/pensar/refletir
balcão	estrutura/tecido/edifício
viajante	indivíduo/pessoa/alguém/ser_humano/alma
prima	parente
nobreza	classe/condição/posição/status/estado
legar	oferecer/dar_de_presente/dar/regalar/entregar
irmandade	classe_social/classe/estrato
insultar	provocar/magoar/ofender
habituar	mudar/modificar/alterar
golpear	tocar/bater/tocar/bater
galgar	ascender/subir
funeral	cerimónia/cerimônia/festa/cerimónia/cerimônia/festa
fortificar	mudar/modificar/alterar
enxergar	aperceber/entender/perceber/aperceber-se
elucidar	explicar
dissipar	esbanjar/desperdiçar/dilapidar/delapidar
degolar	o_fazendeiro_matou_um_porco_para_o_natal./matar
danificar	mudar/modificar/alterar
atributo	concepção/idéia/conceito/ideia
atar	prender/fixar/prender/fixar
afrouxar	mudar/modificar/alterar
afigurar	conjeturar/pensar/imaginar/conjecturar
acessar	encontrar/reconquistar/recuperar/reganhar/re-adquirir
varrer	deslocar/mexer/mover/deslocar/mexer/mover
terapia	produtos_farmacêuticos/medicamento/remédio/droga_medicinal
simular	reproduzir
sabedoria	peculiaridade/feição
revestir	cobrir/tampar/cobrir/tampar
ração	comida/alimento/nutriente
porção	objeto/objeto_físico
mente	compreensão/conhecimento/noção/cognição
lucrar	receber/obter/comprar/adquirir
ira	cólera/raiva/ira/zanga/emoção/comoção/abalo/sentimento
inverno	estação_do_ano/estação/tempo/sazão/período
incomodar	aporrinhar/chatear/importunar/irritar/vexar/incomodar/molestar/perturbar/aborrecer/amolar/agastar
imitar	parecer/assemelhar-se/assemelhar-se_a/assemelhar/reproduzir
fretar	receber/obter/comprar/adquirir
estrago	alteração/mudança/variação/modificação
estanho	metais/metais/metal
esposar	seleccionar/escolher/selecionar
encher	mudar/modificar/alterar/mudar/modificar/alterar
embalar	cobrir/tampar
dianteira	lado/face
contaminar	mudar/modificar/alterar
balear	o_fazendeiro_matou_um_porco_para_o_natal./matar
asa	órgão_biologico/órgão/adição/melhoria
aposento	alojamento/abrigo/casa
amante	indivíduo/pessoa/alguém/ser_humano/alma
acoplar	juntar/unir/ligar/reunir
aceno	sinal
ácido	composto_químico/substância_química
viciar	mudar/modificar/alterar
vacilar	adiar
túmulo	região/área
testa	traço
sensação	percepção/percepção
seda	pano/tecido/fazenda/têxteis/tecido_têxtil
rolar	deslocar/mexer/mover
retribuir	pagar
pilotar	controlar/operar
modelar	forjar/formar/modelar/moldar/mudar/modificar/alterar
limpar	esfregar/mudar/modificar/alterar/mudar/modificar/alterar/mudar/modificar/alterar
humilhar	provocar/magoar/ofender
furar	causar_dor/doer/traspassar/perfurar/penetrar
fatia	porção
desobstruir	mudar/modificar/alterar
descobrimento	ato/ação/feito/acção
dente	osso
degradar	decair/piorar
deduzir	manter/guardar/segurar/reter
decréscimo	alteração/mudança/variação/modificação
curvar	virar-se/tornar-se/virar/virar-se/tornar-se/virar
contendor	indivíduo/pessoa/alguém/ser_humano/alma
chão	relevo_(geografia)/chão/terra_firme/terra/relevo/solo/objeto/objeto_físico
carregamento	mercadoria/artigo/produto
boneco	brinquedo
arrepender	sentir/experimentar
aquecer	mudar/modificar/alterar/mudar/modificar/alterar
apanhar	jogar
aniquilar	o_fazendeiro_matou_um_porco_para_o_natal./matar
anfitrião	adulto/de_maior
amarrar	prender/fixar
amainar	desabar/decrescer/minguar/diminuir
alongar	estressar/tensionar
abstrato	concepção/idéia/conceito/ideia
toque	ato/ação/feito/acção
tinta	materiais/camada/capa
súdito	indivíduo/pessoa/alguém/ser_humano/alma
sopa	prato
sacudir	deslocar/mexer/mover
proponente	indivíduo/pessoa/alguém/ser_humano/alma
presumir	antecipar
porão	pavimento/piso/andar
poetisa	escritor/autor
pedagogo	profissional_liberal/profissional
igualar	mudar/modificar/alterar
iate	embarcações/embarcação/barco/navio/navios
freguesia	pessoal/população/povo/gente
exposições	acúmulo/aglomeração/colecção/coleção
estremecer	agitar/sacudir/tremer/tremular/tiritar/estremecer/tremer
estigma	aceno/emblema/símbolos/símbolo/sinal/simbolo
emocionar	elicitar/provocar/incitar/estimular/concitar
egoísmo	peculiaridade/feição
drogaria	boutique/venda/loja
desordenar	mudar/modificar/alterar
descendência	parente
decair	decair/piorar
cólera	cólera/raiva/ira/zanga/emoção/comoção/abalo/sentimento
conectar	prender/fixar/raciocinar/cogitar/pensar/refletir
compêndio	publicação/edição
borda	fronteira/limite
asfixiar	o_fazendeiro_matou_um_porco_para_o_natal./matar
antepassado	parente/antecessor/ancestral/antepassado
ansiar	ansiar/desejar/querer
anomalia	indivíduo/pessoa/alguém/ser_humano/alma
albergue	alojamento/abrigo/casa/hotel
afã	anseio/apetite/pretensão/desejo
adição	componente/parte
abreviar	reduzir/diminuir
urgir	aconselhar/sugerir/propor
tocador	intérprete
submergir	cobrir/tampar
solos	objeto/objeto_físico
semear	colocar/carregar/botar/pôr
reputar	achar/pensar
prazer	alegria/prazer
perfurar	entrar/traspassar/perfurar/penetrar
numerário	cobre/dinheiro/moeda/divisa
molhar	mudar/modificar/alterar
leva	montão/multidão/turba
industria	comércio/mercantilismo/comercialismo
fluido	matéria/substância
devastar	o_fazendeiro_matou_um_porco_para_o_natal./matar
desvirtuar	mudar/modificar/alterar
despender	pagar
corromper	pagar/mudar/modificar/alterar
contrapeso	estrutura/tecido/edifício
comité	organização
comida	comida/alimento/nutriente
cognome	nome_de_batismo/primeiro_nome/nome_próprio/prenome/nome/antenome
carbono	elemento_químico/elemento_químico
cabimento	alternativa/opção/escolha/intercorrência/eleição
barca	batel/escaler/barco/bote
balsa	batel/escaler/barco/bote
aversão	emoção/comoção/abalo/sentimento
arranjar	colocar/carregar/botar/pôr
amortecer	mudar/modificar/alterar
aglomerar	acrescer/acrescentar/crescer/aumentar
aeródromo	instalação/infra-estrutura
álcali	composto_químico/substância_química
vegetação	acúmulo/aglomeração/colecção/coleção
séculos	tempo/etapa/período
ruído	ruído/problema
replicar	falar/contar/dizer
recém-nascido	criança/menino/filho
puxar	ferir/lesar/machucar/lesionar
prefaciar	falar/contar/dizer
pontapé	porrada/golpe
pavimento	estrutura/tecido/edifício
ociosidade	ato/ação/feito/acção
nó	laço
morada	alojamento/abrigo/casa
moldar	forjar/formar/modelar/moldar/modelar/formar
mascarar	esconder/encobrir/omitir/tampar/tapar/acobertar/ocultar
manchar	mudar/modificar/alterar
incapacitar	mudar/modificar/alterar
garrafa	vaso/vasilha/vasilhame/vaso/vasilha/vasilhame
fluir	manar/fluir/correr/deslocar/mexer/mover
fibras	materiais
farol	torres/torre/roque
faceta	qualidade/carácter_distintivo/característica
estrato	pessoal/população/povo/gente
escavar	explorar
encurtar	reduzir/diminuir/diminuir/reduzir
dona-de-casa	mulher/esposa
despejar	prover/suprir/abastecer/fornecer
descuido	engano/falha/equívoco/erro
desconsideração	ofensa/injúria/desfeita
degenerar	decair/piorar
deferência	atitude
curva	seção/segmento
copiar	parecer/assemelhar-se/assemelhar-se_a/assemelhar/reproduzir
conglomerar	acrescer/acrescentar/crescer/aumentar
coisas	objeto/objeto_físico
celebridade	honra
capataz	orientador/supervisor
bola	brinquedo
batalhar	disputar/lutar/brigar
avaliador	autoridade
ancestral	parente
afogar	o_fazendeiro_matou_um_porco_para_o_natal./matar/expirar/morrer/bater_as_botas/falecer/comer_capim_pela_raiz/perecer
vulgo	pessoal/população/povo/gente
vaso	tubo/condutas
soterrar	esconder/encobrir/omitir/tampar/tapar/acobertar/ocultar
remo	esporte
prenome	nome_de_batismo/primeiro_nome/nome_próprio/prenome/nome/antenome
preleção	discurso
pisar	viajar/ir/caminhar/andar
picar	causar_dor/doer
paredes	estrutura/tecido/edifício
papai	genitor/mãe/pai/progenitor
mulherio	classe_social/classe/estrato
molestar	aporrinhar/chatear/importunar/irritar/vexar/incomodar/molestar/perturbar/aborrecer/amolar/agastar
instrumentista	intérprete
inferir	resolver/solucionar
impactar	mudar/modificar/alterar
garota	mulher
estrangular	o_fazendeiro_matou_um_porco_para_o_natal./matar
espaçamento	posição/espaçamento
esfriar	mudar/modificar/alterar/atuar/comportar-se/agir/parecer
escutar	obedecer/aperceber/entender/perceber/aperceber-se/aperceber/entender/perceber/aperceber-se
engordar	mudar/modificar/alterar
desembolsar	pagar
denotar	significar
delinquência	estado/estado/situação/condição
deitar	colocar/carregar/botar/pôr
dançar	deslocar/mexer/mover/deslocar/mexer/mover
dama	mulher/mulher
custos	despesa/gasto
criatura	indivíduo/pessoa/alguém/ser_humano/alma
conhecida	indivíduo/pessoa/alguém/ser_humano/alma
condensar	reduzir/diminuir
chutar	golpear/bater
centúria	tempo/etapa/período
cavalheiro	homem
cantiga	composição_musical/composição_musical
bobagem	engano/falha/equívoco/erro
beleza	aspecto/aparência/semblante
aviltar	provocar/magoar/ofender/mudar/modificar/alterar
asseverar	teimar/insistir
ansiedade	emoção/comoção/abalo/sentimento
óxido	composto_químico/substância_química
ânsia	emoção/comoção/abalo/sentimento
átomo	materiais/substância
viveiro	edifício/prédio
verdura	hortifruti/hortifruto
varão	indivíduo/pessoa/alguém/ser_humano/alma
transito	acúmulo/aglomeração/colecção/coleção
torrar	gastar/despender
símbolos	sinal
sutileza	dificuldade
suprimentos	comida/alimento/nutriente
sono	tempo/etapa/período
rochedo	pedra/rocha
querosene	combustível/material_com_que_se_aquece/carburante
propulsão	ato/ação/feito/acção
prole	besta/criatura/ser/bicho/animal
pressuposição	suposição/possibilidade/hipótese/teoria
posar	colocar/carregar/botar/pôr
plutônio	elemento_químico/elemento_químico
pedregulho	pedra/rocha
pedestal	suporte/encosto/apoio
passear	ir/caminhar/andar/ir/caminhar/andar
motocicleta	mota/moto/motocicleta
moto	mota/moto/motocicleta
mecenato	aprovaçã0/aprovação
massacrar	o_fazendeiro_matou_um_porco_para_o_natal./matar/o_fazendeiro_matou_um_porco_para_o_natal./matar
mancha	aceno/emblema/símbolos/símbolo/sinal/simbolo/engano/falha/equívoco/erro
maldade	estado/estado/situação/condição
macular	mudar/modificar/alterar
lâmpada	mobiliário/alfaia/movéis/móvel/mobília
lenha	combustível/material_com_que_se_aquece/carburante
injustiçar	tratar
iniqüidade	estado/estado/situação/condição
horticultura	cultivo/pecuária/agricultura
horda	montão/multidão/turba
gangue	organização/sociedade/ordem/união/associação
fósforo	elemento_químico/elemento_químico
fiasco	engano/falha/equívoco/erro
fermentação	bebidas_alcoólicas/álcool/bebida_alcoólica/álcoois/bebida_alcoólica
estafeta	corrida
esquentar	mudar/modificar/alterar/mudar/modificar/alterar
espirito	crença/opinião/fé/convicção
esconderijo	região/área
enxugar	esfregar/modelar/formar/mudar/modificar/alterar
efeitos	consequência/conseqüência/resultado/fim/efeito/poder/força
ecoar	soltar/emitir
desperdiçar	gastar/despender/esbanjar/desperdiçar/dilapidar/delapidar
desconcertar	elicitar/provocar/incitar/estimular/concitar
derramar	prover/suprir/abastecer/fornecer
degrau	suporte/encosto/apoio/escada/escadaria
decoração	ornato/ornamento/decoração/adorno
cria	besta/criatura/ser/bicho/animal
consertar	emendar/reparar/consertar/melhorar/aperfeiçoar
civilizar	lustrar/refinar/polir
caracter	grafema/letra
bosque	relevo_(geografia)/chão/terra_firme/terra/relevo/solo/cobertura_vegetal/flora/vegetação
arremeter	correr
arrebentar	pular/saltar
arranhar	ferir/lesar/machucar/lesionar
amoldar	forjar/formar/modelar/moldar
altitude	dimensão/extensão/amplidão/magnitude
aguerrir	disputar/lutar/brigar
ângulos	espaço
visualizar	conjeturar/pensar/imaginar/conjecturar
visitação	visita
têmpora	traço
trucidar	o_fazendeiro_matou_um_porco_para_o_natal./matar
tremer	agitar/sacudir/tremer/tremular/tiritar/estremecer/tremer/deslocar/mexer/mover/tirar/puxar/arredar
transmudar	mudar/modificar/alterar/mudar/modificar/alterar
torneio	certame/partida/concurso/competição/torneio/jogo
torcer	modelar/formar
sujar	mudar/modificar/alterar
sugar	beber/tomar
salada	prato
rotação	mudança
remendar	emendar/reparar/consertar
reinvindicar	teimar/insistir
registrador	registro
refrescar	mudar/modificar/alterar
raspar	tocar/bater/ferir/lesar/machucar/lesionar
raiva	cólera/raiva/ira/zanga/emoção/comoção/abalo/sentimento
raciocinar	raciocinar/cogitar/pensar/refletir
plantel	edifício/prédio
perspicácia	crença/opinião/fé/convicção
perambular	viajar/ir/caminhar/andar/viajar/ir/caminhar/andar
película	espectáculo/show
outono	estação_do_ano/estação/tempo/sazão/período
nenê	criança/menino/filho
moinhos	maquinário/máquina/maquinaria
mitologia	acúmulo/aglomeração/colecção/coleção/acúmulo/aglomeração/colecção/coleção
missiva	texto
mercantilismo	transação
mento	traço
mensurar	resolver/decidir
menosprezar	tratar
melodia	texto
maquinário	maquinaria/máquina
machucar	causar_dor/doer
macho	besta/criatura/ser/bicho/animal/indivíduo/pessoa/alguém/ser_humano/alma
linguística	disciplina_cientifica/ciência
irar	elicitar/provocar/incitar/estimular/concitar
infortúnio	problema
inflamação	sintoma
hebraico	indivíduo/pessoa/alguém/ser_humano/alma
hebraica	indivíduo/pessoa/alguém/ser_humano/alma
genitália	órgão_biologico/órgão/órgão_biologico/órgão
fúria	cólera/raiva/ira/zanga
fricção	confronto/recontro/conflito
forca	laço
filhote	besta/criatura/ser/bicho/animal
façanha	conquista/façanha/realização/feito
estufa	edifício/prédio
escape	ato/ação/feito/acção
esbanjar	gastar/despender
enxofre	elemento_químico/elemento_químico
entreter	entreter/divertir/sentir/experimentar
enrijecer	mudar/modificar/alterar
enlatar	preservar/conservar
enforcar	executar
encostar	deslocar/mexer/mover
encolher	diminuir/reduzir/desabar/decrescer/minguar/diminuir
efetuação	ato/ação/feito/acção
doer	aperceber/entender/perceber/aperceber-se
divertir	entreter/divertir
divertimento	diversão/divertimento/entretenimento/entreterimento
ditado	locução/provérbio/ditado/idioma/expressão
director	gerente/administrador
dilapidar	gastar/despender
desfeita	comportamento/conduta
cômoda	mobiliário/alfaia/movéis/móvel/mobília
cristalino	órgão_biologico/órgão
coorte	pessoal/população/povo/gente
consorte	parente
concha	concha/carapaça
chá	bebida
chicote	aparelho/ferramenta/instrumento
causalidade	ato/ação/feito/acção
camuflagem	cobertor/cobertura/capa/envólucro
brinde	aquisição
boda	cerimónia/cerimônia/festa/cerimónia/cerimônia/festa
bebê	criança/menino/filho/projeto/tarefa
autóctone	indivíduo/pessoa/alguém/ser_humano/alma
astúcia	inteligência
amalgamar	mudar/modificar/alterar
aglomeração	acúmulo/aglomeração/colecção/coleção
agarrar	segurar/agarrar/capturar/pegar/segurar/agarrar/capturar/pegar
afeição	emoção/comoção/abalo/sentimento
afagar	tratar/afagar/tocar/bater
índices	registro
zangar	elicitar/provocar/incitar/estimular/concitar
vivenda	aposento/habitação/moradia/residência/casa/lar/morada/domicílio/edifício/prédio
varanda	estrutura/tecido/edifício/estrutura/tecido/edifício
turba	montão/multidão/turba
tumores	tumores/enfermidade/doença
tumba	região/área
tropeçar	ir/caminhar/andar
tremular	agitar/sacudir/tremer
tremor	consternação/temor/medo/terror
topar	receber/obter/comprar/adquirir
taxi	auto/veículo/carro/automóvel/viatura
tacada	esforço/tentativa
sorver	beber/tomar
sepultura	região/área
senhorita	mulher
semblante	aspecto/aparência/semblante
sedativo	produtos_farmacêuticos/medicamento/remédio/droga_medicinal
secar	mudar/modificar/alterar
sagacidade	inteligência/peculiaridade/feição
rotulagem	acontecimento/festa
resvalar	deslizar/passar_gradativamente_a/escorregar
regozijar	sentir/experimentar
registo	registro
refrigerar	mudar/modificar/alterar
pré-história	tempo/etapa/período
provérbio	locução/provérbio/ditado/idioma/expressão
provisões	comida/alimento/nutriente
projecto	pensamento/idéia/conceito/opinião
progenitor	antecessor/ancestral/antepassado
pousada	hotel
poetas	escritor/autor
pilha	acúmulo/aglomeração/colecção/coleção
piazza	praça
perverter	mudar/modificar/alterar
pendurar	prender/fixar/prender/fixar
parelha	jogo/grupo
paragem	região/área
papá	genitor/mãe/pai/progenitor
palpitar	pulsar
palestrar	leccionar/instruir/ensinar/lecionar
ornamento	ornato/ornamento/decoração/adorno/ornato/ornamento/decoração/adorno
ondular	deslocar/mexer/mover
nebulosa	acúmulo/aglomeração/colecção/coleção
nadar	viajar/ir/caminhar/andar/viajar/ir/caminhar/andar
murchar	desabar/decrescer/minguar/diminuir/desabar/decrescer/minguar/diminuir
monumentos	estrutura/tecido/edifício
minerar	explorar
minarete	torres/torre/roque
mendigar	solicitar/pedir/requerer/requisitar
manipulador	causa/causador
maltratar	tratar
magoar	elicitar/provocar/incitar/estimular/concitar
madame	mulher
lingüística	disciplina_cientifica/ciência/disciplina_cientifica/ciência
legume	hortifruti/hortifruto
larva	besta/criatura/ser/bicho/animal
judia	indivíduo/pessoa/alguém/ser_humano/alma
intelecto	indivíduo/pessoa/alguém/ser_humano/alma
hospedaria	hotel
hortaliça	hortifruti/hortifruto
hebreu	indivíduo/pessoa/alguém/ser_humano/alma
guerrear	disputar/lutar/brigar
gradação	posição/hierarquia/classe/posto
genealogia	tribo/familia/clã/família
gemer	chorar/choramingar
gelar	mudar/modificar/alterar
galáxia	acúmulo/aglomeração/colecção/coleção
galho	caule/tronco/caule/tronco
gafe	engano/falha/equívoco/erro
frasco	vaso/vasilha/vasilhame
ferver	reduzir/diminuir
ferrar	malograr/fracassar/falhar/quebrar_a_cara
fado	causa/causador
expatriação	migração
excitar	elicitar/provocar/incitar/estimular/concitar
estirar	ferir/lesar/machucar/lesionar
esticar	estressar/tensionar
esquiar	viajar/ir/caminhar/andar
escorregar	deslizar/passar_gradativamente_a/escorregar/viajar/ir/caminhar/andar/viajar/ir/caminhar/andar
enraivecer	sentir/experimentar/elicitar/provocar/incitar/estimular/concitar
embrulho	acúmulo/aglomeração/colecção/coleção
embrulhar	cobrir/tampar
dádiva	aquisição
divisória	estrutura/tecido/edifício
deslizar	deslizar/passar_gradativamente_a/escorregar/viajar/ir/caminhar/andar/viajar/ir/caminhar/andar
deserdar	privar
desabilitar	mudar/modificar/alterar
depravar	mudar/modificar/alterar
defunto	morto/cadáver/defunto/corpo/restos_mortais
cúmulo	acúmulo/aglomeração/colecção/coleção
critica	ato/ação/feito/acção
consternação	emoção/comoção/abalo/sentimento
comover	elicitar/provocar/incitar/estimular/concitar
chacinar	o_fazendeiro_matou_um_porco_para_o_natal./matar
calmante	produtos_farmacêuticos/medicamento/remédio/droga_medicinal
broto	departamento/divisão
boutique	shopping/centros_comerciais/shopping_center
bote	embarcações/embarcação/barco/navio/navios
bobeira	peculiaridade/feição
banheiro	quarto/aposento/sala/quarto/aposento/sala
balada	acontecimento/festa
avaria	alteração/mudança/variação/modificação
arrumar	arranjar/dispor
armário	mobiliário/alfaia/movéis/móvel/mobília
arder	sentir/experimentar
arcano	informação
aplainar	modelar/formar
amplidão	grandeza/número/magnitude
amo	indivíduo/pessoa/alguém/ser_humano/alma
alegrar	sentir/experimentar
aguentar	deixar/permitir/consentir
agudeza	inteligência
aerotransportar	transportar/levar/carregar
adro	praça
aculturar	lustrar/refinar/polir
aba	fronteira/limite