federal	governo/governação/administração
segundo	música
antigo	lingüística/lingüística/linguística
cristão	crença_religiosa/fé/religião
médio	lingüística/lingüística/linguística
futuro	gramática
aéreo	botânica/botanica/botânica
jovem	ser/organismo/ser_vivo
crítico	ciências_físicas/fisica/física/física/quimica/química
cambial	botânica/botanica/botânica
nuclear	ciências_físicas/fisica/física/física/biologia/ciências_da_vida
específico	patologia
natural	música
primo	ciência_exacta/matematica/matemática/ciências_exactas
regular	forças_armadas/exército/máquina_de_guerra
normal	psicologia/psicólogos_por_nacionalidade
físico	industria/comércio/negócio/empresa
anual	botânica/botanica/botânica
alternativa	electricidade/eletricidade
inflacionário	economia
dominante	genética/genetica/genética
territorial	biologia/ciências_da_vida
rápido	música
essencial	lei/jurisprudência/ciências_jurídicas
voluntário	fisiologia/fisiologia
progressivo	taxação/colectas/tributo/taxa/impostos/imposto
facultativo	biologia/ciências_da_vida
sistemático	biologia/ciências_da_vida
federativo	governo/governação/administração
estrutural	geologia
passivo	gramática
rico	metalurgia/metalurgia/indústria_de_metais_ferrosos/quimica/química
processual	lei/jurisprudência/ciências_jurídicas
contínuo	ciência_exacta/matematica/matemática/ciências_exactas
clássico	belas_artes
substancial	lei/jurisprudência/ciências_jurídicas
nominal	gramática/economia
lento	música
incompatível	calculadora/computador
indevido	lei/jurisprudência/ciências_jurídicas
celular	ser/organismo
filial	genética/genetica/genética
funcional	patologia
maior	lei/jurisprudência/ciências_jurídicas/música
racional	ciência_exacta/matematica/matemática/ciências_exactas
orgânico	quimica/química/patologia
ortodoxo	crença_religiosa/fé/religião
noturno	biologia/ciências_da_vida
ecológico	biologia/ciências_da_vida
nítido	meteorologia/meteorologia
normativo	gramática
compatível	calculadora/computador
artificial	lógica
romano	antiguidade
dramático	música
digital	eletronica/eletrônica/eletrónica/eletrônica/electrónica
imperativo	gramática
dinâmico	ciências_físicas/fisica/física/física
duradouro	biologia/ciências_da_vida
unitário	governo/governação/administração
online	informática/ciência_da_computação/expedição/transporte/transportação
trágico	drama
bienal	botânica/botanica/botânica
indicativo	gramática
análogo	biologia/ciências_da_vida
anal	psicanálise
sintético	lingüística/lingüística/linguística/lógica
composto	botânica/botanica/botânica
metodista	crença_religiosa/fé/religião
inverso	ciência_exacta/matematica/matemática/ciências_exactas
diferencial	ciência_exacta/matematica/matemática/ciências_exactas
reage	ciências_físicas/fisica/física/física/quimica/química
analítico	lingüística/lingüística/linguística/lógica/ciência_exacta/matematica/matemática/ciências_exactas
blindado	forças_armadas/exército/máquina_de_guerra
substantivo	lei/jurisprudência/ciências_jurídicas
desligado	informática/ciência_da_computação
atrativo	ciências_físicas/fisica/física/física
alterno	electricidade/eletricidade
dorsal	biologia/ciências_da_vida
subjetivo	filosofia
oral	anatomia
lírico	poema/verso/poesia/música/música
descritivo	gramática
anidro	quimica/química
ácido	quimica/química
magnético	ciências_físicas/fisica/física/física
infinito	gramática
probatório	lei/jurisprudência/ciências_jurídicas
cíclico	termodinâmica/termodinâmica/quimica/química/botânica/botanica/botânica
tardio	lingüística/lingüística/linguística
on-line	informática/ciência_da_computação
residual	lei/jurisprudência/ciências_jurídicas
perene	botânica/botanica/botânica
maligno	patologia
equipado	mobiliário/alfaia/movéis/móvel/mobília
caduco	biologia/ciências_da_vida
benigno	patologia
cosmopolita	ciências_do_ambiente/ecologia/ecologia
anormal	psicologia/psicólogos_por_nacionalidade
varão	biologia/ciências_da_vida
saturação	quimica/química
retrógrado	astronomia/astronomia
optativo	gramática
meticuloso	microbiologia/microbiologia
medido	música
luterano	crença_religiosa/fé/religião
irracional	ciência_exacta/matematica/matemática/ciências_exactas
inerme	forças_armadas/exército/máquina_de_guerra
endêmico	ciências_do_ambiente/ecologia/ecologia
desarmado	forças_armadas/exército/máquina_de_guerra
analógico	eletronica/eletrônica/eletrónica/eletrônica/electrónica
volátil	quimica/química
nominativo	gramática
macho	biologia/ciências_da_vida
involuntário	fisiologia/fisiologia
guardado	contrato/acordo
finito	gramática
colorido	fotografia
canino	zoologia/zoologia
basal	botânica/botanica/botânica
ajustado	psicologia/psicólogos_por_nacionalidade
talhado	literatura
proporcionado	geometria
polivalente	imunologia/imunologia
molecular	psicologia/psicólogos_por_nacionalidade
mensurável	música
inanimado	lingüística/lingüística/linguística
gregário	vegetal/planta/flora/besta/criatura/ser/bicho/animal
geomorfológico	geologia
fornecido	mobiliário/alfaia/movéis/móvel/mobília
desvinculado	arquitectura/arquitetura
cômico	drama
consubstancial	teologia_cristã
congruente	geometria
conectado	expedição/transporte/transportação
canceroso	patologia
bivalente	genética/genetica/genética
aromático	quimica/química
animado	lingüística/lingüística/linguística
anglicano	crença_religiosa/fé/religião
alternado	electricidade/eletricidade