partido	imcompleto/com_imperfeições/imperfeito/ferido/danificado/avariado
mesmo	igual/idêntico/análogo/parelho
novo	moderno/contemporâneo/recente/fresco/atual/actual/corrente
primeiro	primário/original/precoce/temporão/cedo/dianteiro
outro	separado
social	social/sociável/gregário/amistoso/amigo/amigável
público	explícito/aberto
democrático	eleito
liberal	esquerdista/liberal
próprio	certo/correto/justo/apropriado
plano	imutável/liso/macio
santa	sagrado/dedicado
geral	impreciso/detalhado/exaustivo/extenso/abrangente/amplo/comum
industrial	progressivo
bem	saudável/salubre/são/saudável/em_forma
favorável	bom/gratís/afirmativo
importante	significativo/importante
branco	claro
alto	ruidoso/barulhento/grande/alto/audível
internacional	alienígena/estrangeiro/extrangeiro
superior	melhor
responsável	prudente/sensato/judicioso
grosso	amplo/largo/forte/gordo/vivido/experimentado/experiente
alegre	contente/animado/animador
santo	sagrado/dedicado
belo	aprazível/gracioso/atraente
prestes	preparado
interno	central
pessoal	privado
bom	saudável/salubre/são/saudável/em_forma
necessário	indispensável/que_não_pode_ser_dispensado/essencial/imprescindível/essencial/imprescindível/obrigatório/essencial
amplo	amplo/largo/geral/totalizado/completo/integral
permanente	estável/inalterável/imutável
júnior	subalterno/nao-maduro/jovem
ordinário	genérico/habitual/geral/ordinário/costumeiro/usual/comum/comum/comum
efetivo	útil/poderoso/potente/eficiente/eficiente/eficaz
atual	novo/moderno/contemporâneo
socialista	esquerdista
corrente	novo/moderno/contemporâneo
primário	original/primeiro/essencial
conjunto	unido/partilhado/integrado/comum/colectivo/coletivo
legal	legítimo/lícito
conservador	ortodoxo
livre	independente
existente	realístico/genuíno/legítimo/autêntico/concreto
intenso	profundo/entranhado
amigo	cálido/social/sociável/social/amigável/útil/congenial
intelectual	erudito/mental
ativo	enérgico/energético/vívido
crítico	sarcástico/desfavorável/crítico/crucial/importante
válido	razoável/legítimo
comum	conjunto/solidário/normal/costumeiro/comum/rotineiro/ordinário/genérico/habitual/geral/ordinário/costumeiro/usual/comum/genérico/habitual/geral/ordinário/costumeiro/usual/comum/comum/comum
extraordinário	superior/impressionante/incomparável/insólito/inusual/incomun/extraordinário
capaz	satisfatório/competente/habilitado
certo	verdadeiro/conveniente/adequado/próprio/precisa/preciso/bem_acabado/perfeito/aprimorado/literal/textual/preciso/exacto/justo/exato/acurado/preciso/exacto/justo/exato/acurado
independente	separado/livre
bastante	rica/rico
definitivo	explícito/inconfundível
religioso	piedoso/religioso
velho	sênior/maturo/maduro/vivido/experimentado/experiente
preto	escuro
claro	cândido/alvo/branco
violento	malvado
significativo	significativo/importante/significante/significativo/importante
alvo	claro
leal	leal/patriótico
regular	sistemático/sistémico/simétrico/ritmado/rítmico
normal	padrão/mentalmente_sadio/mentalmente_são/são/sadio/sã/genérico/habitual/geral/ordinário/costumeiro/usual/comum/comum
negro	escuro
verdadeiro	honesto/sincero/honesta/sincera/genuíno/legítimo/autêntico/certo/correto/justo
familiar	sabido
decisivo	crítico/crucial/importante/conclusivo
constante	invariável/estável/inalterável/imutável
seguro	invulnerável/indemne/indene/inofensivo/que_não_causa_danos/inócuo
ilegal	ilegítimo/fora_da_lei/ilegal
fiel	leal/patriótico
doce	saboroso/doce/açucarado
moderno	novo/tardio/atual/actual/corrente
profundo	erudito/intenso/intensivo
integral	detalhado/exaustivo/extenso/abrangente/amplo/totalizado/completo/integral/integral/inteiro
difícil	duro
justo	verdadeiro/conveniente/adequado/próprio/precisa/preciso/bem_acabado/imparcial/lícito/honesto/sincero/honesta/sincera/preciso/certo/exato/correcto/certo/correto/justo/preciso/exacto/justo/exato/acurado
disposto	preparado
moral	digno/nobre/virtuoso/eqüitativo/recto/reto/justo/honroso/honrado/bom/boa/casto/casta
duro	forte/vivido/experimentado/experiente
cândido	claro
completo	detalhado/exaustivo/extenso/abrangente/amplo/integral/inteiro
original	primário/primeiro/criativo/criador/original/não_usual
simples	singelo/simples/despretensioso
complexo	composto/árduo/intrincado/difícil
essencial	primário/necessário/essencial/intrínseca/intrínseco/importante/indispensável/que_não_pode_ser_dispensado/essencial/imprescindível/indispensável/que_não_pode_ser_dispensado/essencial/imprescindível/essencial/imprescindível/obrigatório/essencial/crítico/crucial/importante
formal	retórico/ceremonioso/formal
voluntário	consciente
concreto	tangível/físico/existente/prático
progressivo	industrial/de_frente/na_frente/fronteiro/dianteiro
passado	dinheiro_tradicional/antigo/velho/extrovertido
alta	ruidoso/barulhento/audível
padrão	normal
preciso	precisa/preciso/bem_acabado/precisa/preciso/bem_acabado/perfeito/aprimorado/literal/textual/específico/preciso/certo/exato/correcto/preciso/certo/exato/correcto/inconfundível/certo/correto/justo/preciso/exacto/justo/exato/acurado/preciso/exacto/justo/exato/acurado
poderoso	forte/potente/eficiente/eficaz/efetivo
falso	desonroso/errado/incorreto
autêntico	verdadeiro/existente/honesto/sincero/honesta/sincera
adequado	satisfatório/certo/correto/justo/apropriado
paralelo	simétrico/comparável
prudente	prudente/sensato/judicioso/diligente/cauto/cauteloso/prudente/atento/cautelosa/cuidadosa/prudente/atento
doente	adoentado/doente/doentio/insalubre/inapropriado
sistemático	regular/organizado
temporário	precário/instável
parcial	injusto
pacífico	quieto/calmo/amigável
considerável	grande
evidente	explícito/aberto
estreito	estreita/estreito/fino/limitado/estreito
recente	novo
insuficiente	escasso
bem-sucedido	produtivo/produtor/afortunado
impossível	inexorável/insuperável/inviável/impraticável/falta_de_esperança/desesperado
gradual	lento/devagar
rico	privilegiado/abastado/copioso/abundante/basto/farto/bastante/lauto
solidário	unido/partilhado/integrado/comum/colectivo/coletivo
pronto	preparado
contemporâneo	novo/tardio/atual/actual/corrente
esquerdista	liberal/socialista
agressivo	de_ataque/ofensivo/malvado/peremptório/assertivo/agressivo/agressivo
prático	prestativo/realístico/possível/concreto
legítimo	verdadeiro/existente/honesto/sincero/honesta/sincera
ofensivo	arisco/desagradável/abominável/malvado/mau/maléfico/malvado/ruim/agressivo
eficiente	útil/poderoso/potente/eficiente/eficiente/eficaz/eficiente/eficaz/efetivo/competente/habilitado
simpático	aprazível/boa!/lhano/gentil/afável/amável
organizado	exigente/detalhista/limpo
inteiro	totalizado/completo/integral
estável	imutável/permanente/duradouro/constante
extenso	amplo/largo/geral/totalizado/completo/integral
fácil	singelo/simples/brando
informal	informal
lento	gradual
eficaz	útil/poderoso/potente/eficiente/eficiente/eficaz
sensível	responsivo
convencional	ceremonioso/formal
enfermo	adoentado/doente/doentio/insalubre/inapropriado
valente	arrojado/audacioso/destemido/bravo/corajoso/audaz/destemido/sem_medo/aventureiro
nobre	honroso/honrado
funcional	prestativo
automático	mecânico
competente	habilidoso/talentoso/qualificado/eficiente/capaz
silvestre	intratável/desobediente/não_governável
racional	mentalmente_sadio/mentalmente_são/são/sadio/sã/razoável/lógico
perigoso	vulnerável/inseguro
explícito	público/explícito/aberto/explícito/inequívoco/unívoco/denotativo/definitivo
útil	prestativo/proveitoso/rendoso/lucrativo/prestativo/serviçal/prestável/eficiente/eficaz/efetivo
sólido	duro/dura
ortodoxo	conservador
cedo	primeiro
móvel	movente
tenso	apertado/desassossegado/inquieto
distante	longe/longínquo/distante
típico	caraterístico/característico
escrito	roteirizado/escrito
deficiente	escasso
rica	privilegiado/abastado/copioso/abundante/basto/farto/bastante/lauto
conveniente	certo/correto/justo/apropriado/acessível
compatível	harmonioso/útil/congenial
intensivo	profundo/entranhado
aberto	público/aberto/explícito
consciente	voluntário/sensível/ciente/informado/acordado/desperto
frio	frio/frígido/frio/fresco/frio/frio/congelado/gelado
estranho	feia/feio/desajeitado
puro	casto/casta
integrado	unido/conjunto/solidário
visível	perceptível
flexível	elástico
bonito	aprazível/gracioso/atraente
artificial	irreal/não_material
abrangente	amplo/largo/geral/totalizado/completo/integral
caro	precioso/valioso
inútil	não_lucrativo/não_rentável/inútil/vão
satisfatório	capaz/adequado/aceitável
sagrado	sagrado/piedoso/religioso/celeste/dedicado/dedicado
razoável	válido/racional/lógico
dinâmico	enérgico/energético
separado	dividido/outro/segregado/independente/individual
ambíguo	vago/impreciso/ambíguo/dúbio/indefinido
surpreendente	inesperado/imprevisto
exato	precisa/preciso/bem_acabado/precisa/preciso/bem_acabado/perfeito/aprimorado/literal/textual/preciso/certo/exato/correcto/certo/correto/justo/preciso/exacto/justo/exato/acurado
duradouro	estável/inalterável/imutável
cauteloso	cautelosa/cuidadosa/prudente/atento
imparcial	imparcial
feliz	ditoso/feliz/grato/contente/alegre/eufórico/contente/contente/animado/animador/contente/animado/animador
inesperado	surpreendente
fino	liso/macio
atento	prudente/sensato/judicioso/diligente/cauto/cauteloso/prudente/atento/cautelosa/cuidadosa/prudente/atento
lógico	razoável/racional/consistente/coerente/lógico/artificial/sintético/analítico
implícito	conotativo/conotativa
genérico	comum
nocivo	tóxico/prejudicial/danoso/daninho/nocivo
animador	feliz/grato/contente/alegre/feliz/contente
solto	lasso
súbito	rápido/veloz/rápida
sagrada	sagrado/dedicado
ambicioso	empreendedor
inocente	eqüitativo/recto/reto/justo
honesto	verdadeiro/justo/correto/honroso/honrado/genuíno/legítimo/autêntico/direto
desempregado	desempregado
paciente	tolerante/resignado
otimista	positivo/vantajoso
delicado	débil/frágil/quebrável
estreita	fino/limitado/estreito
correto	verdadeiro/conveniente/adequado/próprio/lícito/honesto/sincero/honesta/sincera/preciso/exacto/justo/exato/acurado
alerta	vívido/acordado/desperto/cauteloso/cuidadoso
acessível	conveniente
vário	diferente/heterogênea/heterogêneo
vulnerável	suscetível/susceptível/inseguro/inseguro/perigoso
perfeito	utópico/preciso/certo/exato/correcto
consistente	invariável
cooperativo	prestativo/serviçal/prestável
aceitável	satisfatório
usual	comum
óbvio	explícito/aberto
próspero	produtivo/produtor/afortunado
preparado	preparado
limpo	organizado/limpo/exigente/detalhista/limpo
interessante	excitante/emocionante
desejável	adorável/amável/amorável
sincero	verdadeiro/justo/correto/honroso/honrado/genuíno/legítimo/autêntico/direto
privilegiado	rica/rico/afortunado
formoso	aprazível/gracioso/atraente
construtivo	positivo/vantajoso
vão	não_lucrativo/não_rentável/inútil/vão
selvagem	intratável/desobediente/não_governável
precioso	digno/decoroso/importante/caro
amistoso	cálido/social/sociável/social/amigável/útil/congenial
abundante	rica/rico
saudável	bom/bem/digno_de_confiança/saudável/salubre/são
sangrento	imisericordioso/impiedoso
gordo	espesso/grosso
vertical	reto/íngrime/íngreme
valioso	digno/decoroso/importante/caro
tóxico	tóxico/nocivo/tóxico/prejudicial/danoso/daninho/nocivo/prejudicial/danoso/daninho/nocivo
repentino	rápido/veloz/rápida
experiente	duro/resistente/grosso/habilidoso/talentoso
dúbio	vago/impreciso/ambíguo/dúbio/indefinido
característico	típico
rotineiro	genérico/habitual/geral/ordinário/costumeiro/usual/comum/comum
farto	rica/rico
áspero	rugoso/desuniforme/desnivelado/despadronizado
árduo	desumano/inumano/prejudicial/danoso/daninho/nocivo/duro
feio	desajeitado/esquisito/estranho
exaustivo	amplo/largo/geral/totalizado/completo/integral
caloroso	forgoso/quente
azedo	saboroso
receoso	cobarde/covardemente/covarde/timorato
impróprio	não_lucrativo/não_rentável/inútil/vão
impressionante	emocionante/comovente
honroso	digno/decoroso/respeitável/nobre/moral/honesto/sincero/honesta/sincera
entusiástico	apaixonado/passional
elegível	qualificado
audacioso	valente/bravo/afoito/corajoso/arrojado/brava/valoroso/destemido/sem_medo/aventureiro
sofisticado	secular/leigo/letrado/alfabetizado/cosmopolita/elegante/esbelto/garboso/airoso/gracioso
ruidoso	estrepitante/berrante/alto/alta/cacofônico
quadrado	angulado/angular
miserável	mal_sucedido/sem_sucesso
limitado	estreita/estreito
corajoso	valente/bravo/afoito/corajoso/arrojado/brava/valoroso/arrojado/audacioso/destemido/bravo/corajoso/audaz/destemido/sem_medo/destemido/sem_medo/aventureiro/aventureiro
comparável	paralelo/paralela/igual/idêntico/análogo/parelho
passional	amoroso/afectuoso/carinhoso/queama/quente/esquentado/entusiástico/entusiasta/emocional
habitual	comum
grato	contente/animado/animador
glorioso	sabido
entusiasta	apaixonado/passional
atraente	aprazível/belo/lindo/bonito/formoso
tolerante	paciente/caridoso
sênior	velho
suave	moderado/silencioso/quieto/moderado
silencioso	suave/inaudível
detalhado	amplo/largo/geral/totalizado/completo/integral
resistente	forte/vivido/experimentado/experiente
quente	caloroso/apaixonado/passional
protegido	invulnerável
ocupado	diligente
infinito	imortal
fechado	fechado
elegante	sofisticado/mimoso/grácil/gracioso/condigno/digno
amigável	cálido/social/sociável/social/amigável/útil/congenial
precoce	primeiro
maduro	velho
inseguro	vulnerável/inseguro
imprevisto	surpreendente
doloroso	desumano/inumano/prejudicial/danoso/daninho/nocivo
calmo	pacífico
bravo	valente/bravo/afoito/corajoso/arrojado/brava/valoroso/arrojado/audacioso/destemido/bravo/corajoso/audaz/destemido/sem_medo/destemido/sem_medo/aventureiro/aventureiro
temporão	primeiro
sábio	prudente/sensato/judicioso/aconselhável
sujo	eriçado/hirto/indecente
previsível	inevitável/seguro/certo
incrível	inverossímil
equitativo	imparcial
basto	rica/rico
talentoso	vivido/experimentado/experiente/competente/habilitado
precisa	específico/preciso/certo/exato/correcto/inconfundível/preciso/exacto/justo/exato/acurado
perdido	perdido/perdido/amaldiçoado/maldita/maldito
infeliz	mal_sucedido/sem_sucesso
imutável	estável/no_mesmo_nível/plano
errado	iniquo/malvada/imoral/injusto/desonroso/mau/maléfico/malvado/ruim/não_ético/errado/incorreto
doméstica	nacional
detalhista	organizado/limpo/mimoso/grácil
arrojado	valente/bravo/afoito/corajoso/arrojado/brava/valoroso/arrojado/audacioso/destemido/bravo/corajoso/audaz/destemido/sem_medo/destemido/sem_medo/aventureiro/aventureiro
qualificado	elegível/competente/habilitado
obstinado	intratável/desobediente/não_governável/desobediente/inflexível
horrível	arisco/desagradável
habilitado	habilidoso/talentoso/qualificado/eficiente/capaz
genuíno	verdadeiro/existente/honesto/sincero/honesta/sincera
entusiasmado	inquieto
débil	delicado/impotente/delicado
desagradável	ofensivo/antipático/horrível
corriqueiro	ceremonioso/formal
audaz	valente/bravo/afoito/corajoso/arrojado/brava/valoroso/destemido/sem_medo/aventureiro
anormal	insano
ávido	entusiástico/entusiasta
sincera	verdadeiro/justo/correto/honroso/honrado/genuíno/legítimo/autêntico/direto
respeitável	digno/decoroso/respeitável/bom
potente	poderoso/fecundo/fértil/eficiente/eficaz/efetivo
paralela	simétrico/comparável
inapto	não_lucrativo/não_rentável/inútil/vão
fronteiro	progressivo
exigente	organizado/limpo/mimoso/grácil
devoto	piedoso/religioso
costumeiro	genérico/habitual/geral/ordinário/costumeiro/usual/comum/comum/comum
copioso	rica/rico
contente	contente/satisfeito/ditoso/feliz/grato/contente/alegre/feliz/grato/contente/alegre/feliz/contente/feliz/contente/eufórico/contente/contente/animado/animador/contente/animado/animador
apropriado	conveniente/adequado/próprio
abrupto	rápido/veloz/rápida
valoroso	arrojado/audacioso/destemido/bravo/corajoso/audaz/destemido/sem_medo/aventureiro
tenro	brando/comestível
suja	eriçado/hirto/indecente
sangüíneo	imisericordioso/impiedoso
perpendicular	reto/íngrime/íngreme
magro	fino
habilidoso	vivido/experimentado/experiente/competente/habilitado
frouxo	lasso
extenuante	desumano/inumano/prejudicial/danoso/daninho/nocivo
estúpido	lerdo/estúpido
desperto	consciente/ciente/informado/alerta
desconfortável	desassossegado
deprimido	abaixo/baixo/inferior
comovente	impressionante/emocional
colorido	cromático
chato	incolor/sem_cor
brava	arrojado/audacioso/destemido/bravo/corajoso/audaz/destemido/sem_medo/aventureiro
apertado	tenso
apaixonado	amoroso/afectuoso/carinhoso/queama/quente/esquentado/entusiástico/entusiasta/emocional
agradável	aprazível/boa!/lhano/gentil/afável/amável
acurado	precisa/preciso/bem_acabado/preciso/certo/exato/correcto/certo/correto/justo
abastado	rica/rico
íngreme	vertical/fio_de_prumo/perpendicular
teimoso	intratável/desobediente/não_governável/desobediente/inflexível
significante	significativo/importante
serviçal	útil/encorajador/cooperativo/prestável
quebrado	imcompleto/com_imperfeições/imperfeito/ferido/danificado/avariado
monótono	incolor/sem_cor
liso	escorregadio/fino/no_mesmo_nível/plano
lauto	rica/rico
intrincado	composto/duro/árduo/intrincado/difícil
inconfundível	precisa/preciso/bem_acabado/definitivo
imbecil	lerdo/estúpido
idiota	lerdo/estúpido
honrado	digno/decoroso/respeitável/nobre/moral/honesto/sincero/honesta/sincera
gregário	social
gracioso	sofisticado/mimoso/grácil/gracioso/condigno/digno
fresco	novo/frio
experimentado	duro/resistente/grosso/habilidoso/talentoso
excitante	sensual/sexy/interessante
esquisito	feia/feio/desajeitado
esperto	inteligente
emocionante	sensual/sexy/interessante/impressionante/emocional
domesticado	nacional
desinteressante	incolor/sem_cor
barulhento	estrepitante/berrante/alto/alta/cacofônico
arisco	ofensivo/antipático/horrível
animado	feliz/grato/contente/alegre/feliz/contente
afortunado	afortunado
adormecido	desfalecido/inconsciente/desmaiado/desacordado/incônscio/esmaecido