comissão	comissário
país	província/estado/departamento
público	auditor/ouvinte/aluno
empresa	departamento/divisão
grupo	livro
escola	professor_de_escola/mestre/professor/corpo_docente
criação	galáxia/nebulosa/via_láctea
lei	oficial_de_polícia/agente/polícia/guarda/policial
administração	comite_planejador
tribunal	júri/júri
aliança	aliado
organização	associado/associação/comite_planejador/quorum/quórum
união	associado
exército	militar/caixilho/corpo/corpo/corpo/corpo
colégio	professor_de_escola/mestre/professor/corpo_docente
associação	associado
coligação	aliado
companhia	elenco/pelotão
ordem	sócio_de_clube/frade/irmão/associado
família	irmão/irmã/genitor/mãe/pai/progenitor/parente/criança/menino/filho/gênero/género/gênero/tribo/rhabdovírus/rhabdovirus/arenavirus/arenavírus/flavivírus/flaviviridae/bunyaviridae
classe	gênero/género/gênero/tribo/rhabdovírus/rhabdovirus/arenavirus/arenavírus/flavivírus/flaviviridae/bunyaviridae
sociedade	sócio_de_clube/associado/estrutura_social/sistema_social/sistemas_sociais
pessoal	plebeu/elenco/indivíduo/pessoa/alguém/ser_humano/alma
povo	plebeu/cidadão/cidadã/súdito/cidadão/espectador/audiência/pessoal/população/povo/gente/indivíduo/pessoa/alguém/ser_humano/alma
terra	província/estado/departamento
polícia	oficial_de_polícia/agente/polícia/guarda/policial
clube	sócio_de_clube
homem	pessoal/população/povo/gente
comitê	comissário
população	cidadão/cidadã/indivíduo/pessoa/alguém/ser_humano/alma
nação	plebeu/súdito/cidadão/província/estado/departamento
corpo	milícia/tropas/exército/forças_armadas
junta	comissário
mundo	galáxia/nebulosa/via_láctea/espectador/audiência/pessoal/população/povo/gente
jogo	livro
corte	júri/júri
frota	navio_de_guerra/navios_de_guerra/navio_de_guerra
casamento	esposa/esposo/marido/cônjuge/cónjuge/consorte
mata	árvore
espécie	estirpe/cepa/variante/estirpe/cepa/variante/raça/estirpe/raça/estirpe
casal	esposa/esposo/marido/cônjuge/cónjuge/consorte
quadrilha	marginal/gangster/gângster/bandido
humanidade	pessoal/população/povo/gente
coalizão	aliado
mão-de-obra	time/equipe/partida
floresta	árvore
burguesia	burguesa/burguês
clero	sacerdote/pastor/pároco/clérigo
júri	jurado/júri/juror/jurado/júri/juror
gente	plebeu/cidadão/cidadã/súdito/cidadão/espectador/audiência/indivíduo/pessoa/alguém/ser_humano/alma
tabela	bicha/coluna/linha
universo	galáxia/nebulosa/via_láctea
cavalo	potro
elenco	elenco
biologia	cobertura_vegetal/flora/vegetação/zoologia/fauna
tripulação	equipe/tripulação/equipagem
tribo	parente
fraternidade	frade/irmão
juizado	júri/júri
irmandade	frade/irmão
homens	time/equipe/partida
clã	parente
comité	comissário
vulgo	plebeu
gangue	marginal/gangster/gângster/bandido
cosmo	galáxia/nebulosa/via_láctea
bosque	árvore
mitologia	mito/lenda/mito/lenda
familia	parente
nebulosa	estrela
galáxia	estrela