ter	incluir/abarcar/conter
eleger	seleccionar/escolher/selecionar/seleccionar/escolher/selecionar
assumir	antecipar
passar	conseguir/atingir/ser_bem_sucedido/suceder/transferir/oferecer/dar_de_presente/dar/regalar/entregar/ganhar_terreno/viajar/ir/caminhar/andar
fazer	plantar/cultivar/amanhar/apresentar/fazer/desempenhar/criar/produzir/fazer/construir/recriar/fazer/causar/provocar/criar
deixar	abandonar/desistir/oferecer/dar_de_presente/dar/regalar/entregar/deslocar/mexer/mover/concordar/aprovar/consentir/aceitar
participar	fazer/agir/atuar
realizar	conseguir/atingir/ser_bem_sucedido/suceder/conhecer/saber/entender
promover	delegar/enaltecer/louvar/elogiar
nomear	estabelecer/fundar/constituir/classificar/rotular/significar/denotar
permanecer	estar/ser
ocupar	estar
obter	conseguir/atingir/ser_bem_sucedido/suceder/receber/obter/comprar/adquirir/receber/obter/comprar/adquirir
votar	seleccionar/escolher/selecionar
criar	criar/produzir/fazer/construir
partir	partir/sair/ir/deslocar/mexer/mover/deslocar/mexer/mover
apoiar	suportar/ajudar/apoiar
dar	transferir/oferecer/dar_de_presente/dar/regalar/entregar/oferecer/dar_de_presente/dar/regalar/entregar/servir/fornecer/prover/provisionar/abastecer
apresentar	propor/nomear/designar/mostrar/apresentar/recriar/informar
formar	receber/construir/confeccionar/fabricar/fazer/causar/provocar/criar/mudar/modificar/alterar
voltar	trazer/tirar/transportar/levar
chegar	vir
defender	defender/proteger/defender/proteger/defender
receber	entreter/divertir
substituir	renovar/mudar/modificar/alterar
aprovar	suportar/ajudar/apoiar/autorizar/permitir
publicar	verbalizar
tomar	ingerir/tomar/consumir
vir	vir
considerar	discutir
manter	ter/registar/registrar
ficar	estar/ser/estar/ser
lançar	propulsionar/propulsar/tocar/impulsionar/propulsionar/propulsar/tocar/impulsionar/lançar/atirar/jogar/lançar/atirar/jogar
atuar	apresentar/fazer/desempenhar
concorrer	correr
falecer	virar/mudar/tornar
conseguir	conseguir/atingir/ser_bem_sucedido/suceder
declarar	afirmar
acusar	criticar/declarar/clamar
propor	propor/nomear/designar/declarar
levar	deslocar/mover/transportar/levar/carregar
derrotar	derrotar/superar/vencer/vencer/derrotar/ultrapassar/bater/superar
reunir	interagir/receber/obter/comprar/adquirir
trabalhar	manusear/manejar/manipular
ir	ganhar_terreno/ir/viajar/andar/viajar/ir/caminhar/andar
liderar	conduzir/dirigir/preceder
acabar	terminar/finalizar/concluir/encerrar/terminar/finalizar/concluir/encerrar
representar	igualar/equivaler/apresentar/fazer/desempenhar/exercer/servir
decidir	moldar/influenciar/determinar/resolver/decidir/seleccionar/escolher/selecionar
organizar	organizar/fazer/causar/provocar/criar/arranjar/dispor/planejar
indicar	informar
retornar	trazer/tirar/transportar/levar/viajar/ir/caminhar/andar
seguir	obedecer/perseguir/perseguir/viajar/ir/caminhar/andar
encontrar	interagir/encontrar/achar/reganhar/receber/obter/comprar/adquirir
disputar	correr/impugnar/contestar/discutir/debater/argüir/arguir
estabelecer	construir/desenvolver/melhorar
tentar	fazer/agir/atuar
permitir	concordar/aprovar/consentir/aceitar
enviar	transferir/transmitir/trazer
contar	estar/ser/verbalizar/exprimir/proferir/expressar/achar/determinar/informar
servir	estar/ser/ajudar/assistir/auxiliar/socorrer/solidarizar_se/acorrer/servir/fornecer/prover/provisionar/abastecer/servir/fornecer/prover/provisionar/abastecer
prever	supor/adivinhar/aventurar/pretender
renunciar	partir/abandonar/deixar/sair/largar/abandonar/desistir
procurar	fazer/agir/atuar/ver/examinar/inspecionar
dirigir	viajar/ir/caminhar/andar/fazer/causar/provocar/criar
pedir	solicitar/pedir/requerer/requisitar/solicitar/pedir/requerer/requisitar/transmitir/comunicar
manifestar	mostrar/apresentar
escolher	delegar/resolver/decidir/seleccionar/escolher/selecionar/seleccionar/escolher/selecionar/seleccionar/escolher/selecionar/seleccionar/escolher/selecionar/julgar/avaliar/balizar
dedicar	usar/utilizar/empregar
instalar	colocar/carregar/botar/pôr
visar	escrever/redigir
chamar	classificar/rotular/telecomunicar/impetrar/mandar/intimar/ordenar
provocar	manipular/controlar/aporrinhar/chatear/importunar/irritar/vexar/incomodar/molestar/perturbar/aborrecer/amolar/agastar/elicitar/provocar/incitar/estimular/concitar/fazer/causar/provocar/criar/zoar/rir/pagodear/ridicularizar/sacanear/zombar/mangar
assinar	escrever/redigir
chefiar	gerenciar/gerir/administrar
ver	observar/mirar/olhar/ver/aperceber/entender/perceber/aperceber-se
comandar	conduzir/dirigir/impetrar/mandar/intimar/ordenar
aceitar	deixar/permitir/consentir/suportar/tolerar/aguentar/aturar
anunciar	enaltecer/louvar/elogiar
compor	fazer/causar/provocar/criar
dizer	falar/contar/dizer/exprimir/expressar/mostrar/verbalizar/exprimir/proferir/expressar/transmitir/comunicar
elaborar	explicar
colocar	deslocar/mover/colocar/carregar/botar/pôr/colocar/carregar/botar/pôr/colocar/carregar/botar/pôr
estudar	adquirir/aprender
incluir	incluir/abarcar/conter
adotar	topar/aceitar/levar/tomar
denunciar	criticar/declarar/clamar
acompanhar	viajar/ir/caminhar/andar
desenvolver	criar
atingir	conseguir/atingir/ser_bem_sucedido/suceder/conseguir/atingir/ser_bem_sucedido/suceder/receber/obter/comprar/adquirir/tocar/bater
prender	prender/deter/confinar/anexar/juntar/unir/segurar/agarrar/capturar/pegar
sair	partir/sair/ir/deslocar/mexer/mover
encerrar	terminar/finalizar/concluir/encerrar
definir	especificar/determinar
escrever	verbalizar/fazer/causar/provocar/criar/transmitir/comunicar
divulgar	informar/contar/enaltecer/louvar/elogiar
tratar	interagir/iniciar/abordar/encetar
transformar	transformar/transmutar/mudar/alterar/mudar
depor	declarar
pretender	especular
alcançar	estar/conseguir/atingir/ser_bem_sucedido/suceder
convidar	solicitar/pedir/requerer/requisitar
retirar	eliminar/deletar/apagar/excluir/tirar/remover/retirar
convocar	impetrar/mandar/intimar/ordenar
solicitar	transmitir/comunicar
parecer	combinar/corresponder/concordar/estar/ser/estar/ser
licenciar	autorizar/permitir
perder	falhar/negligenciar/malograr/fracassar/falhar/quebrar_a_cara/colocar/carregar/botar/pôr
surgir	tornar_se
caber	estar/ser
aumentar	desinformar/enganar/aumentar/crescer/aumentar/crescer/mudar_a_dimensão/aumentar/ampliar/progredir/aumentar/ampliar/progredir
vencer	derrotar/superar/vencer
negar	reter/conter/manter/guardar/segurar/reter/desdizer/contradizer
articular	falar/contar/dizer/exprimir/expressar/mostrar
prestar	dar/entregar
recusar	reter/conter/responder/reagir
condenar	pronunciar/julgar/rotular
extinguir	destruir
exigir	exigir/demandar/solicitar/pedir/requerer/requisitar/impetrar/mandar/intimar/ordenar
viajar	viajar
entregar	expulsar/transferir/oferecer/dar_de_presente/dar/regalar/entregar/dar/entregar/pegar/transmitir/trazer
discutir	discutir/conversar/falar
assegurar	defender/proteger
coordenar	arranjar/dispor
bacharelar	receber
auxiliar	suportar/ajudar/apoiar
suceder	conseguir/atingir/ser_bem_sucedido/suceder
conquistar	limitar/controlar/refrear/tomar_o_poder/arrogar/assumir_pela_força/esbulhar/usurpar
apontar	informar
mudar	alterar/mudar
mostrar	mostrar/apresentar/mostrar/apresentar/informar/informar
reduzir	reduzir/diminuir/mudar/modificar/alterar
abandonar	partir/abandonar/deixar/sair/largar/abandonar/desistir/escapar/evadir-se/fugir/abandonar/deixar
fixar	anexar/juntar/unir
ampliar	aumentar/ampliar/progredir
ganhar	receber/obter/comprar/adquirir/receber/obter/comprar/adquirir
opor	discutir/debater/argüir/arguir
preparar	construir/confeccionar/fabricar/leccionar/instruir/ensinar/lecionar
desempenhar	recriar
colaborar	trabalhar
cassar	cancelar/revogar/anular
terminar	terminar/finalizar/concluir/encerrar/terminar/finalizar/concluir/encerrar
autorizar	responsabilizar/nomear/autorizar/permitir
reconhecer	licenciar/certificar/autorizar/julgar/declarar/lembrar-se/lembrar/recordar/recordar-se
encabeçar	conduzir/dirigir
resolver	entender/compreender/comprender
responder	falar/contar/dizer
romper	dividir/separar
sugerir	declarar/exprimir/expressar/mostrar
obrigar	forçar/obrigar/compelir
construir	edificar/construir/fabricar
gerar	criar/produzir/fazer/construir/fazer/causar/provocar/criar
rejeitar	reter/conter/responder/reagir
ameaçar	avisar/alertar/advertir
julgar	resolver/decidir
oferecer	fazer/agir/atuar
comprometer	usar/utilizar/empregar/concordar
denominar	classificar/rotular
lutar	disputar/lutar/brigar
promulgar	declarar
estender	aumentar/ampliar/progredir/mudar/modificar/alterar
revelar	mostrar/apresentar/informar/contar
pôr	descer/baixar/cair/deslocar/mover/colocar/carregar/botar/pôr/colocar/carregar/botar/pôr
citar	reiterar/redizer/repetir/reapresentar/referir/mencionar
inaugurar	iniciar/começar
lecionar	informar
conduzir	gerenciar/gerir/administrar
transmitir	deslocar/mover
firmar	acordar/concordar
conter	incluir/abarcar/conter/incluir/abarcar/conter/limitar/controlar/refrear/conter/limitar/restringir
admitir	julgar/declarar/deixar/permitir/consentir/deixar/permitir/consentir
controlar	limitar/controlar/refrear/manusear/manejar/manipular
negociar	conseguir/atingir/ser_bem_sucedido/suceder
dispor	colocar/carregar/botar/pôr
aderir	juntar/grudar
limitar	limitar/controlar/refrear
dividir	usar/utilizar/empregar/mudar
identificar	significar/denotar
pagar	pagar/dar/entregar
beneficiar	receber/obter/comprar/adquirir
submeter	dar/entregar/aceitar
completar	mudar/modificar/alterar
proibir	reter/conter/dar_ordem/comandar/exigir/ordenar
causar	mudar/modificar/alterar
produzir	plantar/cultivar/amanhar
faltar	falhar/negligenciar
demitir	demitir/remover
adquirir	receber/obter/comprar/adquirir
justificar	defender/apoiar/suportar
pertencer	estar/ser
usar	usar/utilizar/empregar
visitar	visitar/viajar/viajar
registrar	protocolar/registar/registrar/registar/inscrever/registrar/recrutar/registar/registrar
acumular	manter/guardar/segurar/reter/arranjar/dispor
sustentar	continuar/manter/preservar
funcionar	operar/funcionar
entender	conhecer/saber/entender
demonstrar	mostrar/apresentar/revalidar/corroborar/provar/confirmar/suportar/sustentar/substanciar
analisar	seleccionar/escolher/selecionar
consolidar	fundir-se/intercalar/unir/unificar
concordar	igualar/equivaler/acordar/concordar/concordar/aprovar/consentir/aceitar
saber	aperceber/entender/perceber/aperceber-se
trazer	mostrar/apresentar/criar/produzir/fazer/construir/transportar/levar/carregar/transportar/levar/carregar
intensificar	aumentar/ampliar/progredir
relacionar	raciocinar/cogitar/pensar/refletir
montar	ascender/subir
ajudar	suportar/ajudar/apoiar/ajudar/assistir/auxiliar/socorrer/solidarizar_se/acorrer
pressionar	tocar/bater
estimular	fazer/causar/provocar/criar
elevar	deslocar/mover
concentrar	raciocinar/cogitar/pensar/refletir
localizar	achar/determinar
efetuar	conseguir/atingir/ser_bem_sucedido/suceder
distribuir	oferecer/dar_de_presente/dar/regalar/entregar
vender	trocar
preferir	avançar/promover
morrer	sofrer/virar/mudar/tornar
explicar	esclarecer/explicar/defender/apoiar/suportar/informar
derrubar	descer/baixar/cair/forçar/empurrar
atacar	agredir/atacar/assaltar
falar	iniciar/abordar/encetar/verbalizar/exprimir/proferir/expressar/transmitir/comunicar
desejar	ansiar/desejar/querer
superar	exceder/sobressair/estar/ser/derrotar/superar/vencer/vencer/derrotar/ultrapassar/bater/superar
governar	governar/reger
operar	manusear/manejar/manipular
crescer	mudar_a_dimensão
financiar	financiar/manter
favorecer	avançar/promover
introduzir	informar/iniciar/começar
examinar	examinar/analizar
reforçar	leccionar/instruir/ensinar/lecionar
associar	raciocinar/cogitar/pensar/refletir
ordenar	organizar/impetrar/mandar/intimar/ordenar
interromper	intrometer/intrometer-se/parar/interromper
exilar	expulsar
executar	penalizar/punir/castigar/o_fazendeiro_matou_um_porco_para_o_natal./matar
cogitar	raciocinar/cogitar/pensar/refletir
classificar	limitar/restringir/julgar/avaliar/balizar
comprar	receber/obter/comprar/adquirir
recomendar	enaltecer/louvar/elogiar
dominar	influir/influenciar/saber
regular	acertar/ajustar/corrigir
acrescentar	mudar_a_dimensão
regressar	viajar/ir/caminhar/andar
aproveitar	usar/utilizar/empregar
acontecer	transformar/transmutar/mudar
convencer	persuadir
empenhar	consignar
anular	cancelar/revogar/anular
redigir	transmitir/comunicar
situar	achar/determinar
vetar	dar_ordem/comandar/exigir/ordenar
levantar	deslocar/mover/descansar/repousar
sancionar	autorizar/permitir
precisar	estar/ser
investir	mudar/modificar/alterar
fornecer	dar/entregar
avaliar	julgar/avaliar/balizar
prorrogar	adiar
formular	exprimir/expressar/mostrar
suprimir	limitar/controlar/refrear
eliminar	destruir
gastar	pagar
embarcar	proceder/entrar
verificar	verificar/verificar
acentuar	exprimir/expressar/mostrar
conferir	verificar
reformar	melhorar/aperfeiçoar
ceder	transferir/esticar
incentivar	encorajar/alentar/encorajar/alentar
forçar	forçar/obrigar/compelir/deslocar/mover
recuperar	receber/obter/comprar/adquirir/melhorar
valer	estar/ser
pleitear	declarar
ferir	ferir/lesar/machucar/lesionar/doer/ferir/aleijar/machucar
enfatizar	exprimir/expressar/mostrar
misturar	manusear/manejar/manipular/desordenar/bagunçar/mudar
desistir	render-se
achar	encontrar/achar/reganhar/conceber/conceitualizar/achar/determinar/julgar/avaliar/balizar
cobrar	calcular/contar/computar/contabilizar
mandar	transferir/transmitir/trazer
atrair	interessar/tirar/puxar/arredar/desafiar/provocar/concitar/estimular/incitar
sentir	aperceber/entender/perceber/aperceber-se
depender	estar/ser
pregar	palestrar/falar
planejar	imaginar/raciocinar/cogitar/pensar/refletir
ler	compreender/entender
lembrar	informar/pensar/lembrar
diminuir	reduzir/diminuir/mudar_a_dimensão/mudar/modificar/alterar
debater	discutir
acatar	obedecer
abranger	continuar/estender/incluir/abarcar/conter
refletir	emitir/raciocinar/cogitar/pensar/refletir
qualificar	servir/bastar/ser_suficiente
questionar	questionar/perguntar/ruminar/ponderar/cogitar/especular/contemplar/refletir
resistir	desafiar/arrostar/relutar/fazer_frente_a/afrontar/resistir/aguentar/desobedecer/desacatar/defender/resistir/lutar/brigar/opor_se
advogar	declarar
graduar	receber
corresponder	igualar/equivaler/igualar/equivaler/confromar-se/adequar-se/ajustar/adaptar-se
antecipar	julgar/avaliar/balizar
preconizar	enaltecer/louvar/elogiar
restringir	limitar/controlar/refrear/conter/limitar/restringir
excluir	extinguir/eliminar
destituir	demitir/remover
veicular	declarar
esclarecer	informar
durar	medir
expor	mostrar/apresentar/explicar/zoar/rir/pagodear/ridicularizar/sacanear/zombar/mangar
inspirar	encorajar/alentar
explorar	usar/utilizar/empregar/usar/utilizar/empregar
conclamar	encorajar/alentar
imprimir	escrever
absolver	pronunciar/julgar/rotular
compreender	incluir/abarcar/conter/conhecer/saber/entender
preservar	cozinhar/preparar
afetar	mudar/modificar/alterar
mencionar	falar/contar/dizer/referir/mencionar
projetar	imaginar
atravessar	continuar/estender/viajar/ir/caminhar/andar/perfurar/furar
alertar	informar
pensar	imaginar/julgar/avaliar/balizar
trocar	trocar/mudar/modificar/alterar
revogar	cancelar/revogar/anular
ouvir	aperceber/entender/perceber/aperceber-se/aperceber/entender/perceber/aperceber-se
importar	estar/ser/comerciar
proclamar	declarar
recolher	receber/obter/comprar/adquirir
cair	inclinar/declivar/descer/baixar/cair/viajar/ir/caminhar/andar/falhar/acabar/morrer
somar	enumerar/contar
cobrir	cobrir/tampar/iniciar/abordar/encetar
avançar	exceder/sobressair/delegar
expressar	exprimir/expressar/mostrar
ultrapassar	ganhar_terreno/derrotar/superar/vencer/vencer/derrotar/ultrapassar/bater/superar
reservar	solicitar/pedir/requerer/requisitar
traduzir	reiterar/redizer/repetir/reapresentar
solucionar	entender/compreender/comprender
descobrir	encontrar/achar/reganhar/mostrar/apresentar/conceber/conceitualizar/inteirar/achar/descobrir/informar-se
dispensar	dar/entregar
rever	escrever_novamente/reescrever/lembrar/relembrar/recordar
repetir	reproduzir
desaparecer	desaparecer/sumir
advertir	informar
converter	alterar/mudar
adiar	adiar/esperar/reter/aguardar
invadir	trespassar/invadir
assistir	suportar/ajudar/apoiar/ajudar/assistir/auxiliar/socorrer/solidarizar_se/acorrer
pesar	medir/estar/ser/mensurar/quantificar
enfraquecer	desobedecer/desacatar
melhorar	melhorar/aperfeiçoar/melhorar/mudar/modificar/alterar
requerer	estar/ser/exigir/demandar/transmitir/comunicar
devolver	trazer/tirar/transportar/levar/viajar/ir/caminhar/andar
dificultar	prejudicar/desavantajar/desfavorecer
comentar	falar/contar/dizer
contornar	tocar/encostar
cancelar	cancelar/revogar/anular
respeitar	achar/considerar/ver
fugir	escapar/evadir-se/fugir/partir/sair/ir
reprimir	limitar/controlar/refrear
prolongar	continuar/manter/preservar/aumentar/crescer
merecer	estar/ser
coincidir	acontecer/ocorrer/suceder/passar
constatar	inteirar/achar/descobrir/informar-se
alimentar	encorajar/alentar/servir/fornecer/prover/provisionar/abastecer
apreender	levar/tomar/segurar/agarrar/capturar/pegar
surpreender	surpreender/assombrar/sobressaltar
proteger	defender
indiciar	declarar/clamar
acertar	mudar/modificar/alterar
quebrar	dividir/separar/arremessar/lançar/atirar/falhar/acabar/morrer/quebrar/romper/separar/dividir/desmoronar/decair/desmoronar/esfacelar/alterar/mudar
conservar	cozinhar/preparar
privar	reter/conter
preocupar	emocionar/disturbar/perturbar
despertar	virar/mudar/tornar
perseguir	perseguir/perseguir
aconselhar	declarar
destruir	destruir/decair/desmoronar/esfacelar
contrair	estreitar/apertar
escapar	escapar/evadir-se/fugir/partir/sair/ir
tirar	deslocar/mover/transportar/levar/carregar/tirar/remover/retirar/tirar/remover/retirar
remunerar	pagar
conciliar	acordar/concordar
sufocar	limitar/controlar/refrear/sofrer/doer
consagrar	usar/utilizar/empregar
evidenciar	informar
reverter	cancelar/revogar/anular
apreciar	passar/transmitir/agradecer/apreciar/reconhecer
vedar	cerrar/fechar/dar_ordem/comandar/exigir/ordenar
fundir	mudar
fracassar	mudar
correr	acelerar/apressar/despachar-se/apressar-se/passar/viajar/ir/caminhar/andar/deslocar/mexer/mover
morar	morar/habitar/povoar/viver
bater	deslocar/mover/deslocar/mexer/mover/agitar/perturbar/bater/acertar/bater/golpear/acertar/bater/golpear/golpear/bater/cerrar/fechar/tocar/bater/tocar/bater/derrotar/superar/vencer
remeter	pegar/transmitir/trazer
preterir	extinguir/eliminar
obedecer	confromar-se/adequar-se/ajustar/adaptar-se
endossar	suportar/ajudar/apoiar
comparar	examinar/analizar
separar	deslocar/mexer/mover/mudar
espalhar	derramar/desaguar
recuar	viajar/ir/caminhar/andar
arrecadar	reunir/acumular/recolher/coletar
inscrever	protocolar/registar/registrar/registar/inscrever/registrar/recrutar
compensar	balancear/equilibrar/compensar/pagar/combinar
reintegrar	pagar
necessitar	estar/ser
conceber	virar/mudar/tornar
centrar	raciocinar/cogitar/pensar/refletir
apressar	viajar/ir/caminhar/andar
marchar	ir/caminhar/andar/ir/caminhar/andar
deliberar	discutir/discutir
provar	ingerir/tomar/consumir/informar
bloquear	bloquear/impossibilitar/impedir/estorvar/evitar/obstar/proibir
apelar	contestar
ignorar	rejeitar
contemplar	observar/mirar/olhar/ver/raciocinar/cogitar/pensar/refletir
descartar	rejeitar
estimar	respeitar/prezar/venerar/julgar/avaliar/balizar
cortar	cortar/dividir/cortar/dividir/eliminar/deletar/apagar/excluir
saudar	transmitir/comunicar
atrasar	adiar/reduzir/desacelerar
combinar	igualar/equivaler/confromar-se/adequar-se/ajustar/adaptar-se/mudar
ascender	ascender/subir/viajar/ir/caminhar/andar
herdar	receber/obter/comprar/adquirir
expandir	explicar/aumentar/crescer
esvaziar	esvaziar/evaziar
caminhar	ir/caminhar/andar/ir/caminhar/andar/ir/caminhar/andar/viajar/ir/caminhar/andar/viajar/ir/caminhar/andar
doar	oferecer/dar_de_presente/dar/regalar/entregar/dar/entregar
gravar	registar/registrar
encarar	observar/mirar/olhar/ver/disputar/jogar/enfrentar/deparar_se/confrontar/defrontar
corrigir	mudar/modificar/alterar
transportar	deslocar/mover/transportar/levar/carregar/transportar/levar/carregar
sobreviver	fazer/agir/atuar
subir	ascender/subir/ascender/subir/viajar/ir/caminhar/andar/aumentar/crescer
descrever	explicar
estrear	passar
requisitar	transmitir/comunicar
experimentar	ingerir/tomar/consumir/analizar/pesquisar
avisar	informar
expulsar	expulsar/deslocar/mover
esboçar	imaginar
averiguar	inteirar/achar/descobrir/informar-se
exibir	ter/possuir/mostrar/apresentar
agitar	deslocar/mover/deslocar/mexer/mover/deslocar/mexer/mover
aperfeiçoar	mudar/modificar/alterar
selar	cerrar/fechar
reproduzir	criar/produzir/fazer/construir/criar/produzir/fazer/construir
exportar	comerciar
estacionar	manobrar/guiar/canalizar/dirigir
salvar	resistir/defender/proteger
culpar	responsabilizar/acusar/incriminar/criticar
inocentar	pronunciar/julgar/rotular
equilibrar	combinar
impulsionar	deslocar/mexer/mover
confessar	julgar/declarar
inclinar	torcer/dobrar/curvar/vergar/torcer/dobrar/curvar/vergar/aprumar
suprir	prover/suprir/abastecer/fornecer/dar/entregar
subscrever	escrever/redigir
selecionar	resolver/decidir/seleccionar/escolher/selecionar
compartilhar	fazer/agir/atuar/usar/utilizar/empregar
censurar	criticar
ensinar	informar
resumir	reduzir/diminuir
modernizar	alterar/mudar
penetrar	entrar/ganhar_terreno
lamentar	sentir/experimentar
atestar	informar
perguntar	questionar/perguntar/transmitir/comunicar/ruminar/ponderar/cogitar/especular/contemplar/refletir
andar	ir/caminhar/andar/ir/caminhar/andar/viajar/ir/caminhar/andar/viajar/ir/caminhar/andar
poupar	isentar/dispensar/liberar
esconder	esconder/encobrir/omitir/tampar/tapar/acobertar/ocultar/esconder/encobrir/omitir/tampar/tapar/acobertar/ocultar
confundir	estar/ser
obstruir	bloquear/impossibilitar/impedir/estorvar/evitar/obstar/proibir
gerir	governar/reger
direcionar	advertir
medir	julgar/avaliar/balizar
instruir	informar/leccionar/instruir/ensinar/lecionar
emprestar	dar/entregar
colher	ajuntar/coletar/coligir/reunir/recolher/juntar
defrontar	disputar/jogar
recriar	fazer/causar/provocar/criar
atualizar	informar
esmagar	apertar/pressionar/prensar
supervisionar	gerenciar/gerir/administrar
guardar	ter/manter/guardar/segurar/reter/defender/proteger/defender/proteger
explodir	responder/reagir/separar/dividir/desmoronar/explodir/arrebentar/estourar
reter	ter/pensar/lembrar
congelar	virar/mudar/tornar/sofrer/padecer
agradar	estar/ser/satisfazer/agradar
jogar	agir/atirar/lançar/arremeter/propulsionar/propulsar/tocar/impulsionar/apostar/jogar/competir/concorrer
credenciar	licenciar/certificar/autorizar
trair	iludir/lograr/enganar/desinformar/enganar
seqüestrar	tomar/capturar/pegar
aprisionar	prender/deter/confinar
minimizar	informar
supor	especular/antecipar/antecipar
respaldar	suportar/ajudar/apoiar
persistir	continuar/manter/preservar
girar	girar/rodar/dar_a_volta/virar-se/tornar-se/virar/deslocar/mexer/mover
reger	governar/reger
cooperar	trabalhar
ajustar	acertar/ajustar/corrigir/mudar/modificar/alterar/alterar/mudar
acrescer	mudar_a_dimensão
premiar	fazer/agir/atuar
exortar	encorajar/alentar/aconselhar/avisar/opinar/assessorar
deferir	autorizar/permitir
legislar	promulgar/ordenar/decretar
forjar	construir/confeccionar/fabricar
fabricar	fabricar/pensar/inventar
emendar	melhorar/aperfeiçoar
aclamar	gesticular
tecer	construir/confeccionar/fabricar/construir/confeccionar/fabricar
dobrar	torcer/dobrar/curvar/vergar/deslocar/mexer/mover/mudar_a_superfície
satisfazer	satisfazer/agradar
multiplicar	calcular/computar/multiplicar
recrutar	protocolar/registar/registrar/engajar/empregar/enlistar
parar	protestar/parar/interromper
finalizar	terminar/finalizar/concluir/encerrar
aliviar	desimpedir/remover/livrar
resgatar	trocar/tirar/remover/retirar
inverter	mudar/modificar/alterar
reconquistar	receber/obter/comprar/adquirir
erguer	deslocar/mover
enumerar	achar/determinar
endereçar	iniciar/abordar/encetar
acenar	gesticular
restituir	pagar
notar	falar/contar/dizer
alugar	dar/entregar
tocar	soar/ressoar/fazer/apresentar/fazer/desempenhar
incitar	fazer/causar/provocar/criar/desafiar/provocar/concitar/estimular/incitar
exceder	exceder/sobressair/vencer/derrotar/ultrapassar/bater/superar
deportar	expulsar
cultivar	adequar/ajustar/adaptar
arrastar	tirar/puxar/arredar
ditar	proclamar
confiscar	levar/tomar
atirar	propulsionar/propulsar/tocar/impulsionar/lançar/atirar/jogar/lançar/atirar/jogar/atirar
aplaudir	gesticular
reconciliar	acordar/concordar/aceitar
racionalizar	defender/apoiar/suportar
omitir	extinguir/eliminar
expirar	virar/mudar/tornar
decepcionar	demover/desconcertar/frustrar/contrariar
confrontar	dar_para/disputar/jogar
soltar	deslocar/mover
roubar	trapacear/defraudar/calotear/roubar/furtar/segurar/agarrar/capturar/pegar/vencer/derrotar/ultrapassar/bater/superar
indagar	transmitir/comunicar
deteriorar	avariar/danificar/decair/desmoronar/esfacelar/decair/piorar
despedir	demitir/remover
carregar	prover/suprir/abastecer/fornecer/deslocar/mover/deslocar/mover/colocar/carregar/botar/pôr/transportar/levar/carregar/transportar/levar/carregar
pugnar	disputar/lutar/brigar
ponderar	ruminar/ponderar/cogitar/especular/contemplar/refletir/raciocinar/cogitar/pensar/refletir
telefonar	telecomunicar
especular	investir/antecipar/raciocinar/cogitar/pensar/refletir
equipar	prover/suprir/abastecer/fornecer
capturar	tomar_o_poder/arrogar/assumir_pela_força/esbulhar/usurpar/receber/obter/comprar/adquirir/agarrar/pegar/tomar
aparelhar	prover/suprir/abastecer/fornecer/virar/mudar/tornar
suportar	financiar/manter/deixar/permitir/consentir
narrar	informar
duplicar	multiplicar
demandar	solicitar/pedir/requerer/requisitar
virar	virar-se/tornar-se/virar/deslocar/mover/deslocar/mexer/mover/deslocar/mexer/mover/transformar/transmutar/mudar
imaginar	imaginar
ilustrar	elaborar/expandir/elocubrar/expor
estourar	separar/dividir/desmoronar/explodir/arrebentar/estourar
bombardear	atacar/assaltar
alçar	deslocar/mover
agradecer	passar/transmitir
lidar	fazer/agir/atuar/iniciar/abordar/encetar
incendiar	queimar
exagerar	desinformar/enganar
crer	crer/acreditar
vislumbrar	observar/mirar/olhar/ver
prover	dar/entregar
prosperar	virar/mudar/tornar
ativar	mudar/modificar/alterar
perturbar	desgostar/desagradar/emocionar/disturbar/perturbar/parecer/impressionar/comover/afetar
gerenciar	sobreviver/aguentar/lidar/virar-se
errar	viajar/ir/caminhar/andar
desafiar	impugnar/contestar
comercializar	mudar/modificar/alterar
coletar	receber/obter/comprar/adquirir
apertar	apertar/pressionar/prensar/agarrar/segurar/tocar/bater
tranqüilizar	aliviar/confortar/consolar/reconfortar/acalmar
protelar	adiar
encobrir	esconder/encobrir/omitir/tampar/tapar/acobertar/ocultar/esconder/encobrir/omitir/tampar/tapar/acobertar/ocultar
disparar	voar/atirar
disfarçar	esconder/encobrir/omitir/tampar/tapar/acobertar/ocultar
chocar	revoltar/repulsar/repugnar/indignar/nausear
apagar	tirar/remover
socorrer	suportar/ajudar/apoiar
enterrar	pôr/situar
consentir	concordar/aprovar/consentir/aceitar/concordar/aprovar/consentir/aceitar
sanar	ajudar/socorrer
pressupor	antecipar
jantar	comer
gostar	satisfazer/agradar
encorajar	induzir
abastecer	dar/entregar
quitar	partir/abandonar/deixar/sair/largar
mergulhar	submergir
impressionar	parecer/impressionar/comover/afetar
dissuadir	aconselhar/avisar/opinar/assessorar
discriminar	distinguir/separar/diferenciar
descer	descer/baixar/cair
apostar	apostar/jogar/adivinhar/prognosticar/pressentir/prever/predizer
vagar	viajar/ir/caminhar/andar
naturalizar	adequar/ajustar/adaptar
manufaturar	pensar/inventar
concitar	fazer/causar/provocar/criar
aprimorar	melhorar/aperfeiçoar
amadurecer	desenvolver/progredir
acordar	virar/mudar/tornar
acomodar	enganchar/aferrar
recordar	lembrar/relembrar/recordar
queimar	doer
plantar	colocar/carregar/botar/pôr/colocar/carregar/botar/pôr
extrair	tirar/remover/retirar
documentar	registar/registrar
arrendar	dar/entregar
afinar	acertar/ajustar/corrigir
partilhar	usar/utilizar/empregar
ofender	revoltar/repulsar/repugnar/indignar/nausear/encolerizar/enraivecer/irar/zangar/elicitar/provocar/incitar/estimular/concitar
irritar	desgostar/desagradar/aporrinhar/chatear/importunar/irritar/vexar/incomodar/molestar/perturbar/aborrecer/amolar/agastar/encolerizar/enraivecer/irar/zangar
falsificar	tapear/trapacear/recriar
desiludir	demover/desconcertar/frustrar/contrariar
assustar	estimular/excitar/emocionar/comover
secundar	suportar/ajudar/apoiar
relembrar	lembrar/relembrar/recordar
postar	mostrar/anunciar
enunciar	falar/contar/dizer
adicionar	enumerar/contar
tolerar	honrar/homenagear/respeitar/prestigiar/deixar/permitir/consentir
ressentir	desgostar/não_gostar/antipatizar
pegar	receber/obter/comprar/adquirir/agarrar/pegar/tomar
interceptar	ouvir/dar_atenção_a/escutar
excetuar	extinguir/eliminar
desencorajar	rejeitar/desaprovar
decrescer	mudar_a_dimensão
certificar	autorizar/permitir
banir	expulsar/expulsar
aludir	referir/mencionar
transcender	exceder/sobressair
sublinhar	marcar
olhar	observar/mirar/olhar/ver/aperceber/entender/perceber/aperceber-se
intimidar	estimular/excitar/emocionar/comover
hospedar	entreter/divertir
empatar	equiparar/igualar
diluir	enfraquecer
clamar	afirmar
atrapalhar	bloquear/impossibilitar/impedir/estorvar/evitar/obstar/proibir
assemelhar	combinar/corresponder/concordar
treinar	leccionar/instruir/ensinar/lecionar/leccionar/instruir/ensinar/lecionar
ousar	fazer/agir/atuar
divorciar	partir/separar_se/separar
desenhar	figurar/representar/imaginar
conformar	obedecer
colar	juntar/grudar
alargar	mudar/modificar/alterar
acalmar	aliviar/confortar/consolar/reconfortar/acalmar
abraçar	agarrar_com_firmeza/agarrar_firmemente
reviver	trazer
retrucar	falar/contar/dizer
validar	revalidar/corroborar/provar/confirmar/suportar/sustentar/substanciar
provir	tornar_se
interrogar	questionar/perguntar
furtar	roubar/furtar/segurar/agarrar/capturar/pegar
encarcerar	prender/deter/confinar
cantar	proferir/falar/dizer/verbalizar/conversar
armazenar	manter/guardar/segurar/reter
sequestrar	tomar/capturar/pegar
sacar	tirar/remover/retirar/tirar/remover/retirar
rezar	comungar
piorar	decair/piorar/virar/mudar/tornar
evocar	exprimir/expressar/mostrar
educar	leccionar/instruir/ensinar/lecionar
desprezar	detestar/odiar
arriscar	procurar/tentar
voar	viajar/ir/caminhar/andar
vestir	virar/mudar/tornar
recompensar	fazer/agir/atuar/pagar
listar	protocolar/registar/registrar
desacreditar	zoar/rir/pagodear/ridicularizar/sacanear/zombar/mangar
compactuar	concordar
ventilar	agitar/sacudir/tremer
salvaguardar	defender/proteger
repartir	mudar
reinar	governar/reger
pintar	criar/fazer/cobrir/revestir
desconsiderar	rejeitar
testemunhar	informar
saltar	viajar/ir/caminhar/andar/deslocar/mexer/mover
sabotar	desobedecer/desacatar
postergar	adiar
persuadir	induzir/persuadir
gritar	soltar/emitir/proferir/falar/dizer/verbalizar/conversar/berrar/gritar
engendrar	fazer/causar/provocar/criar
amar	amar
afundar	descer/baixar/cair
solapar	desobedecer/desacatar
relaxar	afundar/virar/mudar/tornar
refinar	melhorar/aperfeiçoar
proscrever	dar_ordem/comandar/exigir/ordenar
ostentar	aumentar/exagerar
mexer	deslocar/mover/deslocar/mexer/mover
inundar	completar/encher
desculpar	desculpar/perdoar
assaltar	agredir/atacar/assaltar
acercar	vir
trancar	prender/fixar
perdoar	desculpar/perdoar/defender/apoiar/suportar
negligenciar	não_entender/perder
instigar	manipular/controlar
foragir	escapar/evadir-se/fugir
focar	raciocinar/cogitar/pensar/refletir
empurrar	forçar/empurrar/deslocar/mover
desanimar	rejeitar/desaprovar
colidir	tocar/bater
auferir	receber/obter/comprar/adquirir/receber/obter/comprar/adquirir
atrever	fazer/agir/atuar
assediar	aporrinhar/chatear/importunar/irritar/vexar/incomodar/molestar/perturbar/aborrecer/amolar/agastar
silenciar	aliviar/confortar/consolar/reconfortar/acalmar
segurar	ter/agarrar/pegar/tomar/segurar/agarrar/capturar/pegar/defender/proteger/solicitar/pedir/requerer/requisitar
reparar	falar/contar/dizer/melhorar/aperfeiçoar
mentir	desinformar/enganar
lesar	ferir/lesar/machucar/lesionar/doer/ferir/aleijar/machucar
exemplificar	elaborar/expandir/elocubrar/expor
enganar	desinformar/enganar/informar
distorcer	desmentir/representar/apresentar
admirar	respeitar/prezar/venerar
acorrer	suportar/ajudar/apoiar
acender	queimar
pulverizar	destruir
meter	fechar_(se)
legar	oferecer/dar_de_presente/dar/regalar/entregar
insultar	encolerizar/enraivecer/irar/zangar/verbalizar/exprimir/proferir/expressar/agredir/atacar
golpear	tocar/bater
galgar	ascender/subir
enxergar	aperceber/entender/perceber/aperceber-se
duvidar	desacreditar/descrer
desertar	escapar/evadir-se/fugir/abandonar/deixar
desamparar	abandonar/deixar
degolar	o_fazendeiro_matou_um_porco_para_o_natal./matar
danificar	ferir/lesar/machucar/lesionar
constrangir	conter/limitar/restringir
comer	comer/ingerir/tomar/consumir
coagir	forçar/obrigar/compelir
atar	anexar/juntar/unir/modelar/formar
vazar	sair/aparecer/aflorar/emergir
varrer	esfregar/enxugar/limpar
sintonizar	acertar/ajustar/corrigir
simular	reproduzir/recriar/desmentir
retroceder	viajar/ir/caminhar/andar
ressuscitar	trazer
repreender	criticar
obstaculizar	bloquear/impossibilitar/impedir/estorvar/evitar/obstar/proibir
lucrar	auferir/ganhar/receber/obter/comprar/adquirir
injetar	drogar
incomodar	desgostar/desagradar/aporrinhar/chatear/importunar/irritar/vexar/incomodar/molestar/perturbar/aborrecer/amolar/agastar
imitar	reproduzir
fracionar	mudar
extorquir	roubar
encher	estar/expandir-se/dilatar-se/completar/encher/mudar/modificar/alterar
embalar	deslocar/mover/cobrir/tampar
compelir	forçar/obrigar/compelir
balear	atirar
abusar	tratar
ruir	alterar/mudar
rolar	virar-se/tornar-se/virar
retribuir	pagar
rescindir	cancelar/revogar/anular
modelar	construir/confeccionar/fabricar/recriar/mudar/modificar/alterar
limpar	esfregar/esvaziar/evaziar/limpar/lavar
grampear	ouvir/dar_atenção_a/escutar
furar	perfurar/furar
filmar	fazer/causar/provocar/criar/registar/registrar
erigir	edificar/construir
desabar	mudar_a_dimensão/alterar/mudar
demolir	destruir
degradar	decair/piorar
curvar	torcer/dobrar/curvar/vergar
arrepender	sentir/experimentar
apanhar	receber/obter/comprar/adquirir/ajuntar/coletar/coligir/reunir/recolher/juntar/segurar/agarrar/capturar/pegar
amarrar	anexar/juntar/unir
alongar	continuar/manter/preservar/deslocar/mexer/mover
alojar	morar/habitar/povoar/viver
seduzir	desafiar/provocar/concitar/estimular/incitar
sacudir	oscilar/deslocar/mexer/mover
ridicularizar	zoar/rir/pagodear/ridicularizar/sacanear/zombar/mangar
revistar	ver/examinar/inspecionar
presumir	antecipar
pontuar	exprimir/expressar/mostrar
naufragar	descer/baixar/cair
largar	deslocar/mover
igualar	confromar-se/adequar-se/ajustar/adaptar-se
florescer	aumentar/crescer
falsear	tapear/trapacear
estremecer	agitar/sacudir/tremer
emocionar	parecer/impressionar/comover/afetar
delatar	criticar
deformar	deformar
decair	virar/mudar/tornar
conectar	raciocinar/cogitar/pensar/refletir
avizinhar	vir
atemorizar	estimular/excitar/emocionar/comover
asfixiar	contrair/comprimir/sofrer/doer
ansiar	ansiar/desejar/querer
adorar	gostar
abreviar	reduzir/diminuir
urgir	aconselhar/avisar/opinar/assessorar
semear	colocar/carregar/botar/pôr
respirar	pausar/interromper/parar
reciclar	usar/utilizar/empregar
perfurar	entrar/perfurar/furar
ovacionar	gesticular
lavar	assear/limpar/purgar/limpar/lavar
iluminar	iluminar-se/iluminar
despender	pagar
denegar	reter/conter
chorar	expressar_sentimentos
cavar	tirar/remover/retirar
aterrissar	vir/chegar
arranjar	colocar/carregar/botar/pôr
aparentar	desmentir
tolher	bloquear/impossibilitar/impedir/estorvar/evitar/obstar/proibir
sobrepujar	vencer/derrotar/ultrapassar/bater/superar
replicar	reproduzir/falar/contar/dizer
quantificar	exprimir/transmitir
puxar	deslocar/mover
pressentir	supor/adivinhar/aventurar/pretender
pousar	vir/chegar
perseverar	continuar/manter/preservar
perecer	virar/mudar/tornar
moldar	construir/confeccionar/fabricar
mascarar	esconder/encobrir/omitir/tampar/tapar/acobertar/ocultar
manchar	mudar/modificar/alterar
inventar	pensar/inventar
infundir	causar
hierarquizar	julgar/avaliar/balizar
fluir	deslocar/mexer/mover
fascinar	atrair
escavar	tirar/remover/retirar
engolir	ingerir/tomar/consumir/suportar/tolerar/aguentar/aturar
encurtar	reduzir/diminuir
drenar	esvaziar/evaziar
deturpar	tapear/trapacear
desmoronar	mudar/alterar/mudar
descongelar	liquefazer/liquidificar
degenerar	decair/piorar
curar	ajudar/socorrer
copiar	reproduzir/fazer/causar/provocar/criar
comprimir	estreitar/apertar
beijar	tocar/bater
afogar	expirar/morrer/bater_as_botas/falecer/comer_capim_pela_raiz/perecer
violentar	agredir/atacar/assaltar
soar	soar/ressoar/fazer
rondar	estar/ser
regatear	agenciar/negociar
pretextar	desmentir
pisotear	ir/caminhar/andar
pisar	viajar/ir/caminhar/andar
picar	doer/cortar/dividir/perfurar/furar
penhorar	prometer
pactuar	concordar
molestar	desgostar/desagradar/aporrinhar/chatear/importunar/irritar/vexar/incomodar/molestar/perturbar/aborrecer/amolar/agastar
impelir	aconselhar/avisar/opinar/assessorar
impactar	mudar/modificar/alterar
fumar	ingerir/tomar/consumir
fender	mudar
extraditar	expulsar
exclamar	declarar
estrangular	contrair/comprimir
estarrecer	surpreender/assombrar/sobressaltar
escutar	aperceber/entender/perceber/aperceber-se/aperceber/entender/perceber/aperceber-se
encantar	satisfazer/agradar/atrair/gostar
devotar	usar/utilizar/empregar
despojar	sacar/tirar
desempregar	demitir/remover
desapontar	demover/desconcertar/frustrar/contrariar
deitar	colocar/carregar/botar/pôr
dançar	deslocar/mexer/mover
condensar	reduzir/diminuir
comprazer	satisfazer/agradar
colecionar	receber/obter/comprar/adquirir
chutar	golpear/bater
brincar	agir/jogar/brincar/fazer_piada/caçoar/gracejar
bradar	berrar/gritar
botar	deslocar/mover
beber	ingerir/tomar/consumir
aventurar	proceder/especular
aterrorizar	intimidar/aterrorizar/amedrontar/assustar/atemorizar/estimular/excitar/emocionar/comover
amedrontar	estimular/excitar/emocionar/comover
acamar	aprumar
verter	manar/fluir/correr/deslocar/mover/deslocar/mover
vangloriar	aumentar/exagerar
soprar	informar
rodear	tocar/encostar
resignar	partir/abandonar/deixar/sair/largar/aceitar
recontar	informar
passear	ir/caminhar/andar/ir/caminhar/andar
orquestrar	planejar
minguar	mudar_a_dimensão
inflar	expandir-se/dilatar-se/expandir
inchar	expandir-se/dilatar-se/expandir
fulminar	olhar
estuprar	agredir/atacar/assaltar
espremer	apertar/pressionar/prensar/agarrar/segurar
enxugar	esfregar
envenenar	narcotizar/drogar/dopar
emboscar	iludir/lograr/enganar
devorar	comer
detestar	desgostar/não_gostar/antipatizar
destroçar	arrombar/arrebentar
desperdiçar	gastar/despender/esgotar/gastar/despender
descontrair	virar/mudar/tornar
desbravar	preceder
derramar	manar/fluir/correr/deslocar/mover/deslocar/mover
debitar	pagar
consertar	melhorar/aperfeiçoar
arrombar	separar/dividir/desmoronar
arremeter	lançar/atirar/jogar
arrebentar	separar/desintegrar/separar/dividir/desmoronar/separar/dividir/desmoronar/separar/dividir/desmoronar
arrasar	destruir
apunhalar	ferir/lesar/machucar/lesionar
abocanhar	agarrar/segurar
venerar	achar/considerar/ver
ultrajar	revoltar/repulsar/repugnar/indignar/nausear
tremer	agitar/sacudir/tremer/deslocar/mexer/mover/mover_involuntariamente/mover_reflexivamente/mover_involuntariamente/mover_involuntariamente/mover_reflexivamente/mover_involuntariamente
transtornar	emocionar/disturbar/perturbar
transmutar	alterar/mudar
tranquilizar	aliviar/confortar/consolar/reconfortar/acalmar
torcer	deformar/deformar
sussurrar	proferir/falar/dizer/verbalizar/conversar
sangrar	expelir/expulsar/liberar/ejetar
rogar	rogar/suplicar
raspar	cortar/cuidar-se
pular	viajar/ir/caminhar/andar/deslocar/mexer/mover/perder/preterir/escapar/deixar_passar/omitir
prezar	achar/considerar/ver
permutar	trocar
perambular	estar/ser/viajar/ir/caminhar/andar
odiar	desgostar/não_gostar/antipatizar
moer	fragmentar
mensurar	exprimir/transmitir
menosprezar	detestar/odiar/rejeitar
maquinar	planejar
machucar	ferir/lesar/machucar/lesionar/doer/ferir/aleijar/machucar
incutir	causar
grifar	marcar
germinar	crescer
flabelar	agitar/sacudir/tremer
fingir	desmentir
fiar	construir/confeccionar/fabricar
estragar	putrefazer/avariar/danificar
estalar	soar/ressoar/fazer/deslocar/mexer/mover
esfaquear	ferir/lesar/machucar/lesionar
escandalizar	revoltar/repulsar/repugnar/indignar/nausear
esboroar	mudar
esbanjar	gastar/despender
entreter	socializar
encostar	estar
encolher	desabar/decrescer/minguar/diminuir
domesticar	adequar/ajustar/adaptar
doer	aparecer_como/parecer/aperceber/entender/perceber/aperceber-se
divertir	socializar/alentar/animar/alegrar
dilapidar	gastar/despender
desinformar	informar
descerrar	informar/contar
debruçar	torcer/dobrar/curvar/vergar
cozinhar	construir/confeccionar/fabricar
contradizer	desdizer/contradizer
condizer	confromar-se/adequar-se/ajustar/adaptar-se
cochilar	dormitar/sonecar/cochilar/dormir/capotar
catar	ajuntar/coletar/coligir/reunir/recolher/juntar
aterrar	vir/chegar
arredar	deslocar/mover
aquietar	aliviar/confortar/consolar/reconfortar/acalmar
anuir	transmitir/comunicar
alagar	completar/encher
agastar	desgostar/desagradar
agasalhar	virar/mudar/tornar
agarrar	agarrar/pegar/tomar/segurar/agarrar/capturar/pegar
afagar	tratar/tocar/bater
vocalizar	falar/contar/dizer
troçar	atuar/comportar-se/agir/parecer
tropeçar	deslocar/mexer/mover/errar/equivocar/confundir
triturar	fragmentar
tremular	agitar/sacudir/tremer
tensionar	afetar/afectar
suplicar	rogar/suplicar
sorver	beber/tomar
sorrir	fazer_careta/sorrir
ruborizar	descolorir/colorir
rosar	descolorir/colorir
rir	expressar_sentimentos
resvalar	deslizar/passar_gradativamente_a/escorregar
remir	trocar
raptar	tomar/capturar/pegar
pulular	apinhar
predizer	supor/adivinhar/aventurar/pretender
piscar	irradiar/radiar
pingar	entornar/verter/derramar
pendurar	prender/fixar/prender/fixar
narcotizar	medicar
nadar	viajar/ir/caminhar/andar/viajar/ir/caminhar/andar
morder	perfurar/furar/agarrar/segurar
mendigar	solicitar/pedir/requerer/requisitar
maltratar	tratar
magoar	elicitar/provocar/incitar/estimular/concitar
luzir	emitir
lesionar	doer/ferir/aleijar/machucar
intrigar	interessar
injuriar	encolerizar/enraivecer/irar/zangar/agredir/atacar
infectar	causar/provocar/dar
implorar	rogar/suplicar
gemer	soltar/emitir
ferver	alterar/mudar
ferrar	doer
estressar	afetar/afectar
esticar	deslocar/mexer/mover
escusar	desculpar/perdoar
escorregar	deslizar/passar_gradativamente_a/escorregar/viajar/ir/caminhar/andar/viajar/ir/caminhar/andar
escorraçar	expulsar
envelhecer	desenvolver/progredir
engravidar	virar/mudar/tornar
engodar	desafiar/provocar/concitar/estimular/incitar
engenhar	planejar
enfiar	fechar_(se)
encharcar	completar/encher
embrulhar	cobrir/tampar
domar	adequar/ajustar/adaptar
destratar	tratar
despir	sacar/tirar
desnudar	sacar/tirar
deslizar	deslizar/passar_gradativamente_a/escorregar/viajar/ir/caminhar/andar/viajar/ir/caminhar/andar
desdenhar	detestar/odiar
decorar	marrar/estudar
decepar	cortar/dividir
cravar	penetrar
convalescer	melhorar
contagiar	causar/provocar/dar
conjeturar	imaginar
comover	parecer/impressionar/comover/afetar
clicar	soar/ressoar/fazer
cativar	atrair
carpir	soltar/emitir
brilhar	irradiar/radiar/iluminar-se/iluminar
bramir	soltar/emitir
berrar	soltar/emitir/soltar/emitir/proferir/falar/dizer/verbalizar/conversar/berrar/gritar
balancear	combinar
atraiçoar	iludir/lograr/enganar
assentir	transmitir/comunicar
assar	construir/confeccionar/fabricar
arrumar	organizar
arremessar	deslocar/mexer/mover/atirar/lançar/arremeter/lançar/atirar/jogar
amputar	tirar/remover/retirar
aguentar	sobreviver/aguentar/lidar/virar-se/fazer/agir/atuar/deixar/permitir/consentir
agachar	torcer/dobrar/curvar/vergar/sentar/sentar-se/estar_sentado
adjudicar	resolver/decidir
acovardar	torcer/dobrar/curvar/vergar
aconchegar	enganchar/aferrar