fazer	cultivo/pecuária/agricultura
empresa	industria/comércio/negócio/empresa
obter	comércio/mercantilismo/comercialismo
vez	jogo
função	ciência_exacta/matematica/matemática/ciências_exactas
força	ciências_físicas/fisica/física/física
parte	lei/jurisprudência/ciências_jurídicas/música
programa	informática/ciência_da_computação/informática/ciência_da_computação
cadeira	arte_dramatica/dramaturgia/teatro/aeroplano/avião
lei	lei/jurisprudência/ciências_jurídicas
administração	industria/comércio/negócio/empresa
costa	rio/oceano/lago
constituição	lei/jurisprudência/ciências_jurídicas
tempo	jogo
ato	lei/jurisprudência/ciências_jurídicas
indústria	indústria/manufatura
gestão	industria/comércio/negócio/empresa
turno	beisebol/basebol/jogo
plano	ciência_exacta/matematica/matemática/ciências_exactas
representar	arte
energia	ciências_físicas/fisica/física/física
lugar	arte_dramatica/dramaturgia/teatro/aeroplano/avião
produção	economia
operação	informática/ciência_da_computação/ciência_exacta/matematica/matemática/ciências_exactas
legislação	lei/jurisprudência/ciências_jurídicas/lei/jurisprudência/ciências_jurídicas
advogado	lei/jurisprudência/ciências_jurídicas
discurso	música/linguagem/discurso/idioma/língua/arte
incluir	quimica/química
atingir	comércio/mercantilismo/comercialismo
casa	arte_dramatica/dramaturgia/teatro
imposto	taxação/colectas/tributo/taxa/impostos/imposto
seção	música
decreto	lei/jurisprudência/ciências_jurídicas
solução	quimica/química
proprietário	lei/jurisprudência/ciências_jurídicas
estabelecimento	industria/comércio/negócio/empresa
taxa	taxação/colectas/tributo/taxa/impostos/imposto
conjunto	ciência_exacta/matematica/matemática/ciências_exactas
mostrar	lei/jurisprudência/ciências_jurídicas
negócio	industria/comércio/negócio/empresa
corpo	humano/ser_humano/besta/criatura/ser/bicho/animal
registro	lei/jurisprudência/ciências_jurídicas/fotografia
luz	ciências_físicas/fisica/física/física
jogo	esporte/jogo/jogo
julgamento	lei/jurisprudência/ciências_jurídicas
produzir	cultivo/pecuária/agricultura
adquirir	comércio/mercantilismo/comercialismo
encargo	taxação/colectas/tributo/taxa/impostos/imposto
radical	quimica/química
vender	comércio/mercantilismo/comercialismo
água	rio/oceano/lago
operar	remédio/prática_da_medicina/medicina/incisão/medicina
consumo	economia
baixar	música
comprar	comércio/mercantilismo/comercialismo
empenhar	comércio/mercantilismo/comercialismo
casamento	lei/jurisprudência/ciências_jurídicas
jurista	lei/jurisprudência/ciências_jurídicas
exposição	arte
cadeia	quimica/química
administrar	remédio/prática_da_medicina/medicina/incisão/medicina
comportamento	psicologia/psicólogos_por_nacionalidade
cair	música
dispensar	remédio/prática_da_medicina/medicina/incisão/medicina
dono	lei/jurisprudência/ciências_jurídicas
arte	arte
marina	armada/marinha/forças_navais
perseguição	crença_religiosa/fé/religião
estilo	música/linguagem/discurso/idioma/língua/arte
teatro	arte_dramatica/dramaturgia/teatro
onda	ciências_físicas/fisica/física/física
música	música
revogação	lei/jurisprudência/ciências_jurídicas
casal	lei/jurisprudência/ciências_jurídicas
sentença	lei/jurisprudência/ciências_jurídicas
litoral	rio/oceano/lago
língua	música/linguagem/discurso/idioma/língua/arte
capitalista	industria/comércio/negócio/empresa
assento	arte_dramatica/dramaturgia/teatro/aeroplano/avião
evidenciar	lei/jurisprudência/ciências_jurídicas
crônica	história/história
provar	lei/jurisprudência/ciências_jurídicas
tramitar	comércio/mercantilismo/comercialismo
difusão	ciências_físicas/fisica/física/física
pedagogia	pedagogia/ensino/formação/educação/didáctica/ensinamento/instrução
caminhar	esporte
linguagem	música/linguagem/discurso/idioma/língua/arte
leis	lei/jurisprudência/ciências_jurídicas
calcular	ciência_exacta/matematica/matemática/ciências_exactas
atestar	lei/jurisprudência/ciências_jurídicas
cultivo	cultivo/pecuária/agricultura
costume	psicologia/psicólogos_por_nacionalidade
congelar	ciências_físicas/fisica/física/física
universo	estatísticas/estatística/estatística
seqüestrar	crime/ofensa
matemática	disciplina_cientifica/ciência
computador	informática/ciência_da_computação
matrimônio	lei/jurisprudência/ciências_jurídicas
gerenciamento	industria/comércio/negócio/empresa
tocar	música
cultivar	cultivo/pecuária/agricultura
músico	música/música
hábito	psicologia/psicólogos_por_nacionalidade
capturar	beisebol/basebol
rodada	jogo
flora	vegetal/planta/flora
plantar	cultivo/pecuária/agricultura/cultivo/pecuária/agricultura
belas-artes	arte
consagração	crença_religiosa/fé/religião
subornar	crime/ofensa
desenhar	arte
software	informática/ciência_da_computação
arco	arquitectura/arquitetura/arquitectura/arquitetura
sequestrar	crime/ofensa
mistura	quimica/química
voar	aeroplano/aeronave/avião
ortodoxia	crença_religiosa/fé/religião
idioma	linguagem/discurso/idioma/língua
pintar	arte/arte
computar	ciência_exacta/matematica/matemática/ciências_exactas
testemunhar	lei/jurisprudência/ciências_jurídicas
solidificar	ciências_físicas/fisica/física/física
orla	rio/oceano/lago
fotografar	fotografia
acessar	informática/ciência_da_computação
colisão	ciências_físicas/fisica/física/física
assimetria	ciência_exacta/matematica/matemática/ciências_exactas
pilotar	aeroplano/aeronave/avião
modelar	arte
limpar	quimica/química
jogada	beisebol/basebol
filmar	película/filme/produção/cinema
apanhar	beisebol/basebol
exposições	arte
semear	cultivo/pecuária/agricultura
corromper	crime/ofensa
vegetação	vegetal/planta/flora
curva	rio
comerciar	comércio/mercantilismo/comercialismo
chutar	esporte
átomo	ciências_físicas/fisica/física/física/quimica/química
valência	quimica/química
transacionar	comércio/mercantilismo/comercialismo
passear	esporte
batida	beisebol/basebol
amoldar	arte
microorganismo	vegetal/planta/flora/besta/criatura/ser/bicho/animal
colorido	fotografia
astúcia	industria/comércio/negócio/empresa
simetria	ciência_exacta/matematica/matemática/ciências_exactas
sagacidade	industria/comércio/negócio/empresa
raptar	crime/ofensa
parasita	vegetal/planta/flora
gelar	ciências_físicas/fisica/física/física
esquiar	esporte
crónica	história/história
amputar	remédio/prática_da_medicina/medicina/incisão/medicina
amanhar	cultivo/pecuária/agricultura