ser	estar/ser
ter	incluir/abarcar/conter/dispõe/apresenta/ter/vivenciar/experimentar/experienciar/experimentar/ter/passar_por/produzir/fazer/sofrer/doer
eleger	seleccionar/escolher/selecionar/seleccionar/escolher/selecionar
assumir	antecipar
tornar	virar/mudar/tornar/alterar/mudar/alterar/mudar
passar	transmitir/dar/transferir/oferecer/dar_de_presente/dar/regalar/entregar/ganhar_terreno/viajar/ir/caminhar/andar/viajar/ir/caminhar/andar/viajar/ir/caminhar/andar
fazer	conduzir/dirigir/fazer/agir/atuar/fazer/agir/atuar/aparecer_como/parecer/plantar/cultivar/amanhar/fazer/provocar/causar/recriar/recriar/fazer/causar/provocar/criar/fazer/causar/provocar/criar/fazer/causar/provocar/criar/mudar/modificar/alterar/atuar/comportar-se/agir/parecer
deixar	prover/dar/passar/entregar/ceder/dar/oferecer/dar_de_presente/dar/regalar/entregar/partir/sair/ir/deslocar/mexer/mover/concordar/aprovar/consentir/aceitar/induzir/mudar/modificar/alterar/alterar/mudar
participar	fazer/agir/atuar
poder	gastar/despender
exercer	trabalhar/usar/utilizar/empregar
realizar	satisfazer/conseguir/atingir/ser_bem_sucedido/suceder/provocar/produzir/ocasionar/efetuar/realizar/efetuar/levar_a_cabo/executar/atingir/cumprir/fazer/causar/provocar/criar/conhecer/saber/entender/terminar/acabar/encerrar/finalizar
estar	estar/ser/estar/ser/virar/mudar/tornar
nascer	virar/mudar/tornar
promover	suportar/ajudar/apoiar/delegar/aconselhar/sugerir/propor
nomear	classificar/rotular
permanecer	estar/ser/estar/ser/fazer/agir/atuar
ocupar	trabalhar/interessar/atacar/assaltar
obter	conseguir/atingir/ser_bem_sucedido/suceder/receber/obter/comprar/adquirir/receber/obter/comprar/adquirir/alterar/mudar
iniciar	fazer/provocar/causar/discutir/iniciar/começar
votar	seleccionar/escolher/selecionar
criar	fazer/agir/atuar/fazer/provocar/causar/criar/produzir/fazer/construir/fazer/causar/provocar/criar
partir	partir/sair/ir/partir/sair/ir/partir/sair/ir/deslocar/mover/deslocar/mexer/mover/deslocar/mexer/mover/alterar/mudar/alterar/mudar
dar	conduzir/dirigir/prover/suprir/abastecer/fornecer/causar/provocar/dar/passar/entregar/ceder/dar/transferir/transferir/oferecer/dar_de_presente/dar/regalar/entregar/oferecer/dar_de_presente/dar/regalar/entregar/dar/entregar/dar/entregar/fazer/causar/provocar/criar/servir/fornecer/prover/provisionar/abastecer/informar/contar
apresentar	representar/mostrar/apresentar/recriar/mencionar/citar/aludir/falar/contar/dizer/informar
formar	construir/confeccionar/fabricar/mudar/modificar/alterar
voltar	trazer/tirar/transportar/levar
chegar	estar/ser/vir
defender	evitar/impedir/atrapalhar/defender
receber	receber/obter/comprar/adquirir/alterar/mudar/alterar/mudar
substituir	renovar/substituir/mudar/modificar/alterar
aprovar	responder/reagir/julgar/avaliar/balizar
publicar	criar/produzir/fazer/construir
tomar	agarrar/pegar/tomar/ingerir/tomar/consumir/ingerir/tomar/consumir
vir	vir/viajar/ir/caminhar/andar
considerar	sentir/experimentar/achar/avaliar/prever/prognosticar/predizer/considerar/achar/considerar/ver/achar/pensar/achar/pensar
manter	estar/ser/ter/ter/ter/manter/guardar/segurar/reter/dar/entregar/sentir/experimentar/teimar/insistir/achar/considerar/ver/desativar/desabilitar/incapacitar
ficar	passar/estar/ser/estar/ser/estar/ser/virar/mudar/tornar
lançar	deslocar/mover/deslocar/mover/propulsionar/propulsar/tocar/impulsionar
atuar	recriar
falecer	virar/mudar/tornar
afirmar	declarar
dever	estar/ser
declarar	falar/contar/dizer/julgar/avaliar/balizar
propor	representar/declarar
transferir	passar/entregar/ceder/dar/deslocar/mover
levar	estar/estar/deslocar/mover
concluir	terminar/finalizar/concluir/encerrar/terminar/finalizar/concluir/encerrar/mudar/modificar/alterar
reunir	associar-se/juntar-se/filiar_se/afiliar_se/ingressar/adicionar/somar/acrescentar/acrescer
afastar	conservar/reter/manter/deslocar/mover
trabalhar	trabalhar/manusear/manejar/manipular/transformar/transubstanciar/transmudar
ir	estar/estar/ganhar_terreno/ir/viajar/andar/viajar/ir/caminhar/andar/viajar/ir/caminhar/andar/viajar/ir/caminhar/andar/viajar/ir/caminhar/andar/viajar/ir/caminhar/andar/viajar/ir/caminhar/andar/acontecer/ocorrer/suceder/passar
liderar	conduzir/dirigir
ocorrer	acontecer/ocorrer/suceder/passar
acabar	parar/terminar/finalizar/cessar/encerrar/acabar/terminar/finalizar/concluir/encerrar/terminar/finalizar/concluir/encerrar/terminar/finalizar/concluir/encerrar
representar	fazer/representar/atuar/figurar/representar/recriar/falar/contar/dizer/verbalizar/exprimir/proferir/expressar
fundar	pioneirar/ser_pioneiro/empreender/iniciar
decidir	seleccionar/escolher/selecionar/terminar/finalizar/concluir/encerrar
organizar	cuidar/guiar/lidar/organizar/solicitar/pedir/requerer/requisitar/ordenar/arrumar/organizar
indicar	significar/querer_dizer/indicar/informar/contar/passar/transmitir/informar/informar
retornar	trazer/tirar/transportar/levar
começar	fazer/agir/atuar/iniciar/começar
seguir	provar/resultar/fazer/agir/atuar/perseguir/viajar/ir/caminhar/andar/viajar/ir/caminhar/andar
encontrar	receber/obter/comprar/adquirir/receber/obter/comprar/adquirir
estabelecer	representar/pioneirar/ser_pioneiro/empreender/iniciar
ligar	engajar/engatar/ligar/prender/fixar
tentar	fazer/agir/atuar/estimular/excitar/emocionar/comover/julgar/avaliar/balizar
permitir	prover/dar/dar/entregar/deixar/permitir/consentir/concordar/aprovar/consentir/aceitar
casar	reunir/unificar
enviar	transferir/transmitir/trazer/enviar/embarcar/despachar/transportar/trazer/expedir/deslocar/mover/deslocar/mover/transmitir
contar	estar/ser/recitar/verbalizar/exprimir/proferir/expressar/achar/determinar/informar/informar
servir	passar/realizar/satisfazer/cumprir/servir/bastar/ser_suficiente/estar/ser/trabalhar/trabalhar/dar/entregar/operar/funcionar/servir/fornecer/prover/provisionar/abastecer/servir/fornecer/prover/provisionar/abastecer
armar	prover/suprir/abastecer/fornecer
prever	informar/contar
continuar	estar/estar/ser/estar/ser/fazer/agir/atuar/viajar/ir/caminhar/andar
renunciar	passar/entregar/ceder/dar/rejeitar
procurar	fazer/agir/atuar/ver/examinar/inspecionar/buscar/procurar
constituir	representar/pioneirar/ser_pioneiro/empreender/iniciar
dirigir	governar/reger/cuidar/guiar/lidar/viajar/ir/caminhar/andar/mirar/apontar/direcionar
pedir	elicitar/provocar/incitar/estimular/concitar/pedir/requisitar/requerer/solicitar/pedir/requerer/requisitar
manifestar	mostrar/apresentar/passar/transmitir
marcar	caracterizar/qualificar/caraterizar/conter/limitar/restringir/mudar/modificar/alterar
escolher	resolver/decidir/seleccionar/escolher/selecionar/seleccionar/escolher/selecionar/seleccionar/escolher/selecionar
dedicar	usar/utilizar/empregar
instalar	colocar/carregar/botar/pôr/colocar/carregar/botar/pôr
chamar	classificar/rotular/telecomunicar/impetrar/mandar/intimar/ordenar
destinar	planejar
provocar	aporrinhar/chatear/importunar/irritar/vexar/incomodar/molestar/perturbar/aborrecer/amolar/agastar/estimular/excitar/emocionar/comover/elicitar/provocar/incitar/estimular/concitar/fazer/provocar/causar/fazer/causar/provocar/criar/fazer/causar/provocar/criar
ver	ver/prestar_atenção/dar_atenção/divisar/avistar/observar/mirar/olhar/ver/observar/mirar/olhar/ver/aperceber/entender/perceber/aperceber-se/aperceber/entender/perceber/aperceber-se/conjeturar/pensar/imaginar/conjecturar/achar/pensar/checar/conferir
abrir	desfazer/virar/mudar/tornar
comandar	conduzir/dirigir
aceitar	estar/ser/topar/aceitar/receber/obter/comprar/adquirir/receber/receber/deixar/permitir/consentir/responder/reagir/julgar/avaliar/balizar/terminar/finalizar/concluir/encerrar
anunciar	jogar/falar/contar/dizer/mostrar/anunciar/informar/contar/informar
compor	representar/representar/verbalizar
dizer	significar/querer_dizer/indicar/verbalizar/exprimir/proferir/expressar/verbalizar/exprimir/proferir/expressar/transmitir/comunicar/transmitir/comunicar
impedir	evitar/impedir/atrapalhar
elaborar	explicar
colocar	deslocar/mover/colocar/carregar/botar/pôr/colocar/carregar/botar/pôr/colocar/carregar/botar/pôr/prender/fixar/cobrir/tampar/vestir/vestir-se/arrumar-se
incluir	incluir/abarcar/conter/achar/considerar/ver/adicionar/somar/acrescentar/acrescer
adotar	seleccionar/escolher/selecionar
conceder	alocar/dar/entregar/dar/entregar/dar/entregar/dar/entregar/admitir/confessar/reconhecer/acordar/concordar
acompanhar	associar/viajar/ir/caminhar/andar
resultar	resultar/redundar/seguir/suceder/sobrevir/provar/resultar/estar/ser
desenvolver	desenvolver/progredir/aumentar/crescer/alterar/mudar
atingir	conseguir/atingir/ser_bem_sucedido/suceder/receber/obter/comprar/adquirir/receber/obter/comprar/adquirir/provocar/produzir/ocasionar/efetuar/tocar/bater/terminar/acabar/encerrar/finalizar/afetar/impactar
prender	anexar/juntar/unir/anexar/juntar/unir/segurar/agarrar/capturar/pegar/desativar/desabilitar/incapacitar
sair	partir/sair/ir/partir/sair/ir/partir/sair/ir/deslocar/mexer/mover/alterar/mudar
encerrar	terminar/finalizar/concluir/encerrar/mudar/modificar/alterar
investigar	pesquisar/investigar/examinar
sediar	amparar/abrigar
escrever	verbalizar/delinear/traçar/transmitir/comunicar
divulgar	mostrar/anunciar/informar/contar
tratar	cuidar/guiar/lidar/interagir/iniciar/abordar/encetar
transformar	forjar/formar/modelar/moldar/mudar/modificar/alterar/mudar/modificar/alterar/mudar/modificar/alterar/alterar/mudar
sofrer	estar/ser/experimentar/ter/passar_por/sofrer/sentir/experimentar/alterar/mudar
depor	declarar
efetivar	fazer/agir/atuar
alcançar	estar/conseguir/atingir/ser_bem_sucedido/suceder
convidar	interagir/estimular/excitar/emocionar/comover/pedir/requisitar/requerer/solicitar/pedir/requerer/requisitar/solicitar/pedir/requerer/requisitar
pronunciar	julgar/declarar
retirar	tirar/remover/retirar/tirar/remover/retirar
combater	disputar/lutar/brigar
convocar	impetrar/mandar/intimar/ordenar
solicitar	solicitar/pedir/requerer/requisitar
parecer	combinar/corresponder/concordar/estar/ser/estar/ser
evitar	evitar/impedir/atrapalhar
perder	abandonar/usar/utilizar/empregar
surgir	parecer
caber	servir/ficar/caber/estar/ser/vestir/vestir-se/arrumar-se
aumentar	crescer/subir/aumentar/crescer/mudar_a_dimensão/acrescer/acrescentar/crescer/aumentar/aumentar/ampliar/progredir/mudar/modificar/alterar
negar	manter/guardar/segurar/reter
prestar	dar/entregar
recusar	responder/reagir
exigir	exigir/demandar/solicitar/pedir/requerer/requisitar
viajar	viajar/viajar/ir/caminhar/andar/viajar/ir/caminhar/andar
entregar	passar/entregar/ceder/dar/passar/entregar/ceder/dar/passar/entregar/ceder/dar/transferir/transferir/oferecer/dar_de_presente/dar/regalar/entregar/oferecer/dar_de_presente/dar/regalar/entregar/dar/entregar/dar/entregar/dar/entregar/pegar/transmitir/trazer
discutir	discutir/conversar/falar/proferir/falar/dizer/verbalizar/conversar
auxiliar	suportar/ajudar/apoiar
suceder	provar/resultar/acontecer/ocorrer/suceder/passar
conquistar	atuar/comportar-se/agir/parecer
apontar	mirar/apontar/direcionar/significar/querer_dizer/indicar/informar
mudar	jogar_fora/substituir/alterar/mudar/alterar/mudar/alterar/mudar/vestir/vestir-se/arrumar-se
mostrar	expor/apresentar/exibir/mostrar/mostrar/apresentar/mostrar/apresentar/passar/transmitir/indicar/assinalar/informar/informar/informar
reduzir	reduzir/diminuir/reduzir/diminuir/reduzir/diminuir/mudar/modificar/alterar
abandonar	cessar/acabar/parar/terminar/desistir/finalizar/deixar/descontinuar/passar/entregar/ceder/dar/descartar/jogar_fora/alterar/mudar
decretar	resolver/decidir
fixar	anexar/juntar/unir
ampliar	mudar/modificar/alterar
ganhar	receber/obter/comprar/adquirir/receber/obter/comprar/adquirir/receber/obter/comprar/adquirir/receber/obter/comprar/adquirir
cumprir	satisfazer/provocar/produzir/ocasionar/efetuar/realizar/efetuar/levar_a_cabo/executar/atingir/cumprir/terminar/acabar/encerrar/finalizar
opor	refutar/rebater
preparar	construir/confeccionar/fabricar/fazer/causar/provocar/criar/leccionar/instruir/ensinar/lecionar/mudar/modificar/alterar
desempenhar	realizar/efetuar/levar_a_cabo/executar/atingir/cumprir/recriar
terminar	parar/terminar/finalizar/cessar/encerrar/acabar/terminar/finalizar/concluir/encerrar/terminar/finalizar/concluir/encerrar/terminar/finalizar/concluir/encerrar/mudar/modificar/alterar
autorizar	deixar/permitir/consentir
reconhecer	apreciar/valorizar/determinar/lembrar-se/lembrar/recordar/recordar-se
buscar	ver/examinar/inspecionar
apurar	pesquisar/investigar/examinar
encabeçar	conduzir/dirigir
resolver	entender/compreender/comprender/terminar/finalizar/concluir/encerrar/melhorar/aperfeiçoar
implantar	prender/fixar
responder	falar/contar/dizer
romper	dividir/separar
sugerir	declarar/informar/contar
obrigar	forçar/obrigar/compelir/induzir
suspender	pendurar/terminar/finalizar/concluir/encerrar/terminar/finalizar/concluir/encerrar/terminar/finalizar/concluir/encerrar
editar	criar/produzir/fazer/construir
construir	fazer/causar/provocar/criar/fazer/causar/provocar/criar
gerar	fazer/causar/provocar/criar
rejeitar	responder/reagir/julgar/avaliar/balizar
ameaçar	ser/existir
julgar	julgar/declarar/achar/considerar/ver/julgar/avaliar/balizar/calcular/computar/raciocinar/cogitar/pensar/refletir
oferecer	fazer/agir/atuar/dar/entregar
comprometer	usar/utilizar/empregar
denominar	classificar/rotular
lutar	disputar/lutar/brigar
informar	informar/transmitir/comunicar
estender	estar/estar/deformar/estressar/tensionar
revelar	mostrar/apresentar/informar/contar
pôr	deslocar/mover/colocar/carregar/botar/pôr/colocar/carregar/botar/pôr/colocar/carregar/botar/pôr/vestir/vestir-se/arrumar-se
lecionar	informar
referir	conectar/associar/relacionar
conduzir	cuidar/guiar/lidar/cuidar/guiar/lidar/fazer/agir/atuar/deslocar/mover/portar/mudar/modificar/alterar
transmitir	interagir/transmitir/dar/enviar/passar/entregar/ceder/dar/deslocar/mover/deslocar/mover/informar/contar/transmitir/comunicar
contribuir	pagar/dar/entregar/mudar/modificar/alterar
fechar	virar/mudar/tornar
firmar	acordar/concordar
desligar	ligar
conter	incluir/abarcar/conter/incluir/abarcar/conter/limitar/controlar/refrear/negar
admitir	topar/aceitar/transferir/transmitir/trazer/admitir/confessar/reconhecer/deixar/permitir/consentir/deixar/permitir/consentir/achar/avaliar/prever/prognosticar/predizer/considerar
controlar	deter/moderar/coibir/serenar/conter/entravar/manusear/manejar/manipular
dispor	gastar/despender/colocar/carregar/botar/pôr/providenciar/arranjar
aderir	juntar/grudar/tocar/encostar
canalizar	governar/reger
limitar	limitar/controlar/refrear/limitar/controlar/refrear/deter/moderar/coibir/serenar/conter/entravar/reduzir/diminuir
dividir	expulsar/receber/obter/comprar/adquirir/deslocar/mover/dividir/separar/partir/usar/utilizar/empregar/calcular/computar/mudar/mudar/alterar/mudar
atribuir	conceder/lidar/entregar/julgar/avaliar/balizar
identificar	determinar
pagar	pagar/pagar/pagar/dar/entregar
beneficiar	receber/obter/comprar/adquirir
querer	ansiar/desejar/querer/ansiar/desejar/querer/ansiar/desejar/querer/ansiar/desejar/querer/ansiar/desejar/querer/ansiar/desejar/querer
completar	mudar/modificar/alterar
viver	estar
causar	fazer/causar/provocar/criar/fazer/causar/provocar/criar
produzir	plantar/cultivar/amanhar/fazer/provocar/causar/fazer/causar/provocar/criar
adquirir	receber/obter/comprar/adquirir/receber/obter/comprar/adquirir/alterar/mudar/atuar/comportar-se/agir/parecer
deter	manter/guardar/segurar/reter/desativar/desabilitar/incapacitar
pertencer	caber_a/pertencer/estar/estar/ser/estar/ser
usar	usar/utilizar/empregar/ingerir/tomar/consumir/vestir/vestir-se/arrumar-se
caracterizar	diferenciar/distinguir/pensar/lembrar
aplicar	cobrir/tampar/usar/utilizar/empregar
registrar	protocolar/registar/registrar/guardar/preservar/conservar/manter/poupar/registar/registrar/escrever/redigir/indicar/assinalar
acumular	colocar/carregar/botar/pôr/acrescer/acrescentar/crescer/aumentar
sustentar	ter/sentir/experimentar/teimar/insistir
reivindicar	solicitar/pedir/requerer/requisitar/solicitar/pedir/requerer/requisitar
funcionar	operar/funcionar/operar/funcionar/exercer/servir
entender	conhecer/saber/entender/entender/compreender/comprender/entender/compreender/comprender/entender/compreender/comprender/entender/compreender/comprender
demonstrar	mostrar/apresentar/passar/transmitir/revalidar/corroborar/provar/confirmar/suportar/sustentar/substanciar
unir	juntar/unir/ligar/reunir/juntar/unir/ligar/reunir/juntar/unir/ligar/reunir/adicionar/somar/acrescentar/acrescer
concordar	igualar/equivaler/combinar/corresponder/concordar/acordar/concordar/responder/reagir
trazer	mostrar/apresentar/deslocar/mover/deslocar/mover/mudar/modificar/alterar
abrigar	prover/suprir/abastecer/fornecer
possuir	dispõe/apresenta
intensificar	acrescer/acrescentar/crescer/aumentar
comunicar	interagir/enviar
delegar	responsabilizar/nomear
aproximar	calcular/computar
relacionar	estar/ser/interagir/raciocinar/cogitar/pensar/refletir
prosseguir	fazer/agir/atuar/viajar/ir/caminhar/andar/acontecer/ocorrer/suceder/passar
significar	significar/querer_dizer/indicar/significar/passar/transmitir
montar	ascender/subir/viajar/ir/caminhar/andar/acasalar/copular
ajudar	suportar/ajudar/apoiar/servir/fornecer/prover/provisionar/abastecer
pressionar	tocar/bater
estimular	suportar/ajudar/apoiar/elicitar/provocar/incitar/estimular/concitar/afetar/afectar
elevar	deslocar/mover/estimular/excitar/emocionar/comover/aumentar/ampliar/progredir
regulamentar	resolver/decidir
concentrar	raciocinar/cogitar/pensar/refletir
sentar	colocar/carregar/botar/pôr
fortalecer	mudar/modificar/alterar
remover	tirar/remover/retirar/tirar/remover/retirar
efetuar	conseguir/atingir/ser_bem_sucedido/suceder/fazer/agir/atuar/fazer/agir/atuar/fazer/provocar/causar/provocar/produzir/ocasionar/efetuar/terminar/acabar/encerrar/finalizar
vender	estar/ser/trocar
morrer	virar/mudar/tornar
praticar	executar/fazer/desempenhar
explicar	informar
esperar	fazer/agir/atuar/ansiar/desejar/querer/ansiar/desejar/querer/ansiar/desejar/querer/antecipar
derrubar	virar-se/tornar-se/virar/cortar/dividir
atacar	disputar/lutar/brigar/afetar/impactar
falar	iniciar/abordar/encetar/proferir/falar/dizer/verbalizar/conversar/verbalizar/exprimir/proferir/expressar/verbalizar/exprimir/proferir/expressar/leccionar/instruir/ensinar/lecionar/transmitir/comunicar/transmitir/comunicar/transmitir/comunicar
circular	viajar/ir/caminhar/andar
desejar	ansiar/desejar/querer/ansiar/desejar/querer/ansiar/desejar/querer/ansiar/desejar/querer/ansiar/desejar/querer/ansiar/desejar/querer/verbalizar/exprimir/proferir/expressar
superar	elicitar/provocar/incitar/estimular/concitar
governar	governar/reger
operar	manusear/manejar/manipular/tratar
crescer	crescer/subir/desenvolver/progredir/mudar_a_dimensão/acrescer/acrescentar/crescer/aumentar
concretizar	fazer/causar/provocar/criar
financiar	dar/entregar
restabelecer	renovar
introduzir	anexar/juntar/unir/falar/contar/dizer/informar
aparecer	surgir/aparecer
associar	raciocinar/cogitar/pensar/refletir
ordenar	organizar/arranjar/dispor/pedir/requisitar/requerer
interromper	fazer/agir/atuar/interromper/suspender/parar/terminar/finalizar/concluir/encerrar/terminar/finalizar/concluir/encerrar/terminar/finalizar/concluir/encerrar
executar	penalizar/punir/castigar/provocar/produzir/ocasionar/efetuar/o_fazendeiro_matou_um_porco_para_o_natal./matar/o_fazendeiro_matou_um_porco_para_o_natal./matar/terminar/acabar/encerrar/finalizar
cogitar	raciocinar/cogitar/pensar/refletir
classificar	denominar/designar/julgar/avaliar/balizar/categorizar
baixar	deslocar/mover/viajar/ir/caminhar/andar/mudar/modificar/alterar
comprar	estar/ser/receber/obter/comprar/adquirir
recomendar	aconselhar/sugerir/propor
escolar	lustrar/refinar/polir
acrescentar	mudar_a_dimensão/acrescer/acrescentar/crescer/aumentar
aproveitar	vivenciar/experimentar/experienciar/usar/utilizar/empregar
acontecer	acontecer/ocorrer/suceder/passar
convencer	influir/influenciar/persuadir
prometer	estar/ser/declarar/declarar
possibilitar	prover/dar
empenhar	consignar
agravar	mudar/modificar/alterar
redigir	transmitir/comunicar
situar	deslocar/mover/colocar/carregar/botar/pôr
posicionar	colocar/carregar/botar/pôr
levantar	deslocar/mover/descansar/repousar/colocar/carregar/botar/pôr/mencionar/citar/aludir
precisar	estar/ser
investir	gastar/despender
cometer	fazer/agir/atuar
recorrer	acontecer/ocorrer/suceder/passar
fornecer	prover/dar/prover/suprir/abastecer/fornecer/dar/entregar/dar/entregar
avaliar	julgar/avaliar/balizar/calcular/computar/raciocinar/cogitar/pensar/refletir
prorrogar	adiar/alongar
acreditar	aceitar
gastar	gastar/despender/pagar/pagar
acelerar	fazer/agir/atuar/apressar/correr/viajar/ir/caminhar/andar/aprofundar/intensificar
proferir	transmitir/comunicar
observar	checar/conferir
embarcar	deslocar/mover
facilitar	ajudar/assistir/auxiliar/socorrer/solidarizar_se/acorrer
acentuar	exprimir/expressar/mostrar
conferir	examinar/analizar
figurar	conjeturar/pensar/imaginar/conjecturar
ceder	transferir/oferecer/dar_de_presente/dar/regalar/entregar/dar/entregar
deslocar	deslocar/mover
forçar	forçar/obrigar/compelir/deslocar/mover/prender/fixar/induzir
recuperar	receber/obter/comprar/adquirir/melhorar
protestar	opor
dissolver	mudar
valer	estar/ser
ferir	indispor/doer/ferir/aleijar/machucar
enfatizar	exprimir/expressar/mostrar
misturar	unificar/amalgamar/misturar/unificar/amalgamar/misturar/adicionar/somar/acrescentar/acrescer/mudar/mudar/modificar/alterar
desistir	cessar/acabar/parar/terminar/desistir/finalizar/deixar/descontinuar/passar/entregar/ceder/dar
achar	receber/obter/comprar/adquirir/conceber/conceitualizar/antecipar/achar/pensar/julgar/avaliar/balizar
cobrar	cobrar/calcular/contar/computar/contabilizar
mandar	transferir/transmitir/trazer/pedir/requisitar/requerer
liberar	passar/entregar/ceder/dar
impetrar	pedir/requisitar/requerer
atrair	elicitar/provocar/incitar/estimular/concitar
sentir	aperceber/entender/perceber/aperceber-se
lograr	vitimar/victimizar
depender	estar/ser
pregar	anexar/juntar/unir
planejar	achar/avaliar/prever/prognosticar/predizer/considerar/pretender/raciocinar/cogitar/pensar/refletir
ler	indicar/assinalar/compreender/entender/compreender/entender
reagir	fazer/agir/atuar/atuar/comportar-se/agir/parecer
lembrar	dar/legar/entregar/passar/deixar/pensar/lembrar
diminuir	reduzir/diminuir/reduzir/diminuir/desabar/decrescer/minguar/diminuir/desabar/decrescer/minguar/diminuir/mudar/modificar/alterar
abranger	incluir/abarcar/conter
refletir	raciocinar/cogitar/pensar/refletir
qualificar	servir/bastar/ser_suficiente/pensar/lembrar
suplementar	anexar/juntar/unir
questionar	dirigir-se/ruminar/ponderar/cogitar/especular/contemplar/refletir
resistir	fazer/agir/atuar/portar/defender/resistir/lutar/brigar/opor_se
matar	o_fazendeiro_matou_um_porco_para_o_natal./matar
engajar	adquirir/obter/deslocar/mover/interessar
corresponder	igualar/equivaler/combinar/corresponder/concordar
antecipar	julgar/avaliar/balizar
empreender	fazer/provocar/causar
restringir	limitar/controlar/refrear/limitar/controlar/refrear/reduzir/diminuir
consultar	perguntar/indagar
administrar	cuidar/guiar/lidar/tratar
excluir	expulsar
esclarecer	explicar/informar
durar	medir
expor	mostrar/apresentar/explicar
inspirar	estimular/excitar/emocionar/comover
explorar	usar/utilizar/empregar/usar/utilizar/empregar
imprimir	criar/produzir/fazer/construir
absolver	pronunciar/julgar/rotular
compreender	incluir/abarcar/conter/conhecer/saber/entender/entender/compreender/comprender/entender/compreender/comprender/entender/compreender/comprender
preservar	manter/guardar/segurar/reter/cozinhar/preparar
afetar	afetar/impactar/mudar/modificar/alterar/mudar/modificar/alterar
mencionar	conectar/associar/relacionar
atravessar	passar/atravessar/ir/caminhar/andar/viajar/ir/caminhar/andar/deslocar/mexer/mover/perfurar/furar
alertar	avisar/alertar/advertir/informar
proceder	fazer/agir/atuar
pensar	imaginar/imaginar/antecipar/julgar/avaliar/balizar
trocar	trocar/transferir/jogar_fora/substituir/mudar/modificar/alterar/vestir/vestir-se/arrumar-se
ouvir	aperceber/entender/perceber/aperceber-se/aperceber/entender/perceber/aperceber-se
importar	estar/ser
proclamar	proferir/falar/dizer/verbalizar/conversar
proporcionar	prover/dar
empregar	adquirir/obter/usar/utilizar/empregar
juntar	reunir/unificar/juntar/unir/ligar/reunir/juntar/unir/ligar/reunir/juntar/unir/ligar/reunir/unir/juntar
aguardar	fazer/agir/atuar/ansiar/desejar/querer
cair	descer/baixar/cair/viajar/ir/caminhar/andar/separar/descolar/desgrudar/expirar/morrer/bater_as_botas/falecer/comer_capim_pela_raiz/perecer/mudar/modificar/alterar
somar	acrescer/acrescentar/crescer/aumentar
cobrir	realizar/satisfazer/cumprir/cobrir/tampar/cobrir/tampar/tocar/encostar/iniciar/abordar/encetar
avançar	delegar/viajar/ir/caminhar/andar/desenvolver/progredir
expressar	passar/transmitir
ultrapassar	ganhar_terreno
interessar	elicitar/provocar/incitar/estimular/concitar
reiterar	fazer/agir/atuar/informar/contar
interpretar	entender/compreender/comprender
traduzir	entender/compreender/comprender/mudar/modificar/alterar
solucionar	entender/compreender/comprender
influenciar	afetar/impactar
descobrir	mostrar/apresentar/conceber/conceitualizar
dispensar	dar/entregar/tratar
repetir	fazer/agir/atuar/soltar/emitir/informar/contar/acontecer/ocorrer/suceder/passar
desaparecer	deslocar/mexer/mover/desaparecer/sumir
advertir	informar
converter	substituir/mudar/modificar/alterar
adiar	adiar/esperar/reter/aguardar
relatar	mostrar/anunciar/informar
invadir	atacar/assaltar
assistir	suportar/ajudar/apoiar
pesar	estar/ser
enfraquecer	enfraquecer/desabar/decrescer/minguar/diminuir/mudar/modificar/alterar/mudar/modificar/alterar
perceber	aperceber/entender/perceber/aperceber-se
assassinar	o_fazendeiro_matou_um_porco_para_o_natal./matar
melhorar	aperfeiçoar/perfazer/melhorar/aperfeiçoar/melhorar/melhorar/virar/mudar/tornar/mudar/modificar/alterar
depositar	dar/entregar
unificar	associar-se/juntar-se/filiar_se/afiliar_se/ingressar/mudar/modificar/alterar
requerer	estar/ser/exigir/demandar/solicitar/pedir/requerer/requisitar
elogiar	estimar/avaliar/medir
devolver	trazer/tirar/transportar/levar
cercar	atacar/assaltar
contornar	tocar/encostar
respeitar	achar/considerar/ver
reclamar	proferir/falar/dizer/verbalizar/conversar/solicitar/pedir/requerer/requisitar
fugir	escapar/evadir-se/fugir/escapulir/escapar/fugir/partir/sair/ir
aprofundar	acrescer/acrescentar/crescer/aumentar
prolongar	alongar
alinhar	situar/posicionar
internar	transferir/transmitir/trazer
outorgar	causar/provocar/dar/alocar/dar/entregar/dar/entregar
alimentar	prover/suprir/abastecer/fornecer/servir/fornecer/prover/provisionar/abastecer
apreender	segurar/agarrar/capturar/pegar
traçar	marcar
surpreender	fazer/agir/atuar
proteger	defender
acertar	tocar/bater/virar/mudar/tornar/mudar/modificar/alterar
quebrar	dividir/separar/partir/dividir/separar
absorver	interessar
acolher	amparar/abrigar
conservar	manter/guardar/segurar/reter/cozinhar/preparar/preservar/conservar
confiar	passar/entregar/ceder/dar/deixar/permitir/consentir
privar	reter/conter
influir	afetar/impactar
despertar	virar/mudar/tornar
perseguir	perseguir/viajar/ir/caminhar/andar
neutralizar	o_fazendeiro_matou_um_porco_para_o_natal./matar
aconselhar	declarar
destruir	arruinar/destroçar/estraçalhar/destruir
comissionar	passar/entregar/ceder/dar
celebrar	celebrar/reunir/encontrar
cuidar	governar/reger/cuidar/guiar/lidar
abordar	discutir
contrair	experimentar/ter/passar_por/estreitar/apertar/desabar/decrescer/minguar/diminuir
escapar	escapar/evadir-se/fugir/escapulir/escapar/fugir/partir/sair/ir
enquadrar	representar
tirar	deslocar/mover/cerrar/fechar/tirar/remover/tirar/remover/retirar/tirar/remover/retirar/tirar/remover/retirar/tirar/remover/retirar/tirar/remover/retirar
ocasionar	fazer/provocar/causar
conciliar	acordar/concordar
sufocar	o_fazendeiro_matou_um_porco_para_o_natal./matar
consagrar	usar/utilizar/empregar
evidenciar	informar/contar/informar
reverter	alterar/mudar
apreciar	passar/transmitir/achar/considerar/ver
incumbir	passar/entregar/ceder/dar
assinalar	informar
adaptar	alterar/variar/mudar/modificar
fundir	forjar/formar/modelar/moldar/dissolver/modelar/formar/mudar
fracassar	mudar
correr	fazer/agir/atuar/manar/fluir/correr/manar/fluir/correr/apressar/correr/acelerar/apressar/despachar-se/apressar-se/passar/passar/atravessar/correr/viajar/ir/caminhar/andar/deslocar/mexer/mover
batizar	denominar/chamar/nomear
morar	estar/morar/habitar/povoar/viver
bater	soar/ressoar/fazer/soar/ressoar/fazer/soar/ressoar/fazer/empurrar/propulsionar/deslocar/mover/deslocar/mover/deslocar/mexer/mover/deslocar/mexer/mover/propulsionar/propulsar/tocar/impulsionar/acertar/bater/golpear/cerrar/fechar/bater/colidir/atingir/tocar/bater/tocar/bater/tocar/bater
remeter	transmitir/pegar/transmitir/trazer
obedecer	obedecer/confromar-se/adequar-se/ajustar/adaptar-se
comparar	estar/ser/examinar/analizar
separar	expulsar/deslocar/mover/deslocar/mexer/mover/partir/dividir/separar/identificar/reconhecer/mudar/mudar/mudar/alterar/mudar
desmentir	representar
espalhar	continuar/estender/lançar/separar/partir/viajar/ir/caminhar/andar/derramar/desaguar
arrecadar	cobrar
inscrever	protocolar/registar/registrar
compensar	pagar/combinar
reintegrar	pagar
necessitar	estar/ser
conceber	imaginar
centrar	raciocinar/cogitar/pensar/refletir
apressar	fazer/agir/atuar/viajar/ir/caminhar/andar/viajar/ir/caminhar/andar/aprofundar/intensificar
marchar	ir/caminhar/andar
provar	estar/ser/ingerir/tomar/consumir/informar
tramitar	interagir
ignorar	tratar/rejeitar
diferenciar	caracterizar/qualificar/caraterizar/distinguir/separar/diferenciar/identificar/reconhecer
contemplar	observar/mirar/olhar/ver/observar/mirar/olhar/ver/raciocinar/cogitar/pensar/refletir
descartar	livrar/rejeitar
estimar	adivinhar/aproximar/julgar/avaliar/chutar/estimar/julgar/avaliar/balizar/calcular/computar
cortar	cortar/dividir/cortar/dividir/separar/descolar/desgrudar
saudar	acostar/cumprimentar/transmitir/comunicar
inserir	anexar/juntar/unir
atrasar	adiar
atenuar	melhorar/aperfeiçoar
gozar	usar/utilizar/empregar
distinguir	caracterizar/qualificar/caraterizar/distinguir/separar/diferenciar/identificar/reconhecer
combinar	igualar/equivaler/interagir/unificar/amalgamar/misturar/adicionar/somar/acrescentar/acrescer/mudar
ascender	ascender/subir/viajar/ir/caminhar/andar
expandir	explicar/aumentar/crescer/aumentar/crescer
esvaziar	virar/mudar/tornar/mudar/modificar/alterar
caminhar	ir/caminhar/andar/ir/caminhar/andar/viajar/ir/caminhar/andar/viajar/ir/caminhar/andar
doar	pagar/dar/entregar
encarar	estar/observar/mirar/olhar/ver/virar-se/tornar-se/virar
corrigir	tornar/inverter/virar/reverter/mudar/modificar/alterar
transportar	deslocar/mover/deslocar/mover/deslocar/mover
sobreviver	fazer/agir/atuar
refutar	renunciar/repudiar
expedir	deslocar/mover
subir	ascender/subir/ascender/subir/viajar/ir/caminhar/andar/crescer/subir/aumentar/crescer
descrever	explicar/informar
assentar	colocar/carregar/botar/pôr/virar/mudar/tornar
experimentar	ingerir/tomar/consumir/alterar/mudar/pôr/usar/colocar/caber/vestir
delinear	marcar
avisar	informar
repudiar	rejeitar
expulsar	deslocar/mover
estreitar	mudar/modificar/alterar/alterar/mudar
averiguar	pesquisar/investigar/examinar
difundir	lançar
desfrutar	usar/utilizar/empregar
livrar	passar/entregar/ceder/dar
liquidar	pagar/custear/o_fazendeiro_matou_um_porco_para_o_natal./matar
exibir	mostrar/apresentar
calcular	raciocinar
derivar	resultar/redundar/seguir/suceder/sobrevir
agitar	deslocar/mover/deslocar/mover/deslocar/mover/deslocar/mexer/mover/deslocar/mexer/mover
aperfeiçoar	aperfeiçoar/perfazer/melhorar/aperfeiçoar/mudar/modificar/alterar
reproduzir	criar/produzir/fazer/construir/criar/produzir/fazer/construir/fazer/causar/provocar/criar
estacionar	manobrar/guiar/canalizar/dirigir/colocar/carregar/botar/pôr
esquecer	perder
vitimar	maltratar/injustiçar
valorizar	achar/considerar/ver
inocentar	pronunciar/julgar/rotular
equilibrar	combinar
impulsionar	deslocar/mover
exaltar	estimular/excitar/emocionar/comover/enaltecer/louvar/elogiar
confessar	admitir/confessar/reconhecer/admitir/confessar/reconhecer
inclinar	inclinar/debruçar/torcer/dobrar/curvar/vergar
conversar	dialogar/conversar/dialogar/falar/proferir/falar/dizer/verbalizar/conversar/transmitir/comunicar
suprir	prover/suprir/abastecer/fornecer/prover/suprir/abastecer/fornecer/dar/entregar/servir/fornecer/prover/provisionar/abastecer
selecionar	resolver/decidir
declinar	desabar/decrescer/minguar/diminuir
compartilhar	fazer/agir/atuar/usar/utilizar/empregar/transmitir/comunicar
ensinar	informar
custar	exigir/requisitar/requerer/precisar/demandar/exigir/requisitar/requerer/precisar/demandar/estar/ser
resumir	reduzir/diminuir
penetrar	entrar
lamentar	afligir-se/magoar/sofrer/sentir/experimentar
atestar	informar
rechaçar	deslocar/mover
perguntar	dirigir-se/transmitir/comunicar/ruminar/ponderar/cogitar/especular/contemplar/refletir
custear	pagar
andar	viajar/viajar/ir/caminhar/andar/viajar/ir/caminhar/andar/viajar/ir/caminhar/andar/viajar/ir/caminhar/andar/viajar/ir/caminhar/andar
poupar	manter/guardar/segurar/reter
esconder	disfarçar/mascarar/esconder/encobrir/esconder/encobrir/omitir/tampar/tapar/acobertar/ocultar/esconder/encobrir/omitir/tampar/tapar/acobertar/ocultar
confundir	constrangir/envergonhar/embaraçar/elicitar/provocar/incitar/estimular/concitar
amparar	prover/suprir/abastecer/fornecer
intimar	pedir/requisitar/requerer
gerir	governar/reger/cuidar/guiar/lidar
direcionar	mirar/apontar/direcionar
medir	estar/ser/resolver/decidir/julgar/avaliar/balizar
instruir	informar/leccionar/instruir/ensinar/lecionar/impetrar/mandar/intimar/ordenar
institucionalizar	transferir/transmitir/trazer
emprestar	dar/entregar/mudar/modificar/alterar
colher	ajuntar/coletar/coligir/reunir/recolher/juntar/ajuntar/coletar/coligir/reunir/recolher/juntar
regularizar	arranjar/dispor/resolver/decidir
defrontar	estar
recriar	fazer/causar/provocar/criar/fazer/causar/provocar/criar
bastar	realizar/satisfazer/cumprir
protocolar	registar/registrar
evoluir	desenvolver/progredir
avistar	aperceber/entender/perceber/aperceber-se
adequar	alterar/variar/mudar/modificar
abater	cortar/dividir/desabar/decrescer/minguar/diminuir
totalizar	estar/ser
providenciar	prover/dar/acordar/concordar
preceder	falar/contar/dizer
guardar	ter/manter/guardar/segurar/reter/sentir/experimentar/checar/conferir
explodir	expressar_sentimentos/separar/dividir/desmoronar
reter	evitar/impedir/atrapalhar/fazer/agir/atuar/negar/ter/manter/guardar/segurar/reter/manter/guardar/segurar/reter/desativar/desabilitar/incapacitar
distanciar	conservar/reter/manter
cruzar	criar/reproduzir/dobrar
congelar	solidificar/virar/mudar/tornar/sofrer/padecer
agradar	estar/ser
jogar	propulsionar/propulsar/tocar/impulsionar/alinhar/apostar/jogar/jogar/competir/concorrer
desdobrar	operar/funcionar/desfazer/deformar
torturar	angustiar/doer/machucar
seqüestrar	tomar/capturar/pegar
minimizar	reduzir/diminuir
manipular	manusear/tocar
supor	antecipar/antecipar/antecipar/resolver/solucionar
persistir	continuar/manter/preservar
girar	girar/virar/virar-se/tornar-se/virar/deslocar/mexer/mover
reger	governar/reger
ajustar	servir/ficar/caber/mudar/modificar/alterar/alterar/variar/mudar/modificar
exprimir	passar/transmitir/transmitir/comunicar
acrescer	mudar_a_dimensão/acrescer/acrescentar/crescer/aumentar
premiar	alocar
exortar	aconselhar/avisar/opinar/assessorar
forjar	forjar/formar/modelar/moldar/forjar/formar/modelar/moldar/construir/confeccionar/fabricar/forjar/transformar
fabricar	pensar/inventar/fazer/causar/provocar/criar
emendar	melhorar/aperfeiçoar
dobrar	virar-se/tornar-se/virar/dobrar/dobrar/deformar
satisfazer	satisfazer/combinar/corresponder/concordar/servir/fornecer/prover/provisionar/abastecer
recrutar	protocolar/registar/registrar/engajar/empregar/enlistar
parar	cessar/acabar/parar/terminar/desistir/finalizar/deixar/descontinuar/interromper/suspender/parar/terminar/finalizar/concluir/encerrar
finalizar	terminar/finalizar/concluir/encerrar/terminar/finalizar/concluir/encerrar/terminar/finalizar/concluir/encerrar/mudar/modificar/alterar
aliviar	ajudar/assistir/auxiliar/socorrer/solidarizar_se/acorrer/melhorar/aperfeiçoar
resgatar	tirar/remover/retirar
inverter	alterar/mudar
emergir	ascender/subir
redundar	provar/resultar
reconquistar	receber/obter/comprar/adquirir
rebater	renunciar/repudiar
erguer	deslocar/mover/colocar/carregar/botar/pôr
enumerar	achar/determinar
endereçar	iniciar/abordar/encetar
acenar	gesticular
sepultar	esconder/encobrir/omitir/tampar/tapar/acobertar/ocultar
restituir	pagar
dispersar	separar/partir
alugar	receber/obter/comprar/adquirir
tocar	soar/ressoar/fazer/deslocar/mover/deslocar/mover/apresentar/fazer/desempenhar/tocar/bater
irradiar	aparecer_como/parecer
equiparar	julgar/considerar/pensar/mudar/modificar/alterar
cultivar	lustrar/refinar/polir
consumir	gastar/despender/ingerir/tomar/consumir
arrastar	tirar/puxar/arredar
ditar	proclamar
atirar	propulsionar/propulsar/tocar/impulsionar/ferir/lesar/machucar/lesionar
reconciliar	acordar/concordar
expirar	virar/mudar/tornar
consignar	confidenciar/incumbir/comissionar/entregar/confiar
soltar	deslocar/mover/verbalizar/exprimir/proferir/expressar
indagar	transmitir/comunicar
deteriorar	avariar/danificar/decair/piorar
carregar	dispõe/apresenta/deslocar/mover/deslocar/mover/encher/carregar/transportar/levar/carregar/completar/encher/completar/encher/mudar/modificar/alterar
ponderar	ruminar/ponderar/cogitar/especular/contemplar/refletir/raciocinar/cogitar/pensar/refletir
oscilar	deslocar/mexer/mover
adoecer	decair/piorar
telefonar	telecomunicar
especular	antecipar/raciocinar/raciocinar/cogitar/pensar/refletir
equipar	prover/suprir/abastecer/fornecer
capturar	agarrar/pegar/tomar/agarrar/pegar/tomar/segurar/agarrar/capturar/pegar/jogar
aparelhar	prover/suprir/abastecer/fornecer
suportar	deixar/permitir/consentir
narrar	informar
manobrar	governar/reger
desativar	mudar/modificar/alterar
demandar	solicitar/pedir/requerer/requisitar
agilizar	aprofundar/intensificar
virar	virar-se/tornar-se/virar/virar-se/tornar-se/virar/virar-se/tornar-se/virar/deslocar/mover/deslocar/mexer/mover/deslocar/mexer/mover/alterar/mudar/alterar/mudar
imaginar	imaginar/fazer/causar/provocar/criar
estourar	falhar/acabar/morrer/separar/dividir/desmoronar
animar	alegrar-se/regozijar-se/regozijar/alegrar/estimular/excitar/emocionar/comover/estimular/excitar/emocionar/comover/afetar/afectar
alçar	deslocar/mover
agradecer	passar/transmitir
transcrever	escrever
minar	explorar
lidar	governar/reger/cuidar/guiar/lidar/fazer/agir/atuar/fazer/agir/atuar/dar/entregar/iniciar/abordar/encetar
desalojar	tirar/remover/retirar
debilitar	enfraquecer
crer	aceitar/crer/acreditar
amenizar	melhorar/aperfeiçoar/desabar/decrescer/minguar/diminuir/alterar/mudar
abortar	terminar/finalizar/concluir/encerrar
vislumbrar	observar/mirar/olhar/ver
prover	prover/suprir/abastecer/fornecer/dar/entregar/dar/entregar
ensaiar	executar/fazer/desempenhar/julgar/avaliar/balizar
perturbar	fazer/agir/atuar/parecer/impressionar/comover/afetar/elicitar/provocar/incitar/estimular/concitar
gerenciar	cuidar/guiar/lidar
errar	viajar/ir/caminhar/andar
desafiar	convidar/pedir
compatibilizar	combinar/corresponder/concordar
coletar	cobrar
apertar	agarrar/segurar/tocar/bater/mudar/modificar/alterar/alterar/mudar
protelar	adiar
indenizar	pagar
encobrir	esconder/encobrir/omitir/tampar/tapar/acobertar/ocultar/esconder/encobrir/omitir/tampar/tapar/acobertar/ocultar
disfarçar	esconder/encobrir/omitir/tampar/tapar/acobertar/ocultar
chocar	bater/colidir/atingir
apagar	ligar/tirar/remover
socorrer	suportar/ajudar/apoiar
enterrar	esconder/encobrir/omitir/tampar/tapar/acobertar/ocultar
desmontar	descer/baixar/cair
consentir	concordar/aprovar/consentir/aceitar/responder/reagir
confinar	desativar/desabilitar/incapacitar/reduzir/diminuir
pressupor	antecipar
gostar	achar/considerar/ver
encorajar	suportar/ajudar/apoiar/exaltar/animar/inspirar/induzir
desmantelar	tirar/remover/retirar
abastecer	dar/entregar/dar/entregar
indispor	mudar/modificar/alterar
discriminar	distinguir/separar/diferenciar
descer	viajar/ir/caminhar/andar
conflagrar	virar/mudar/tornar
apostar	apostar/jogar/jogar
alarmar	avisar/alertar/advertir
vagar	viajar/ir/caminhar/andar/viajar/ir/caminhar/andar/viajar/ir/caminhar/andar
manufaturar	pensar/inventar
desvalorizar	humilhar/rebaixar/mortificar/aviltar
cindir	dividir/separar/partir
amadurecer	desenvolver/progredir/amadurecer
acordar	melhorar/aperfeiçoar/virar/mudar/tornar
acomodar	satisfazer/estabilizar-se
queimar	falhar/acabar/morrer/avariar/danificar/virar/mudar/tornar/mudar/tratar
plantar	colocar/carregar/botar/pôr/colocar/carregar/botar/pôr
imputar	julgar/avaliar/balizar
partilhar	receber/obter/comprar/adquirir/usar/utilizar/empregar
ofender	provocar/magoar/ofender/elicitar/provocar/incitar/estimular/concitar
irritar	aporrinhar/chatear/importunar/irritar/vexar/incomodar/molestar/perturbar/aborrecer/amolar/agastar/piorar/exacerbar/agravar
inspecionar	ver/examinar/inspecionar
falsificar	recriar
erradicar	o_fazendeiro_matou_um_porco_para_o_natal./matar
assustar	estimular/excitar/emocionar/comover
progredir	viajar/ir/caminhar/andar/desenvolver/progredir/aumentar/crescer/mudar/modificar/alterar
pesquisar	examinar/analizar
perfazer	melhorar/aperfeiçoar
enaltecer	estimar/avaliar/medir
adicionar	estar/ser/acrescer/acrescentar/crescer/aumentar/mudar/modificar/alterar
tolerar	deixar/permitir/consentir
retratar	fazer/representar/atuar
pegar	passar/anexar/juntar/unir/agarrar/pegar/tomar/agarrar/pegar/tomar/segurar/agarrar/capturar/pegar/alterar/mudar
improvisar	executar/fazer/desempenhar
harmonizar	combinar/corresponder/concordar
alocar	lotear/atribuir
subornar	pagar
repousar	estar/ser/estar_situado/jazer/estar_deitado
olhar	observar/mirar/olhar/ver/aperceber/entender/perceber/aperceber-se/checar/conferir
intimidar	estimular/excitar/emocionar/comover
incorrer	alterar/mudar
hospedar	amparar/abrigar
habitar	estar/ser/existir
desorganizar	desordenar/bagunçar
cumprimentar	vir/acostar/cumprimentar
atrapalhar	evitar/impedir/atrapalhar
assemelhar	parecer/assemelhar-se/assemelhar-se_a/assemelhar/combinar/corresponder/concordar
treinar	limitar/controlar/refrear/leccionar/instruir/ensinar/lecionar/leccionar/instruir/ensinar/lecionar/lustrar/refinar/polir
ousar	fazer/agir/atuar/fazer/agir/atuar
desenhar	figurar/representar
colar	anexar/juntar/unir/juntar/grudar/tocar/encostar
alienar	passar/entregar/ceder/dar/providenciar/arranjar
sinalizar	colocar/carregar/botar/pôr/informar/contar
retrucar	falar/contar/dizer
exacerbar	mudar/modificar/alterar
dialogar	dialogar/falar/transmitir/comunicar
desfilar	ir/caminhar/andar
validar	revalidar/corroborar/provar/confirmar/suportar/sustentar/substanciar
testar	julgar/avaliar/balizar
delimitar	conter/limitar/restringir
cantar	proferir/falar/dizer/verbalizar/conversar
anotar	registar/registrar
sequestrar	tomar/capturar/pegar
sacar	tirar/remover/retirar/tirar/remover/retirar/tirar/remover/retirar
piorar	decair/piorar/decair/piorar/virar/mudar/tornar/mudar/modificar/alterar
educar	leccionar/instruir/ensinar/lecionar/lustrar/refinar/polir
despachar	enviar/embarcar/despachar/transportar/trazer/expedir/deslocar/mover/transmitir/o_fazendeiro_matou_um_porco_para_o_natal./matar
atropelar	ferir/lesar/machucar/lesionar
arriscar	ser/existir/procurar/tentar/procurar/tentar
voar	ir/viajar/andar/viajar/ir/caminhar/andar/controlar/operar
vestir	alterar/mudar/vestir/vestir-se/arrumar-se
subverter	mudar/modificar/alterar
recompensar	pagar
anexar	juntar/unir/ligar/reunir/anexar/juntar/unir
rodar	girar/virar/deslocar/mover/viajar/ir/caminhar/andar
retificar	tornar/inverter/virar/reverter
repartir	mudar
reinar	governar/reger
rebaixar	deslocar/mover/humilhar/rebaixar/mortificar/aviltar/provocar/magoar/ofender
pintar	figurar/representar/criar/fazer/cobrir/revestir
fragmentar	separar/dividir/desmoronar
edificar	fazer/causar/provocar/criar
desconsiderar	tratar/rejeitar
computar	raciocinar
testemunhar	informar
sonhar	aperceber/entender/perceber/aperceber-se
reapresentar	informar/contar
postergar	adiar
portar	dispõe/apresenta
persuadir	influir/influenciar/induzir/persuadir
oficiar	exercer/servir
louvar	enaltecer/louvar/elogiar/estimar/avaliar/medir
gritar	proferir/falar/dizer/verbalizar/conversar/gritar/urrar/berrar
encetar	discutir
cadastrar	indicar/assinalar
afundar	descer/baixar/cair/descer/baixar/cair/deslocar/mover
solidificar	mudar
relaxar	virar/mudar/tornar/virar/mudar/tornar
refinar	melhorar/aperfeiçoar
mexer	deslocar/mover/deslocar/mover
ironizar	tratar
inundar	cobrir
entravar	evitar/impedir/atrapalhar
endurecer	mudar/modificar/alterar/alterar/mudar/atuar/comportar-se/agir/parecer
desculpar	conceder
confidenciar	passar/entregar/ceder/dar
colorir	adornar/ornamentar/decorar/enfeitar/ornar/embelezar/empetecar/alterar/mudar
assaltar	disputar/lutar/brigar
arruinar	malograr/fracassar/falhar/quebrar_a_cara/arruinar/destroçar/estraçalhar/destruir
acercar	vir
trancar	prender/fixar
tombar	expirar/morrer/bater_as_botas/falecer/comer_capim_pela_raiz/perecer
sitiar	atacar/assaltar
reportar	mostrar/anunciar/mostrar/anunciar
rasgar	dividir/separar/partir
perdoar	conceder
materializar	acontecer/ocorrer/suceder/passar
jurar	declarar
guiar	governar/reger/governar/reger/deslocar/mover
fotografar	registar/registrar
foragir	escapar/evadir-se/fugir
focar	focar/centrar/concentrar/raciocinar/cogitar/pensar/refletir
empurrar	forçar/empurrar/deslocar/mover/deslocar/mover
desobrigar	passar/entregar/ceder/dar
colidir	bater/colidir/atingir/tocar/bater
circunscrever	reduzir/diminuir
auferir	receber/obter/comprar/adquirir/receber/obter/comprar/adquirir
atrever	fazer/agir/atuar/fazer/agir/atuar
assediar	aporrinhar/chatear/importunar/irritar/vexar/incomodar/molestar/perturbar/aborrecer/amolar/agastar
segurar	ter/manter/guardar/segurar/reter/agarrar/pegar/tomar/segurar/agarrar/capturar/pegar/segurar/agarrar/capturar/pegar
reparar	melhorar/aperfeiçoar
perpetrar	fazer/agir/atuar
mentir	desinformar/enganar
lesar	doer/ferir/aleijar/machucar
enganar	vitimar/victimizar/informar
dizimar	o_fazendeiro_matou_um_porco_para_o_natal./matar
convir	combinar/corresponder/concordar
balizar	raciocinar/cogitar/pensar/refletir
admirar	observar/mirar/olhar/ver
acorrer	suportar/ajudar/apoiar
acender	virar/mudar/tornar
provisionar	dar/entregar
meter	acasalar/copular
legar	oferecer/dar_de_presente/dar/regalar/entregar
insultar	provocar/magoar/ofender
habituar	mudar/modificar/alterar
golpear	tocar/bater/tocar/bater
galgar	ascender/subir
fortificar	mudar/modificar/alterar
falir	avariar/danificar
enxergar	aperceber/entender/perceber/aperceber-se
enraizar	estabilizar-se
empunhar	manusear/manejar/manipular
elucidar	explicar
dormir	estar_situado/jazer/estar_deitado/repousar/descansar/cochilar/dormir
dissipar	esbanjar/desperdiçar/dilapidar/delapidar
degolar	o_fazendeiro_matou_um_porco_para_o_natal./matar
danificar	mudar/modificar/alterar
comer	acasalar/copular/comer/ingerir/tomar/consumir/ingerir/tomar/consumir/ingerir/tomar/consumir
coagir	forçar/obrigar/compelir
atar	prender/fixar/prender/fixar/deter/manter/prender/confinar/reter/anexar/juntar/unir/ligar/amarrar/atar/conectar
amanhecer	alterar/mudar
afrouxar	mudar/modificar/alterar
afigurar	conjeturar/pensar/imaginar/conjecturar
acessar	encontrar/reconquistar/recuperar/reganhar/re-adquirir
varrer	deslocar/mexer/mover/deslocar/mexer/mover/assear/limpar/purgar
sobrevir	provar/resultar
simular	reproduzir/atuar/fingir
revestir	cobrir/tampar/cobrir/tampar
presentear	alocar
lucrar	receber/obter/comprar/adquirir
logar	acessar
incomodar	aporrinhar/chatear/importunar/irritar/vexar/incomodar/molestar/perturbar/aborrecer/amolar/agastar
imitar	parecer/assemelhar-se/assemelhar-se_a/assemelhar/reproduzir
fretar	receber/obter/comprar/adquirir
fracionar	mudar
esposar	reunir/unificar/seleccionar/escolher/selecionar
encher	expandir-se/dilatar-se/virar/mudar/tornar/mudar/modificar/alterar/mudar/modificar/alterar
embalar	cobrir/tampar
contaminar	mudar/modificar/alterar
compelir	forçar/obrigar/compelir/induzir
balear	o_fazendeiro_matou_um_porco_para_o_natal./matar
afugentar	deslocar/mover
acoplar	juntar/unir/ligar/reunir
viciar	mudar/modificar/alterar
vacilar	adiar
rolar	deslocar/mexer/mover/achatar/aplainar/enxugar
retribuir	pagar
proliferar	aumentar/crescer
povoar	estar
pilotar	controlar/operar
modelar	forjar/formar/modelar/moldar/construir/confeccionar/fabricar/mudar/modificar/alterar
limpar	esfregar/tirar/remover/retirar/tirar/remover/retirar/mudar/modificar/alterar/mudar/modificar/alterar/mudar/modificar/alterar/cuidar-se/limpar/lavar
humilhar	provocar/magoar/ofender
furar	causar_dor/doer/cortar/dividir/perfurar/furar/traspassar/perfurar/penetrar
filmar	registar/registrar
escoar	esvaziar
desobstruir	mudar/modificar/alterar
degradar	humilhar/rebaixar/mortificar/aviltar/decair/piorar
deduzir	manter/guardar/segurar/reter/calcular/computar
curvar	virar-se/tornar-se/virar/virar-se/tornar-se/virar/deformar
confeccionar	fazer/causar/provocar/criar
codificar	codificar
arrepender	sentir/experimentar
aquecer	mudar/modificar/alterar/mudar/modificar/alterar/alterar/mudar
apanhar	ajuntar/coletar/coligir/reunir/recolher/juntar/jogar
aniquilar	o_fazendeiro_matou_um_porco_para_o_natal./matar
amarrar	prender/fixar/deter/manter/prender/confinar/reter/anexar/juntar/unir/ligar/amarrar/atar/conectar
amainar	desabar/decrescer/minguar/diminuir
alongar	alongar/aumentar/ampliar/progredir/estressar/tensionar
alojar	morar/habitar/povoar/viver
sacudir	oscilar/deslocar/mexer/mover/mover_involuntariamente/mover_reflexivamente/mover_involuntariamente
ridicularizar	zombar/ironizar/menosprezar
revistar	ver/examinar/inspecionar
presumir	antecipar
pontuar	exprimir/expressar/mostrar/adicionar/somar/acrescentar/acrescer
naufragar	descer/baixar/cair
mirar	checar/conferir
lotear	conceder/lidar/entregar
largar	deslocar/mover/alterar/mudar
iludir	vitimar/victimizar
igualar	mudar/modificar/alterar
florescer	desenvolver/progredir/aumentar/crescer
exercitar	executar/fazer/desempenhar
estremecer	agitar/sacudir/tremer/tremular/tiritar/estremecer/tremer/mover_involuntariamente/mover_reflexivamente/mover_involuntariamente
emocionar	parecer/impressionar/comover/afetar/elicitar/provocar/incitar/estimular/concitar
desordenar	mudar/modificar/alterar
descansar	estar/ser/estar_situado/jazer/estar_deitado
desaguar	distribuir/disseminar/espalhar
deformar	alterar/mudar
decair	decair/piorar/virar/mudar/tornar
conectar	prender/fixar/raciocinar/cogitar/pensar/refletir
avizinhar	vir
atritar	tocar/encostar
atemorizar	estimular/excitar/emocionar/comover
asfixiar	o_fazendeiro_matou_um_porco_para_o_natal./matar
ansiar	ansiar/desejar/querer
amortizar	liquidar/terminar_de_pagar
abreviar	reduzir/diminuir
urgir	aconselhar/sugerir/propor/aconselhar/avisar/opinar/assessorar
subtrair	calcular/computar
submergir	deslocar/mover/cobrir/tampar
semear	colocar/carregar/botar/pôr
rotular	anexar/juntar/unir/denominar/designar/julgar/declarar
reputar	achar/pensar
refrear	deter/moderar/coibir/serenar/conter/entravar
personificar	fazer/representar/atuar
perfurar	entrar/cortar/dividir/perfurar/furar/traspassar/perfurar/penetrar
padecer	sofrer/doer
molhar	mudar/modificar/alterar
lavar	assear/limpar/purgar/cuidar-se/limpar/lavar
iluminar	iluminar-se/iluminar/alterar/mudar
devastar	o_fazendeiro_matou_um_porco_para_o_natal./matar
desvirtuar	mudar/modificar/alterar
despender	pagar
corromper	pagar/mudar/modificar/alterar
confabular	dialogar/conversar/dialogar/conversar
chorar	expressar_sentimentos
cavar	cortar/dividir/tirar/remover/retirar
arranjar	colocar/carregar/botar/pôr/acordar/concordar
aparentar	estar/ser
amortecer	mudar/modificar/alterar
aglomerar	acrescer/acrescentar/crescer/aumentar
vasculhar	revistar/procurar/buscar
tolher	evitar/impedir/atrapalhar
sucumbir	dar/entregar
replicar	falar/contar/dizer
quantificar	exprimir/transmitir
puxar	deslocar/mover/ferir/lesar/machucar/lesionar
prefaciar	falar/contar/dizer
perseverar	continuar/manter/preservar
perecer	virar/mudar/tornar
namorar	associar
moldar	forjar/formar/modelar/moldar/construir/confeccionar/fabricar/modelar/formar
mascarar	esconder/encobrir/omitir/tampar/tapar/acobertar/ocultar
manchar	mudar/modificar/alterar
inventar	pensar/inventar/imaginar
incapacitar	mudar/modificar/alterar
hierarquizar	julgar/avaliar/balizar
fluir	manar/fluir/correr/deslocar/mexer/mover
esterilizar	operar
espionar	checar/conferir
escavar	explorar/tirar/remover/retirar
engolir	ingerir/tomar/consumir
encurtar	reduzir/diminuir/diminuir/reduzir
drenar	esvaziar/evaziar
despejar	prover/suprir/abastecer/fornecer
desmoronar	separar/desintegrar/mudar/mudar
desintegrar	mudar
descongelar	liquefazer/liquidificar
degenerar	decair/piorar
curar	melhorar
copiar	parecer/assemelhar-se/assemelhar-se_a/assemelhar/reproduzir/fazer/causar/provocar/criar
conglomerar	acrescer/acrescentar/crescer/aumentar
comprimir	estreitar/apertar
batalhar	disputar/lutar/brigar
afogar	o_fazendeiro_matou_um_porco_para_o_natal./matar/expirar/morrer/bater_as_botas/falecer/comer_capim_pela_raiz/perecer
soterrar	esconder/encobrir/omitir/tampar/tapar/acobertar/ocultar
soar	soar/ressoar/fazer/soar/ressoar/fazer/aparecer_como/parecer
pisar	viajar/ir/caminhar/andar
picar	causar_dor/doer
molestar	aporrinhar/chatear/importunar/irritar/vexar/incomodar/molestar/perturbar/aborrecer/amolar/agastar
mesclar	unificar/amalgamar/misturar
inferir	resolver/solucionar
impelir	aconselhar/avisar/opinar/assessorar
impactar	mudar/modificar/alterar
fumar	ingerir/tomar/consumir
fender	mudar
exasperar	encolerizar/enraivecer/irar/zangar
estrangular	o_fazendeiro_matou_um_porco_para_o_natal./matar
esfriar	mudar/modificar/alterar/atuar/comportar-se/agir/parecer
escutar	obedecer/aperceber/entender/perceber/aperceber-se/aperceber/entender/perceber/aperceber-se
engordar	virar/mudar/tornar/mudar/modificar/alterar
devotar	usar/utilizar/empregar
desembolsar	pagar
denotar	informar/contar/significar
deitar	colocar/carregar/botar/pôr
dançar	deslocar/mexer/mover/deslocar/mexer/mover
condensar	reduzir/diminuir
chutar	propulsionar/propulsar/tocar/impulsionar/golpear/bater/calcular/computar
bradar	proferir/falar/dizer/verbalizar/conversar
botar	deslocar/mover
beber	ingerir/tomar/consumir/ingerir/tomar/consumir
aviltar	humilhar/rebaixar/mortificar/aviltar/provocar/magoar/ofender/mudar/modificar/alterar
atormentar	angustiar/doer/machucar
aterrorizar	estimular/excitar/emocionar/comover
asseverar	comportar-se/resistir/conduzir/declarar/teimar/insistir
amedrontar	estimular/excitar/emocionar/comover
alentar	exaltar/animar/inspirar
vistoriar	ver/examinar/inspecionar
verter	deslocar/mover
transacionar	interagir
torrar	gastar/despender
rodear	tocar/encostar
revolver	deslocar/mover
recontar	informar
ratear	soar/ressoar/fazer
posar	colocar/carregar/botar/pôr
perigar	ser/existir
passear	ir/caminhar/andar/ir/caminhar/andar
massacrar	o_fazendeiro_matou_um_porco_para_o_natal./matar/o_fazendeiro_matou_um_porco_para_o_natal./matar
macular	mudar/modificar/alterar
lixar	alisar
inter-relacionar	estar/ser
injustiçar	tratar
inflar	expandir-se/dilatar-se/expandir
inchar	expandir-se/dilatar-se/expandir
exultar	animar-se/alegrar-se/animar/alegrar
exaurir	indispor
esquentar	mudar/modificar/alterar/mudar/modificar/alterar/alterar/mudar
espremer	agarrar/segurar
enxugar	esfregar/modelar/formar/mudar/modificar/alterar
emboscar	atacar/assaltar
ecoar	soar/ressoar/fazer/soltar/emitir
desperdiçar	gastar/despender/usar/utilizar/empregar/esbanjar/desperdiçar/dilapidar/delapidar
desinfetar	assear/limpar/purgar
descontrair	virar/mudar/tornar
desconcertar	elicitar/provocar/incitar/estimular/concitar
descolar	partir/dividir/separar
derramar	prover/suprir/abastecer/fornecer/deslocar/mover/distribuir/disseminar/espalhar
consertar	emendar/reparar/consertar/melhorar/aperfeiçoar
civilizar	lustrar/refinar/polir
arremeter	correr
arrebentar	pular/saltar/separar/dividir/desmoronar
arranhar	tocar/encostar/ferir/lesar/machucar/lesionar
apear	descer/baixar/cair
amoldar	forjar/formar/modelar/moldar
aguerrir	disputar/lutar/brigar
abocanhar	agarrar/segurar
visualizar	conjeturar/pensar/imaginar/conjecturar
vergar	deformar
verbalizar	fazer/causar/provocar/criar/transmitir/comunicar
venerar	achar/considerar/ver
trucidar	o_fazendeiro_matou_um_porco_para_o_natal./matar
tremer	agitar/sacudir/tremer/tremular/tiritar/estremecer/tremer/deslocar/mexer/mover/tirar/puxar/arredar/mover_involuntariamente/mover_reflexivamente/mover_involuntariamente/mover_involuntariamente/mover_reflexivamente/mover_involuntariamente
transmutar	alterar/mudar
transmudar	mudar/modificar/alterar/mudar/modificar/alterar
transladar	deslocar/mover
transar	acasalar/copular
torcer	modelar/formar/deformar
sussurrar	soar/ressoar/fazer/proferir/falar/dizer/verbalizar/conversar
sujar	mudar/modificar/alterar
sugar	beber/tomar
remendar	emendar/reparar/consertar
reinvindicar	comportar-se/resistir/conduzir/teimar/insistir
refrescar	mudar/modificar/alterar
recitar	repetir/ecoar
raspar	cortar/tocar/bater/ferir/lesar/machucar/lesionar
raciocinar	raciocinar/cogitar/pensar/refletir
prezar	achar/considerar/ver
permutar	trocar
perambular	viajar/ir/caminhar/andar/viajar/ir/caminhar/andar
moer	fragmentar
mensurar	exprimir/transmitir/resolver/decidir
menosprezar	tratar/rejeitar
maquiar	cuidar-se
manejar	manusear/manejar/manipular/manusear/tocar
machucar	causar_dor/doer/desconcertar/perturbar/confundir/indispor/doer/ferir/aleijar/machucar
irar	encolerizar/enraivecer/irar/zangar/elicitar/provocar/incitar/estimular/concitar
glorificar	enaltecer/louvar/elogiar
fingir	atuar/fingir
extender	alongar/alongar
estragar	avariar/danificar/virar/mudar/tornar
esboroar	mudar
esbanjar	gastar/despender
entreter	entreter/divertir/socializar/sentir/experimentar
enrijecer	mudar/modificar/alterar
enlatar	preservar/conservar
enforcar	executar
encostar	estar/deslocar/mexer/mover
encolher	diminuir/reduzir/desabar/decrescer/minguar/diminuir
doer	estar/ser/aperceber/entender/perceber/aperceber-se/desconcertar/perturbar/confundir/indispor
divertir	entreter/divertir/socializar
dilapidar	gastar/despender
desprender	tirar/remover/retirar
desmarcar	tirar/remover
desinformar	informar
descerrar	informar/contar
desatar	desfazer
debruçar	torcer/dobrar/curvar/vergar
cozinhar	construir/confeccionar/fabricar/mudar
cochilar	estar_situado/jazer/estar_deitado/repousar/descansar/cochilar/dormir
catar	ajuntar/coletar/coligir/reunir/recolher/juntar
arredar	deslocar/mover
anuir	gesticular
angustiar	desconcertar/perturbar/confundir
amalgamar	mudar/modificar/alterar
agarrar	agarrar/pegar/tomar/segurar/agarrar/capturar/pegar/segurar/agarrar/capturar/pegar
afagar	tratar/afagar/tocar/bater
zangar	elicitar/provocar/incitar/estimular/concitar
tropeçar	ir/caminhar/andar
triturar	fragmentar
tremular	agitar/sacudir/tremer
topar	receber/obter/comprar/adquirir
tensionar	afetar/afectar
substanciar	fazer/causar/provocar/criar
subjazer	estar/ser
sorver	beber/tomar
serrar	cortar/dividir
secar	mudar/modificar/alterar/alterar/mudar
ruborizar	descolorir/colorir
rosar	descolorir/colorir
rir	expressar_sentimentos/zombar/ironizar/menosprezar
reverberar	soar/ressoar/fazer
resvalar	deslizar/passar_gradativamente_a/escorregar
regozijar	sentir/experimentar
refrigerar	mudar/modificar/alterar
raptar	tomar/capturar/pegar
pulular	zumbir/apinhar
piscar	reagir/agir_involuntariamente/agir_reflexivamente
perverter	mudar/modificar/alterar
pendurar	adornar/ornamentar/decorar/enfeitar/ornar/embelezar/empetecar/prender/fixar/prender/fixar
parir	produzir/fazer
palpitar	pulsar
palestrar	leccionar/instruir/ensinar/lecionar
ondular	deslocar/mexer/mover
nadar	viajar/ir/caminhar/andar/viajar/ir/caminhar/andar
murchar	desabar/decrescer/minguar/diminuir/desabar/decrescer/minguar/diminuir
morder	agarrar/segurar
minerar	explorar
mendigar	solicitar/pedir/requerer/requisitar
martelar	forjar/transformar
maltratar	tratar
magoar	sofrer/elicitar/provocar/incitar/estimular/concitar
lesionar	doer/ferir/aleijar/machucar
jazer	estar/estar/ser
guerrear	disputar/lutar/brigar
gesticular	transmitir/comunicar
gemer	chorar/choramingar
gelar	solidificar/mudar/modificar/alterar
ferver	reduzir/diminuir/virar/mudar/tornar
ferrar	malograr/fracassar/falhar/quebrar_a_cara
excitar	estimular/excitar/emocionar/comover/elicitar/provocar/incitar/estimular/concitar/afetar/afectar
estressar	afetar/afectar
estirar	ferir/lesar/machucar/lesionar
esticar	alongar/deformar/estressar/tensionar
esquiar	viajar/ir/caminhar/andar
escurecer	alterar/mudar
escorregar	deslizar/passar_gradativamente_a/escorregar/viajar/ir/caminhar/andar/viajar/ir/caminhar/andar
enraivecer	sentir/experimentar/elicitar/provocar/incitar/estimular/concitar
engravidar	fecundar/inseminar/fertilizar
enfurecer	encolerizar/enraivecer/irar/zangar
empalidecer	descolorir/colorir
embrulhar	cobrir/tampar
desnudar	limpar/retirar
deslizar	deslizar/passar_gradativamente_a/escorregar/deslocar/mover/viajar/ir/caminhar/andar/viajar/ir/caminhar/andar
deserdar	privar
desentranhar	tirar/remover/retirar
desamarrar	desfazer
desabrochar	desenvolver/progredir
desabilitar	mudar/modificar/alterar
depravar	mudar/modificar/alterar
depenar	jogar_fora
defraudar	vitimar/victimizar
curtir	celebrar
convalescer	melhorar
conjeturar	imaginar
comover	elicitar/provocar/incitar/estimular/concitar
cicatrizar	melhorar
chover	precipitar/cair/chover
chacinar	o_fazendeiro_matou_um_porco_para_o_natal./matar
buzinar	soar/ressoar/fazer
brocar	cortar/dividir
brilhar	estar/ser/iluminar-se/iluminar
berrar	proferir/falar/dizer/verbalizar/conversar
balancear	combinar
azedar	virar/mudar/tornar
aviar	enviar/embarcar/despachar/transportar/trazer/expedir
arrumar	organizar/arranjar/dispor/ordenar/arrumar/organizar
arder	sentir/experimentar
aplainar	modelar/formar
amputar	tirar/remover/retirar
alegrar	alegrar-se/regozijar-se/regozijar/alegrar/sentir/experimentar
aguentar	fazer/agir/atuar/deixar/permitir/consentir
aerotransportar	transportar/levar/carregar
adjudicar	causar/provocar/dar
aculturar	lustrar/refinar/polir
acovardar	torcer/dobrar/curvar/vergar
abalroar	deslocar/mover