país	província/estado
empresa	departamento/divisão
grupo	livro
criação	galáxia/nebulosa/via_láctea
lei	oficial_de_polícia/agente/polícia/guarda/policial
tribunal	júri/júri
aliança	aliado
coligação	aliado
companhia	elenco
família	genitor/mãe/pai/progenitor/parente/criança/menino/filho
pessoal	elenco/indivíduo/pessoa/alguém/ser_humano/alma
povo	cidadão/cidadã/pessoal/população/povo/gente/indivíduo/pessoa/alguém/ser_humano/alma
terra	província/estado
polícia	oficial_de_polícia/agente/polícia/guarda/policial
homem	pessoal/população/povo/gente
população	cidadão/cidadã/indivíduo/pessoa/alguém/ser_humano/alma
nação	província/estado
mundo	galáxia/nebulosa/via_láctea/pessoal/população/povo/gente
jogo	livro
corte	júri/júri
casamento	esposa/esposo/marido/cônjuge/cónjuge/consorte
mata	árvore
espécie	estirpe/cepa/variante/estirpe/cepa/variante
casal	esposa/esposo/marido/cônjuge/cónjuge/consorte
humanidade	pessoal/população/povo/gente
coalizão	aliado
floresta	árvore
gente	cidadão/cidadã/indivíduo/pessoa/alguém/ser_humano/alma
tabela	bicha/coluna
universo	galáxia/nebulosa/via_láctea
elenco	elenco
biologia	cobertura_vegetal/flora/vegetação
tripulação	equipe/tripulação/equipagem
tribo	parente
juizado	júri/júri
clã	parente
cosmo	galáxia/nebulosa/via_láctea
bosque	árvore
mitologia	mito/lenda/mito/lenda
familia	parente