ser	estar/ser/fazer/agir/atuar
com	adequar/ajustar/adaptar
ter	incluir/abarcar/conter/dispõe/apresenta/dispõe/apresenta/estar/ser/ter/receber/sofrer/experimentar/alterar/mudar/sofrer/doer
eleger	seleccionar/escolher/selecionar/seleccionar/escolher/selecionar
assumir	deslocar/mexer/mover/antecipar/alterar/mudar
tornar	deslocar/mover/tornar/ficar/estar/virar/mudar/tornar/deixar/fazer/alterar/mudar/alterar/mudar
passar	passar/conseguir/atingir/ser_bem_sucedido/suceder/delegar/transmitir/dar/obter/passar/entregar/ceder/dar/transferir/oferecer/dar_de_presente/dar/regalar/entregar/ganhar_terreno/viajar/ir/caminhar/andar/viajar/ir/caminhar/andar/viajar/ir/caminhar/andar/lançar/atirar/jogar/aplicar/colocar/transmitir/comunicar/julgar/avaliar/balizar/acontecer/ocorrer/suceder/passar/alterar/mudar
militar	influir/influenciar
fazer	chegar/totalizar/adicionar/representar/cometer/perpetrar/conduzir/dirigir/fazer/agir/atuar/fazer/agir/atuar/fazer/agir/atuar/receber/obter/comprar/adquirir/aparecer_como/parecer/plantar/cultivar/amanhar/apresentar/fazer/desempenhar/construir/confeccionar/fabricar/fazer/provocar/causar/realizar/efetuar/levar_a_cabo/executar/atingir/cumprir/criar/fazer/recriar/recriar/fazer/causar/provocar/criar/fazer/causar/provocar/criar/fazer/causar/provocar/criar/fazer/causar/provocar/criar/fazer/causar/provocar/criar/fazer/causar/provocar/criar/fazer/causar/provocar/criar/induzir/achar/considerar/ver/mudar/modificar/alterar/mudar/modificar/alterar/atuar/comportar-se/agir/parecer
deixar	consignar/prover/dar/passar/entregar/ceder/dar/oferecer/dar_de_presente/dar/regalar/entregar/deslocar/mexer/mover/fazer/provocar/causar/produzir/concordar/aprovar/consentir/aceitar/induzir/mudar/modificar/alterar/alterar/mudar
participar	estar/ser/fazer/agir/atuar
poder	gastar/despender
exercer	trabalhar/ter
realizar	satisfazer/conseguir/atingir/ser_bem_sucedido/suceder/vender/provocar/produzir/ocasionar/efetuar/pioneirar/ser_pioneiro/empreender/iniciar/realizar/efetuar/levar_a_cabo/executar/atingir/cumprir/fazer/causar/provocar/criar/conhecer/saber/entender/terminar/acabar/encerrar/finalizar/terminar/acabar/encerrar/finalizar
integrar	combinar/misturar/calcular/computar/virar/mudar/tornar
estar	durar/estar/ser/estar/ser/estar/ser/estar/ser/parecer/virar/mudar/tornar/ficar/permanecer/continuar/manter
nascer	virar/mudar/tornar
promover	suportar/ajudar/apoiar/promover/encorajar/estimular/delegar/aconselhar/sugerir/propor/enaltecer/louvar/elogiar
nomear	responsabilizar/nomear/estabelecer/fundar/constituir/classificar/rotular/denominar/chamar/nomear/significar/denotar/seleccionar/escolher/selecionar
permanecer	prosseguir/continuar/permanecer/seguir/estar/ser/estar/ser/estar/ser/fazer/agir/atuar/resistir
ocupar	estar/morar/habitar/povoar/viver/governar/reger/trabalhar/interessar/esgotar/gastar/despender/atacar/assaltar
obter	ser/existir/alcançar/atingir/efectuar/efetuar/realizar/obter/chegar_a/conseguir/atingir/ser_bem_sucedido/suceder/obter/obter/receber/obter/comprar/adquirir/receber/obter/comprar/adquirir/receber/obter/comprar/adquirir/alterar/mudar
iniciar	estar/ser/aceitar/admitir/fazer/provocar/causar/fazer/causar/provocar/criar/leccionar/instruir/ensinar/lecionar/discutir/determinar
votar	votar/seleccionar/escolher/selecionar/seleccionar/escolher/selecionar
criar	responsabilizar/nomear/fazer/agir/atuar/fazer/provocar/causar/criar/fazer/criar/fazer/fazer/causar/provocar/criar
partir	partir/deixar/sair/partir/deixar/sair/deslocar/mover/deslocar/mexer/mover/deslocar/mexer/mover/avariar/danificar/alterar/mudar/alterar/mudar/alterar/mudar
apoiar	suportar/ajudar/apoiar/colocar/carregar/botar/pôr/colocar/carregar/botar/pôr
filiar	determinar
dar	jazer/conduzir/dirigir/prover/suprir/abastecer/fornecer/causar/provocar/dar/causar/provocar/dar/conceder/lidar/entregar/passar/entregar/ceder/dar/passar/entregar/ceder/dar/transferir/transferir/oferecer/dar_de_presente/dar/regalar/entregar/oferecer/dar_de_presente/dar/regalar/entregar/oferecer/dar_de_presente/dar/regalar/entregar/dar/entregar/dar/entregar/dar/entregar/fazer/causar/provocar/criar/servir/fornecer/prover/provisionar/abastecer/falar/contar/dizer/informar/contar/dispensar/administrar
titular	mensurar/quantificar
apresentar	representar/mostrar/apresentar/recriar/recriar/falar/contar/dizer/proferir/falar/dizer/verbalizar/conversar/introduzir/apresentar/informar
formar	tornar_se/influir/influenciar/receber/construir/confeccionar/fabricar/fazer/causar/provocar/criar/mudar/modificar/alterar/alterar/mudar
chegar	ir/estender/levar/estar/ser/alcançar/atingir/efectuar/efetuar/realizar/obter/chegar_a/alcançar/atingir/efectuar/efetuar/realizar/obter/chegar_a/vir/aproximar-se_de/chegar/avizinhar/acercar/alcançar/chegar/vir/chegar/vir/chegar/vir/vir/imaginar/raciocinar/cogitar/pensar/refletir
defender	evitar/impedir/atrapalhar/defender/proteger/defender/proteger/defender/proteger/defender/proteger/defender/disputar/lutar/brigar/afirmar
receber	entreter/divertir/celebrar/receber/obter/comprar/adquirir/cumprimentar/saudar/achar/considerar/ver/aceitar/transformar/converter/transmudar/alterar/mudar/alterar/mudar
substituir	responsabilizar/nomear/trocar/substituir/mudar/modificar/alterar
aprovar	suportar/ajudar/apoiar/exprimir/expressar/mostrar/enaltecer/louvar/elogiar/autorizar/permitir/aceitar/julgar/avaliar/balizar
publicar	verbalizar
tomar	receber/obter/comprar/adquirir/traspassar/perfurar/penetrar/agarrar/pegar/tomar/beber/tomar/consumir/usar/ingerir/tomar/consumir/ingerir/tomar/consumir
vir	estar/resultar/redundar/seguir/suceder/sobrevir/estar/ser/estar/ser/ser/existir/vir/viajar/ir/caminhar/andar/acontecer/ocorrer/suceder/passar
considerar	observar/mirar/olhar/ver/sentir/experimentar/discutir/achar/considerar/ver/achar/considerar/ver/achar/pensar/achar/pensar/achar/pensar/achar/pensar/adivinhar/aproximar/julgar/avaliar/chutar/estimar/julgar/avaliar/balizar/examinar/analizar/ruminar/ponderar/cogitar/especular/contemplar/refletir
reeleger	eleger/escolher
manter	prosseguir/continuar/permanecer/seguir/conservar/reter/manter/estar/ser/esposar/adotar/adoptar/ter/ter/ter/ter/ter/ter/ter/manter/guardar/segurar/reter/dar/entregar/sentir/experimentar/produzir/fazer/defender/proteger/afirmar/asseverar/jurar/afirmar/registar/registrar/teimar/insistir/achar/considerar/ver/achar/pensar/desativar/desabilitar/incapacitar
ficar	continuar/permanecer/ficar/quedar/passar/estar/estar/ser/estar/ser/estar/ser/estar/ser/estar/ser/estar/ser/tornar/ficar/estar/virar/mudar/tornar/ficar/permanecer/continuar/manter/alterar/mudar
lançar	enviar/lançar/deslocar/mover/deslocar/mover/deslocar/mover/propulsionar/propulsar/tocar/impulsionar/propulsionar/propulsar/tocar/impulsionar/propulsionar/propulsar/tocar/impulsionar/lançar/atirar/jogar/lançar/atirar/jogar/lançar/atirar/jogar/lançar/atirar/jogar/lançar/atirar/jogar/registar/registrar/verbalizar/exprimir/proferir/expressar/transmitir/comunicar/iniciar/começar/principiar
atuar	fazer/representar/atuar/apresentar/fazer/desempenhar/executar/fazer/desempenhar/recriar/exercer/servir
concorrer	competir/concorrer
falecer	desaparecer/sumir/virar/mudar/tornar
afirmar	reinvindicar/manter/sustentar/asseverar/afirmar/asseverar/jurar/afirmar/asseverar/jurar/afirmar/asseverar/jurar/afirmar
conseguir	conseguir/atingir/ser_bem_sucedido/suceder/conseguir/atingir/ser_bem_sucedido/suceder/receber/obter/comprar/adquirir/resolver/solucionar
dever	estar/ser
declarar	jogar/reinvindicar/manter/sustentar/asseverar/afirmar/asseverar/jurar/afirmar/falar/contar/dizer/falar/contar/dizer/pronunciar/julgar/rotular/aconselhar/sugerir/propor/autorizar/permitir/julgar/avaliar/balizar
acusar	transmitir/comunicar
propor	representar/responsabilizar/nomear/aconselhar/sugerir/propor/pretender/planejar/seleccionar/escolher/selecionar
ingressar	registar/inscrever/registrar/recrutar
transferir	delegar/passar/entregar/ceder/dar/deslocar/mover/alterar/mudar
levar	estar/estar/promover/encorajar/estimular/acompanhar/deslocar/mover/deslocar/mover/transportar/levar/carregar/esgotar/gastar/despender/induzir/mudar/modificar/alterar/mudar/modificar/alterar
concluir	acordar/concordar/raciocinar/cogitar/pensar/refletir/completar/encher/terminar/finalizar/concluir/encerrar/terminar/finalizar/concluir/encerrar/mudar/modificar/alterar
derrotar	decretar
presidir	governar/reger
reunir	associar-se/juntar-se/filiar_se/afiliar_se/ingressar/interagir/receber/obter/comprar/adquirir/fazer/causar/provocar/criar/ajuntar/coletar/coligir/reunir/recolher/juntar/ajuntar/coletar/coligir/reunir/recolher/juntar/unir/acoplar/juntar/adicionar/somar/acrescentar/acrescer
afastar	conservar/reter/manter/estar/deslocar/mover
trabalhar	trabalhar/manusear/manejar/manipular/aprontar/preparar/transformar/transubstanciar/transmudar
ir	estar/estar/estar/ir/progredir/avançar/prosseguir/seguir/continuar/ganhar_terreno/ir/viajar/andar/viajar/ir/caminhar/andar/viajar/ir/caminhar/andar/viajar/ir/caminhar/andar/viajar/ir/caminhar/andar/viajar/ir/caminhar/andar/viajar/ir/caminhar/andar/viajar/ir/caminhar/andar/viajar/ir/caminhar/andar/viajar/ir/caminhar/andar/viajar/ir/caminhar/andar/desaparecer/sumir/ir/prosseguir/acontecer/ocorrer/suceder/passar/acontecer/ocorrer/suceder/passar
liderar	conduzir/dirigir/discutir
ocorrer	tornar_se/acontecer/ocorrer/suceder/passar/acontecer/ocorrer/suceder/passar
acabar	estar/ser/fazer/agir/atuar/terminar/finalizar/concluir/encerrar/terminar/finalizar/concluir/encerrar/terminar/finalizar/concluir/encerrar/terminar/finalizar/concluir/encerrar/terminar/finalizar/concluir/encerrar/enfraquecer/alterar/mudar
representar	igualar/equivaler/estar/ser/estar/ser/fazer/representar/atuar/apresentar/fazer/desempenhar/recriar/recriar/exercer/servir/falar/contar/dizer/representar/significar/querer_dizer/indicar/verbalizar/exprimir/proferir/expressar
fundar	pioneirar/ser_pioneiro/empreender/iniciar
designar	seleccionar/escolher/selecionar/seleccionar/escolher/selecionar/julgar/avaliar/balizar
decidir	julgar/declarar/induzir/resolver/decidir/resolver/decidir/seleccionar/escolher/selecionar/raciocinar/cogitar/pensar/refletir/terminar/finalizar/concluir/encerrar
organizar	cuidar/guiar/lidar/associar-se/juntar-se/filiar_se/afiliar_se/ingressar/organizar/pioneirar/ser_pioneiro/empreender/iniciar/fazer/causar/provocar/criar/arranjar/dispor/planejar/planejar/ordenar/arrumar/organizar
indicar	registar/registrar/acostar/cumprimentar/significar/querer_dizer/indicar/significar/querer_dizer/indicar/informar/contar/passar/transmitir/mostrar/ler/registrar/cadastrar/evidenciar/sugerir/indicar/sinalizar/denotar/informar/informar/informar/representar/apresentar
retornar	dar/entregar/viajar/ir/caminhar/andar/significar/denotar/responder/retrucar/replicar
começar	estar/ser/estar/ser/alcançar/atingir/efectuar/efetuar/realizar/obter/chegar_a/fazer/agir/atuar/fazer/agir/atuar/começar/deslocar/mover/começar/iniciar/fazer/causar/provocar/criar/proferir/falar/dizer/verbalizar/conversar/iniciar/começar/principiar/iniciar/começar/principiar/iniciar/começar/principiar/alterar/mudar
seguir	resultar/redundar/seguir/suceder/sobrevir/provar/resultar/estar/ser/obedecer/fazer/agir/atuar/perseguir/perseguir/seguir/viajar/ir/caminhar/andar/viajar/ir/caminhar/andar/viajar/ir/caminhar/andar/examinar/analizar/atuar/comportar-se/agir/parecer
encontrar	interagir/encontrar/achar/reganhar/receber/obter/comprar/adquirir/receber/obter/comprar/adquirir/receber/obter/comprar/adquirir/alcançar/chegar/servir/fornecer/prover/provisionar/abastecer
estabelecer	representar/estar/ser/pioneirar/ser_pioneiro/empreender/iniciar/fazer/causar/provocar/criar/fazer/causar/provocar/criar/fazer/causar/provocar/criar/tornar/ficar/estar
ligar	engajar/engatar/ligar/aderir/grudar/colar/prender/fixar/telefonar/chamar/conter/limitar/restringir
popular	completar/encher
tentar	procurar/tentar/fazer/agir/atuar/provocar/animar/excitar/estimular/excitar/emocionar/comover/convidar/pedir/julgar/avaliar/balizar
permitir	ficar/servir/pegar/prover/dar/permitir/outorgar/dar/conceder/dar/entregar/deixar/permitir/consentir/deixar/permitir/consentir/concordar/aprovar/consentir/aceitar
casar	reunir/unificar/unir/acoplar/juntar
enviar	pagar/transferir/transmitir/trazer/transferir/transmitir/trazer/transferir/transmitir/trazer/enviar/lançar/enviar/embarcar/despachar/transportar/trazer/expedir/enviar/embarcar/despachar/transportar/trazer/expedir/deslocar/mover/deslocar/mover/despachar/remeter/enviar/despachar/remeter/enviar/transmitir/passar/transmitir
contar	estar/ser/estar/ser/recitar/verbalizar/exprimir/proferir/expressar/achar/determinar/informar/informar/incluir/adivinhar/aproximar/julgar/avaliar/chutar/estimar/classificar
servir	passar/passar/realizar/satisfazer/cumprir/servir/bastar/ser_suficiente/estar/ser/ajudar/assistir/auxiliar/socorrer/solidarizar_se/acorrer/trabalhar/trabalhar/dar/entregar/entornar/verter/derramar/provocar/produzir/ocasionar/efetuar/operar/funcionar/servir/fornecer/prover/provisionar/abastecer/servir/fornecer/prover/provisionar/abastecer/servir/fornecer/prover/provisionar/abastecer/exercer/servir
armar	aparelhar/equipar/suprir/apetrechar/prover/suprir/abastecer/fornecer
prever	fazer/agir/atuar/conjeturar/pensar/imaginar/conjecturar/informar/contar/evidenciar/sugerir/indicar/sinalizar/denotar/julgar/avaliar/balizar
continuar	prosseguir/continuar/permanecer/seguir/conservar/reter/manter/estar/estar/ser/estar/ser/estar/ser/fazer/agir/atuar/fazer/agir/atuar/fazer/agir/atuar/fazer/agir/atuar/viajar/ir/caminhar/andar/dialogar/falar
renunciar	partir/abandonar/deixar/sair/largar/passar/entregar/ceder/dar/renunciar/repudiar/rejeitar
deputar	delegar
procurar	procurar/tentar/fazer/agir/atuar/ver/examinar/inspecionar/ver/examinar/inspecionar/ansiar/desejar/querer/buscar/procurar/buscar/procurar/buscar/procurar/buscar/procurar/analizar/pesquisar
constituir	representar/pioneirar/ser_pioneiro/empreender/iniciar
dirigir	governar/reger/governar/reger/governar/reger/cuidar/guiar/lidar/trabalhar/ir/progredir/avançar/prosseguir/seguir/continuar/forçar/empurrar/viajar/ir/caminhar/andar/fazer/causar/provocar/criar/controlar/operar/impetrar/mandar/intimar/ordenar
pedir	transmitir/comunicar
manifestar	mostrar/apresentar/evidenciar/testificar/mostrar/testemunhar/atestar/provar/passar/transmitir/surgir/aparecer
marcar	registar/registrar/registar/registrar/caracterizar/qualificar/caraterizar/marcar/conter/limitar/restringir/mudar/modificar/alterar
escolher	delegar/resolver/decidir/seleccionar/escolher/selecionar/seleccionar/escolher/selecionar/seleccionar/escolher/selecionar/seleccionar/escolher/selecionar/seleccionar/escolher/selecionar/seleccionar/escolher/selecionar/seleccionar/escolher/selecionar/seleccionar/escolher/selecionar/seleccionar/escolher/selecionar/julgar/avaliar/balizar
instalar	colocar/carregar/botar/pôr/colocar/carregar/botar/pôr
visar	escrever/redigir
chamar	classificar/rotular/soltar/emitir/convocar/chamar/telecomunicar/impetrar/mandar/intimar/ordenar/achar/considerar/ver
garantir	prometer
destinar	destinar/planejar
provocar	promover/encorajar/estimular/estimular/excitar/emocionar/comover/fazer/provocar/causar/fazer/provocar/causar/fazer/causar/provocar/criar/fazer/causar/provocar/criar/fazer/causar/provocar/criar/desafiar/zoar/rir/pagodear/ridicularizar/sacanear/zombar/mangar/mudar/modificar/alterar
envolver	fazer/agir/atuar/absorver/engajar/ocupar
assinar	comprar/adquirir/obter/atingir/escrever/redigir
chefiar	gerenciar/gerir/administrar
ver	ver/prestar_atenção/dar_atenção/divisar/avistar/observar/mirar/olhar/ver/observar/mirar/olhar/ver/observar/mirar/olhar/ver/observar/mirar/olhar/ver/observar/mirar/olhar/ver/olhar/ver/enxergar/olhar/ver/enxergar/aperceber/entender/perceber/aperceber-se/aperceber/entender/perceber/aperceber-se/aperceber/entender/perceber/aperceber-se/conjeturar/pensar/imaginar/conjecturar/achar/pensar/checar/conferir/examinar/analizar
destacar	desconectar
determinar	caracterizar/caraterizar/fazer/provocar/causar/imaginar/seleccionar/escolher/selecionar
abrir	prover/dar/expor/apresentar/exibir/mostrar/começar/iniciar/abrir/virar/mudar/tornar
comandar	conduzir/dirigir/instruir/impetrar/mandar/intimar/ordenar
aceitar	estar/ser/topar/aceitar/topar/aceitar/receber/obter/comprar/adquirir/receber/receber/receber/sofrer/experimentar/deixar/permitir/consentir/aceitar/julgar/avaliar/balizar/suportar/tolerar/aguentar/aturar/terminar/finalizar/concluir/encerrar
anunciar	jogar/jogar/falar/contar/dizer/mostrar/anunciar/informar/contar/enaltecer/louvar/elogiar/informar/informar
compor	representar/representar/verbalizar/fazer/causar/provocar/criar/fazer/causar/provocar/criar/unir/acoplar/juntar/planejar
dizer	dispõe/apresenta/evidenciar/testificar/mostrar/testemunhar/atestar/provar/falar/contar/dizer/significar/querer_dizer/indicar/recitar/exprimir/expressar/mostrar/verbalizar/exprimir/proferir/expressar/verbalizar/exprimir/proferir/expressar/verbalizar/exprimir/proferir/expressar/passar/transmitir/especular/mostrar/ler/registrar/cadastrar/aconselhar/sugerir/propor/transmitir/comunicar/transmitir/comunicar/adivinhar/inferir/supor
entrar	estar/ser/estar/ser/obter
impedir	evitar/impedir/atrapalhar/conter/limitar/restringir
elaborar	imaginar
colocar	deslocar/mover/colocar/carregar/botar/pôr/colocar/carregar/botar/pôr/colocar/carregar/botar/pôr/colocar/carregar/botar/pôr/colocar/carregar/botar/pôr/colocar/carregar/botar/pôr/arranjar/dispor/inserir/introduzir/prender/fixar/cobrir/tampar/adequar/ajustar/adaptar/mudar/modificar/alterar/vestir/vestir-se/arrumar-se
encarregar	delegar/confidenciar/incumbir/comissionar/entregar/confiar
criticar	julgar/avaliar/balizar
incluir	incluir/abarcar/conter/incluir/abarcar/conter/achar/considerar/ver/incluir/adicionar/somar/acrescentar/acrescer
adotar	topar/aceitar/seleccionar/escolher/selecionar/alterar/mudar
instaurar	fazer/causar/provocar/criar
conceder	conceder/premiar/outorgar/presentear/alocar/dar/entregar/dar/entregar/dar/entregar/dar/entregar/dar/entregar/dar/entregar/acordar/concordar
denunciar	classificar/rotular/mostrar/anunciar/informar
acompanhar	acompanhar/acompanhar/viajar/ir/caminhar/andar/tocar/conhecer/saber/entender
resultar	resultar/redundar/seguir/suceder/sobrevir/provar/resultar/estar/ser/acontecer/ocorrer/suceder/passar/acontecer/ocorrer/suceder/passar
desenvolver	imaginar/acontecer/ocorrer/suceder/passar/acontecer/ocorrer/suceder/passar/desenvolver/progredir/desenvolver/progredir/aumentar/crescer/melhorar/aperfeiçoar/alterar/mudar
atingir	alcançar/atingir/efectuar/efetuar/realizar/obter/chegar_a/alcançar/atingir/efectuar/efetuar/realizar/obter/chegar_a/alcançar/atingir/efectuar/efetuar/realizar/obter/chegar_a/conseguir/atingir/ser_bem_sucedido/suceder/conseguir/atingir/ser_bem_sucedido/suceder/conseguir/atingir/ser_bem_sucedido/suceder/obter/receber/obter/comprar/adquirir/receber/obter/comprar/adquirir/receber/obter/comprar/adquirir/receber/obter/comprar/adquirir/vir/chegar/provocar/produzir/ocasionar/efetuar/traspassar/perfurar/penetrar/resolver/solucionar/terminar/acabar/encerrar/finalizar/terminar/acabar/encerrar/finalizar/afetar/impactar
prender	relacionar_se/relacionar/relacionar-se/propulsionar/propulsar/tocar/impulsionar/anexar/juntar/unir/anexar/juntar/unir/segurar/agarrar/capturar/pegar/desativar/desabilitar/incapacitar/conter/limitar/restringir
sair	partir/deixar/sair/partir/deixar/sair/deslocar/mexer/mover/surgir/aparecer/materializar/alterar/mudar
encerrar	terminar/finalizar/concluir/encerrar/mudar/modificar/alterar
investigar	analizar/pesquisar/analizar/pesquisar/analizar/pesquisar/analizar/pesquisar
sediar	amparar/abrigar
escrever	escrever/compor/verbalizar/verbalizar/fazer/causar/provocar/criar/delinear/traçar/transmitir/comunicar/transmitir/comunicar
divulgar	mostrar/anunciar/informar/contar/enaltecer/louvar/elogiar
tratar	cuidar/guiar/lidar/cuidar/guiar/lidar/interagir/iniciar/abordar/encetar
encaminhar	conduzir/dirigir
transformar	forjar/formar/modelar/moldar/transformar/transmutar/mudar/mudar/modificar/alterar/mudar/modificar/alterar/mudar/modificar/alterar/mudar/modificar/alterar/mudar/modificar/alterar/mudar/modificar/alterar/alterar/mudar/alterar/mudar
sofrer	estar/ser/estar/ser/sofrer/sentir/experimentar/decair/piorar/alterar/mudar
pretender	reclamar/reivindicar/querer/desejar/especular/pretender/pretender/planear/planejar
efetivar	fazer/agir/atuar/fazer/representar/atuar
conhecer	lembrar-se/lembrar/recordar/recordar-se
vincular	relacionar_se/relacionar/relacionar-se
alcançar	estar/conseguir/atingir/ser_bem_sucedido/suceder/conseguir/atingir/ser_bem_sucedido/suceder/alcançar/chegar/transmitir/comunicar
convidar	interagir/estimular/excitar/emocionar/comover/acostar/cumprimentar
pronunciar	proferir/falar/dizer/verbalizar/conversar/julgar/declarar
retirar	tirar/remover/retirar/tirar/remover/retirar/tirar/remover/retirar/tirar/remover/retirar
instituir	fazer/causar/provocar/criar/fazer/causar/provocar/criar
enfrentar	lidar/começar
combater	disputar/lutar/brigar
convocar	ajuntar/coletar/coligir/reunir/recolher/juntar/convocar/chamar/convocar/chamar/convocar/chamar/impetrar/mandar/intimar/ordenar
solicitar	transmitir/comunicar
parecer	parecer/assemelhar-se/assemelhar-se_a/assemelhar/combinar/corresponder/concordar/estar/ser/estar/ser/estar/ser/estar/ser/parecer/parecer
evitar	evitar/impedir/atrapalhar/escapar/fugir/escapulir/foragir/escapar/fugir/escapulir/foragir/privar-se/privar/abster-se/abster
licenciar	autorizar/permitir
perder	abandonar/sofrer/colocar/carregar/botar/pôr
surgir	tornar_se/parecer/emergir/surgir/aparecer
caber	servir/ficar/caber/estar/ser/estar/ser/vestir/vestir-se/arrumar-se
aumentar	alçar/erguer/elevar/levantar/desinformar/enganar/aumentar/crescer/aumentar/crescer/aumentar/crescer/aumentar/crescer/aumentar/crescer/mudar_a_dimensão/acrescer/acrescentar/crescer/aumentar/acrescer/acrescentar/crescer/aumentar/acrescer/acrescentar/crescer/aumentar/acrescer/acrescentar/crescer/aumentar/acrescer/acrescentar/crescer/aumentar/aumentar/ampliar/progredir/aumentar/ampliar/progredir/aumentar/ampliar/progredir/aumentar/ampliar/progredir/aumentar/ampliar/progredir/aumentar/ampliar/progredir/aumentar/ampliar/progredir/aumentar/ampliar/progredir/aumentar/ampliar/progredir/aumentar/ampliar/progredir/aumentar/ampliar/progredir/mudar/modificar/alterar/mudar/modificar/alterar/mudar/modificar/alterar
negar	reter/conter/manter/guardar/segurar/reter/renunciar/repudiar/demonstrar/validar
articular	prover/suprir/abastecer/fornecer/falar/contar/dizer/exprimir/expressar/mostrar
viagem	viajar/ir/caminhar/andar
prestar	dar/entregar/raciocinar/cogitar/pensar/refletir
recusar	limitar/controlar/refrear/reter/conter/rejeitar/recusar/rejeitar
condenar	pronunciar/julgar/rotular
extinguir	o_fazendeiro_matou_um_porco_para_o_natal./matar/terminar/finalizar/concluir/encerrar
exigir	reivindicar/exigir/demandar/impetrar/mandar/intimar/ordenar
viajar	andar/ir/viajar/viajar/viajar/viajar/ir/caminhar/andar/viajar/ir/caminhar/andar/viajar/ir/caminhar/andar/viajar/ir/caminhar/andar
entregar	expulsar/passar/entregar/ceder/dar/passar/entregar/ceder/dar/passar/entregar/ceder/dar/passar/entregar/ceder/dar/transferir/transferir/oferecer/dar_de_presente/dar/regalar/entregar/oferecer/dar_de_presente/dar/regalar/entregar/oferecer/dar_de_presente/dar/regalar/entregar/oferecer/dar_de_presente/dar/regalar/entregar/dar/entregar/dar/entregar/dar/entregar/dar/entregar/dar/entregar/dar/entregar/dar/entregar
discutir	tratar/falar/cobrir/endereçar/lidar/dialogar/conversar/discutir/conversar/falar/proferir/falar/dizer/verbalizar/conversar
assegurar	defender/proteger/persuadir
coordenar	satisfazer/cuidar/guiar/lidar/arranjar/dispor
bacharelar	receber
auxiliar	suportar/ajudar/apoiar/levar/carregar/dirigir/conduzir/guiar
utilizar	usar/aproveitar/explorar/substituir/converter/mudar/trocar
suceder	provar/resultar/conseguir/atingir/ser_bem_sucedido/suceder/alcançar/chegar/acontecer/ocorrer/suceder/passar
conquistar	limitar/controlar/refrear/superar/parecer/impressionar/comover/afetar/atuar/comportar-se/agir/parecer
apontar	situar/posicionar/significar/querer_dizer/indicar/indicar/mostrar/apontar/indicar/mostrar/apontar/informar/informar/deformar
mudar	deslocar/mover/jogar_fora/avariar/danificar/substituir/virar/mudar/tornar/tornar/inverter/virar/reverter/mudar/modificar/alterar/alterar/mudar/alterar/mudar/alterar/mudar/alterar/mudar/alterar/mudar/alterar/mudar/alterar/mudar/alterar/mudar/vestir/vestir-se/arrumar-se
mostrar	descobrir/revelar/trazer/expor/apresentar/exibir/mostrar/mostrar/apresentar/mostrar/apresentar/divulgar/revelar/descerrar/passar/transmitir/indicar/assinalar/informar/informar/informar/informar/planejar
reduzir	substituir/trocar/desvalorizar/rebaixar/aviltar/degradar/partir/dividir/separar/reduzir/diminuir/reduzir/diminuir/reduzir/diminuir/reduzir/diminuir/reduzir/diminuir/reduzir/diminuir/reduzir/diminuir/reduzir/diminuir/reduzir/diminuir/conter/limitar/restringir/mudar/modificar/alterar/mudar/modificar/alterar
confirmar	combinar/corresponder/concordar/afirmar/asseverar/jurar/afirmar/transmitir/comunicar/fortalecer/fortificar
alegar	reinvindicar/manter/sustentar/asseverar/evidenciar/testificar/mostrar/testemunhar/atestar/provar
abandonar	cessar/acabar/parar/terminar/desistir/finalizar/deixar/descontinuar/partir/abandonar/deixar/sair/largar/passar/entregar/ceder/dar/descartar/jogar_fora/descartar/jogar_fora/escapar/evadir-se/fugir/alterar/mudar
decretar	resolver/decidir
fixar	colocar/carregar/botar/pôr/anexar/juntar/unir/juntar/grudar
ampliar	aumentar/ampliar/progredir/mudar/modificar/alterar
ganhar	receber/obter/comprar/adquirir/receber/obter/comprar/adquirir/receber/obter/comprar/adquirir/receber/obter/comprar/adquirir/acrescer/acrescentar/crescer/aumentar/alterar/mudar
cumprir	satisfazer/provocar/produzir/ocasionar/efetuar/realizar/efetuar/levar_a_cabo/executar/atingir/cumprir/realizar/efetuar/levar_a_cabo/executar/atingir/cumprir/terminar/acabar/encerrar/finalizar
atender	ouvir/dar_atenção_a/escutar
opor	refutar/rebater
preparar	construir/confeccionar/fabricar/construir/confeccionar/fabricar/fazer/causar/provocar/criar/leccionar/instruir/ensinar/lecionar/aprontar/preparar/aprontar/preparar/aprontar/preparar/mudar/modificar/alterar
desempenhar	fazer/agir/atuar/realizar/efetuar/levar_a_cabo/executar/atingir/cumprir/recriar
terminar	estar/ser/dividir/separar/partir/terminar/acabar/encerrar/finalizar/terminar/finalizar/concluir/encerrar/terminar/finalizar/concluir/encerrar/terminar/finalizar/concluir/encerrar/terminar/finalizar/concluir/encerrar/terminar/finalizar/concluir/encerrar/terminar/finalizar/concluir/encerrar/mudar/modificar/alterar
autorizar	responsabilizar/nomear/autorizar/permitir/deixar/permitir/consentir
reconhecer	estar/ser/reconhecer/apreciar/valorizar/apreciar/agradecer/julgar/declarar/determinar/aceitar/aceitar/lembrar-se/lembrar/recordar/recordar-se
aliar	combinar/fundir/misturar
buscar	ver/examinar/inspecionar/transportar/analizar/pesquisar/analizar/pesquisar/analizar/pesquisar
impor	forçar/obrigar/compelir/transmitir/comunicar
apurar	receber/obter/comprar/adquirir/melhorar/aperfeiçoar
encabeçar	jazer/conduzir/dirigir
resolver	acordar/concordar/resolver/decidir/calcular/computar/resolver/solucionar/terminar/finalizar/concluir/encerrar/melhorar/aperfeiçoar
implantar	inserir/introduzir/prender/fixar/transmitir/comunicar
complementar	balancear/equilibrar/compensar
responder	estar/ser/fazer/agir/atuar/falar/contar/dizer/refutar/rebater/resolver/solucionar/resolver/solucionar
romper	partir/separar_se/separar/dividir/separar
deflagrar	queimar/carburar
retomar	alterar/mudar
sugerir	significar/querer_dizer/indicar/informar/contar/exprimir/expressar/mostrar/passar/transmitir/informar
obrigar	forçar/obrigar/compelir/forçar/obrigar/compelir/relacionar_se/relacionar/relacionar-se/confidenciar/incumbir/comissionar/entregar/confiar/induzir
suspender	expulsar/pendurar/suspender/interromper/terminar/finalizar/concluir/encerrar/terminar/finalizar/concluir/encerrar/terminar/finalizar/concluir/encerrar/mudar/modificar/alterar/mudar/modificar/alterar
editar	mudar/modificar/alterar
construir	edificar/construir/imaginar/imaginar/fazer/causar/provocar/criar/fazer/causar/provocar/criar/fazer/causar/provocar/criar/delinear/traçar/melhorar/aperfeiçoar
gerar	fazer/causar/provocar/criar/fazer/causar/provocar/criar/fazer/causar/provocar/criar
rejeitar	reter/conter/rejeitar/recusar/rejeitar/julgar/avaliar/balizar/julgar/avaliar/balizar
ameaçar	ser/existir/exprimir/expressar/mostrar/avisar/alertar/advertir
julgar	pronunciar/julgar/rotular/julgar/declarar/aceitar/resolver/decidir/concluir/resolver/decidir/achar/considerar/ver/julgar/avaliar/balizar/julgar/avaliar/balizar/calcular/computar/ruminar/ponderar/cogitar/especular/contemplar/refletir/raciocinar/cogitar/pensar/refletir
alterar	mudar/modificar/alterar
oferecer	fazer/agir/atuar/prover/suprir/abastecer/fornecer/prover/suprir/abastecer/fornecer/oferecer/dar_de_presente/dar/regalar/entregar/dar/entregar
comprometer	afetar/impactar
denominar	classificar/rotular/denominar/chamar/nomear
lutar	fazer/agir/atuar/lutar/combater/batalhar/disputar/lutar/brigar/disputar/lutar/brigar/disputar/lutar/brigar/disputar/lutar/brigar/disputar/lutar/brigar
informar	informar/informar/informar/informar/transmitir/comunicar
promulgar	anunciar/declarar
estender	estar/estar/estar/prover/suprir/abastecer/fornecer/gesticular/aumentar/ampliar/progredir/aumentar/ampliar/progredir/deformar/mudar/modificar/alterar/mudar/modificar/alterar/estressar/tensionar
revelar	descobrir/revelar/trazer/descobrir/revelar/trazer/mostrar/apresentar/falar/contar/dizer/informar/contar/divulgar/revelar/descerrar/divulgar/revelar/descerrar/mudar/modificar/alterar
pôr	descer/baixar/cair/deslocar/mover/colocar/carregar/botar/pôr/colocar/carregar/botar/pôr/colocar/carregar/botar/pôr/colocar/carregar/botar/pôr/colocar/carregar/botar/pôr/colocar/carregar/botar/pôr/adequar/ajustar/adaptar/vestir/vestir-se/arrumar-se
citar	escrever/compor/evidenciar/testificar/mostrar/testemunhar/atestar/provar/reiterar/redizer/repetir/reapresentar/convocar/chamar/referir/mencionar
reassumir	alterar/mudar
inaugurar	começar/iniciar
lecionar	informar
comparecer	surgir/aparecer
referir	enviar/lançar/denominar/chamar/nomear/conectar/associar/relacionar/classificar
conduzir	conduzir/dirigir/cuidar/guiar/lidar/cuidar/guiar/lidar/gerenciar/gerir/administrar/trabalhar/fazer/agir/atuar/levar/carregar/dirigir/conduzir/guiar/levar/carregar/dirigir/conduzir/guiar/manobrar/guiar/canalizar/dirigir/forçar/empurrar/deslocar/mover/apresentar/fazer/desempenhar/executar/fazer/desempenhar/portar/controlar/operar/disputar/lutar/brigar/mudar/modificar/alterar
transmitir	interagir/transmitir/dar/passar/entregar/ceder/dar/deslocar/mover/deslocar/mover/transmitir/informar/contar/transmitir/comunicar/transmitir/comunicar
contribuir	promover/encorajar/estimular/pagar/dar/entregar/mudar/modificar/alterar
fechar	virar/mudar/tornar
firmar	acordar/concordar
desligar	apagar/desligar/ligar/virar/mudar/tornar
conter	incluir/abarcar/conter/incluir/abarcar/conter/incluir/abarcar/conter/incluir/abarcar/conter/estar/ser/limitar/controlar/refrear/negar/defender/conter/limitar/restringir
especializar	evoluir/desenvolver/amenizar/alterar/variar/mudar/modificar
admitir	ficar/servir/pegar/aceitar/admitir/topar/aceitar/transferir/transmitir/trazer/julgar/declarar/deixar/permitir/consentir/deixar/permitir/consentir/aceitar
desencadear	pioneirar/ser_pioneiro/empreender/iniciar
controlar	testar/tentar/ensaiar/limitar/controlar/refrear/governar/reger/cuidar/guiar/lidar/interagir/manusear/manejar/manipular/conter/limitar/restringir
incorporar	combinar/misturar
negociar	conseguir/atingir/ser_bem_sucedido/suceder/vender/transferir/passar/atravessar/discutir
dispor	gastar/despender/vender/colocar/carregar/botar/pôr/colocar/carregar/botar/pôr/providenciar/arranjar
aderir	esposar/adotar/adoptar/juntar/grudar/tocar/encostar
canalizar	governar/reger/prover/suprir/abastecer/fornecer/manobrar/guiar/canalizar/dirigir/deslocar/mover/edificar/construir
limitar	limitar/controlar/refrear/limitar/controlar/refrear/reduzir/diminuir/circunscrever/confinar/restringir/limitar/circunscrever/confinar/restringir/limitar/conter/limitar/restringir
dividir	expulsar/receber/obter/comprar/adquirir/deslocar/mover/partir/dividir/separar/partir/dividir/separar/dividir/separar/partir/dividir/separar/partir/dividir/separar/partir/calcular/computar/mudar/mudar/mudar/alterar/mudar
atribuir	conceder/lidar/entregar/imputar/atribuir/imputar/atribuir/julgar/avaliar/balizar/julgar/avaliar/balizar
identificar	significar/denotar/conectar/associar/relacionar/determinar/achar/considerar/ver/reconhecer
pagar	oferecer/corromper/subornar/alienar/dispor/alienar/dispor/pagar/pagar/pagar/pagar/dar/entregar/dar/entregar/causar_dor/doer
beneficiar	receber/obter/comprar/adquirir
submeter	oferecer/dar_de_presente/dar/regalar/entregar/dar/entregar/aconselhar/sugerir/propor/aceitar
querer	ansiar/desejar/querer/ansiar/desejar/querer/ansiar/desejar/querer/ansiar/desejar/querer/ansiar/desejar/querer/ansiar/desejar/querer/ansiar/desejar/querer/ansiar/desejar/querer/querer/desejar/exigir/demandar
completar	balancear/equilibrar/compensar/jogar/completar/encher/mudar/modificar/alterar
proibir	reter/conter
viver	estar/morar/habitar/povoar/viver
causar	fazer/provocar/causar/fazer/provocar/causar/fazer/causar/provocar/criar/fazer/causar/provocar/criar/mudar/modificar/alterar/mudar/modificar/alterar
produzir	plantar/cultivar/amanhar/fazer/provocar/causar/fazer/causar/provocar/criar/fazer/causar/provocar/criar/fazer/causar/provocar/criar/mudar/modificar/alterar/cuidar-se
adquirir	obter/obter/receber/obter/comprar/adquirir/receber/obter/comprar/adquirir/receber/obter/comprar/adquirir/receber/obter/comprar/adquirir/comprar/adquirir/obter/atingir/alterar/mudar/alterar/mudar/atuar/comportar-se/agir/parecer
deter	manter/guardar/segurar/reter/desativar/desabilitar/incapacitar
pertencer	caber_a/pertencer/estar/estar/ser/estar/ser/estar/ser/estar/ser/incluir
existir	ser/existir
usar	durar/dispõe/apresenta/dispõe/apresenta/dispõe/apresenta/cuidar/guiar/lidar/usar/aproveitar/explorar/usar/aproveitar/explorar/ingerir/tomar/consumir/significar/denotar/vestir/vestir-se/arrumar-se
caracterizar	diferenciar/distinguir/pensar/lembrar
visitar	reunir/encontrar/viajar
aplicar	forçar/obrigar/compelir/conceder/lidar/entregar/aplicar/colocar/cobrir/tampar/cobrir/tampar/significar/denotar
registrar	protocolar/registar/registrar/protocolar/registar/registrar/registar/inscrever/registrar/recrutar/guardar/preservar/conservar/manter/poupar/mandar/enviar/registar/registrar/registar/registrar/registar/registrar/escrever/redigir/indicar/assinalar/afetar/afectar
acumular	manter/guardar/segurar/reter/colocar/carregar/botar/pôr/arranjar/dispor/desenvolver/progredir/acrescer/acrescentar/crescer/aumentar
sustentar	combinar/corresponder/concordar/ter/sentir/experimentar/teimar/insistir
reivindicar	asseverar/jurar/afirmar
funcionar	conseguir/atingir/ser_bem_sucedido/suceder/operar/funcionar/operar/funcionar/operar/funcionar/exercer/servir
entender	escutar/ouvir_dizer/ouvir/sentir/crer/acreditar/conhecer/saber/entender/compreender/entender
demonstrar	mostrar/apresentar/evidenciar/testificar/mostrar/testemunhar/atestar/provar/passar/transmitir
analisar	seleccionar/escolher/selecionar
consolidar	solidificar/alterar/mudar
unir	reunir/unificar/anexar/juntar/unir/unir/juntar/adicionar/somar/acrescentar/acrescer/mudar/modificar/alterar/mudar/modificar/alterar
concordar	igualar/equivaler/combinar/corresponder/concordar/acordar/concordar/concordar/aprovar/consentir/aceitar/alterar/mudar
saber	aperceber/entender/perceber/aperceber-se/distinguir/separar/diferenciar/adivinhar/inferir/supor
exonerar	desculpar/perdoar
trazer	mostrar/apresentar/deslocar/mover/deslocar/mover/fazer/causar/provocar/criar/transportar/levar/carregar/transportar/levar/carregar/transmitir/mudar/modificar/alterar
abrigar	prover/suprir/abastecer/fornecer
possuir	dispõe/apresenta
intensificar	acrescer/acrescentar/crescer/aumentar/acrescer/acrescentar/crescer/aumentar/aumentar/ampliar/progredir/mudar/modificar/alterar
comunicar	interagir/informar
delegar	responsabilizar/nomear/delegar/delegar
eclodir	vir_ao_mundo/nascer/vir_ao_mundo/procriar/gerar/reproduzir
aproximar	parecer/assemelhar-se/assemelhar-se_a/assemelhar/ganhar_terreno/calcular/computar
relacionar	estar/ser/interagir/raciocinar/cogitar/pensar/refletir
prosseguir	prosseguir/continuar/permanecer/seguir/fazer/agir/atuar/fazer/agir/atuar/viajar/ir/caminhar/andar/dialogar/falar/acontecer/ocorrer/suceder/passar
significar	significar/querer_dizer/indicar/significar/querer_dizer/indicar/significar/passar/transmitir/indicar/assinalar
montar	estar/ascender/subir/viajar/ir/caminhar/andar/deslocar/mexer/mover/fazer/causar/provocar/criar/acasalar/copular/acasalar/copular/unir/acoplar/juntar
mobilizar	deslocar/mover/ajuntar/coletar/coligir/reunir/recolher/juntar/convocar/chamar
ajudar	suportar/ajudar/apoiar/promover/encorajar/estimular/ajudar/assistir/auxiliar/socorrer/solidarizar_se/acorrer/levar/carregar/dirigir/conduzir/guiar/servir/fornecer/prover/provisionar/abastecer/melhorar/aperfeiçoar/melhorar/aperfeiçoar
pressionar	influir/influenciar/deslocar/mover/impelir/exortar/urgir
estimular	suportar/ajudar/apoiar/promover/encorajar/estimular/fazer/provocar/causar/fazer/causar/provocar/criar/desafiar/afetar/impactar/afetar/afectar
matricular	registar/inscrever/registrar/recrutar
elevar	deslocar/mover/estimular/excitar/emocionar/comover/aumentar/ampliar/progredir/mudar/modificar/alterar
regulamentar	resolver/decidir
contratar	delegar/prometer
concentrar	raciocinar/cogitar/pensar/refletir/virar/mudar/tornar/mudar/modificar/alterar
sentar	aprumar/colocar/carregar/botar/pôr/colocar/carregar/botar/pôr
fortalecer	mudar/modificar/alterar
remover	dividir/ejetar/separar/excluir/dividir/ejetar/separar/excluir/tirar/remover/retirar/tirar/remover/retirar/tirar/remover/retirar
localizar	jazer/limitar/restringir/encontrar/achar/reganhar/situar/achar/determinar
efetuar	conseguir/atingir/ser_bem_sucedido/suceder/fazer/agir/atuar/fazer/agir/atuar/fazer/provocar/causar/provocar/produzir/ocasionar/efetuar/terminar/acabar/encerrar/finalizar
distribuir	oferecer/dar_de_presente/dar/regalar/entregar/arranjar/dispor/distribuir/disseminar/espalhar/hierarquizar/classificar/ranquiar
vender	estar/ser/trocar/transaccionar/tramitar/transacionar/entregar/render-se/ceder/dar/persuadir
preferir	avançar/promover/pagar
morrer	morrer_por/ansiar_por/desejar_fortemente/sentir/experimentar/desaparecer/sumir/expirar/morrer/bater_as_botas/falecer/comer_capim_pela_raiz/perecer/virar/mudar/tornar/alterar/mudar
praticar	executar/fazer/desempenhar
explicar	estar/ser/falar/contar/dizer/elaborar/expandir/elocubrar/expor/esclarecer/explicar/esclarecer/explicar/informar/informar
esperar	fazer/agir/atuar/ansiar/desejar/querer/ansiar/desejar/querer/ansiar/desejar/querer/querer/desejar/aguardar/esperar/aguardar/esperar/antecipar/planear/planejar/achar/considerar/ver/dar_à_luz/ter/parir
implementar	forçar/obrigar/compelir
orientar	situar/posicionar/resolver/decidir/adequar/ajustar/adaptar/alterar/mudar
modificar	adicionar/somar/acrescentar/acrescer
intitular	denominar/chamar/nomear/denominar/chamar/nomear
derrubar	descer/baixar/cair/virar-se/tornar-se/virar/forçar/empurrar/escrever/compor/derrubar/abater/decretar/mudar/modificar/alterar
atacar	fazer/agir/atuar/parecer/impressionar/comover/afetar/papar/alimentar_se/comer/atacar/assaltar/disputar/lutar/brigar/iniciar/começar/principiar/afetar/impactar/afetar/afectar
reafirmar	afirmar
falar	tratar/falar/cobrir/endereçar/lidar/iniciar/abordar/encetar/proferir/falar/dizer/verbalizar/conversar/proferir/falar/dizer/verbalizar/conversar/verbalizar/exprimir/proferir/expressar/verbalizar/exprimir/proferir/expressar/verbalizar/exprimir/proferir/expressar/divulgar/revelar/descerrar/passar/transmitir/leccionar/instruir/ensinar/lecionar/transmitir/comunicar/transmitir/comunicar/transmitir/comunicar
circular	manar/fluir/correr/deslocar/mover/deslocar/mover/viajar/ir/caminhar/andar/viajar/ir/caminhar/andar/viajar/ir/caminhar/andar/viajar/ir/caminhar/andar/modelar/formar
culminar	alcançar/atingir/efectuar/efetuar/realizar/obter/chegar_a/alcançar/chegar/terminar/finalizar/concluir/encerrar
subordinar	incluir/abarcar/conter/hierarquizar/classificar/ranquiar
desejar	ansiar/desejar/querer/ansiar/desejar/querer/ansiar/desejar/querer/ansiar/desejar/querer/ansiar/desejar/querer/ansiar/desejar/querer/ansiar/desejar/querer/querer/desejar/conjeturar/pensar/imaginar/conjecturar/verbalizar/exprimir/proferir/expressar/exigir/demandar
superar	estar/ser
governar	governar/reger/governar/reger
temer	respeitar/prezar/venerar
operar	conduzir/dirigir/manusear/manejar/manipular
crescer	desenvolver/progredir/mudar_a_dimensão/acrescer/acrescentar/crescer/aumentar/acrescer/acrescentar/crescer/aumentar/acrescer/acrescentar/crescer/aumentar/acrescer/acrescentar/crescer/aumentar/acrescer/acrescentar/crescer/aumentar/alterar/mudar/alterar/mudar/alterar/mudar
processar	cuidar/guiar/lidar/desafiar/calcular/computar
concretizar	fazer/causar/provocar/criar/alterar/mudar
financiar	pagar/financiar/manter/dar/entregar
favorecer	avançar/promover/achar/considerar/ver
restabelecer	restabelecer/mudar/modificar/alterar
introduzir	colocar/carregar/botar/pôr/anexar/juntar/unir/falar/contar/dizer/informar/leccionar/instruir/ensinar/lecionar
argumentar	representar/apresentar
aparecer	parecer/executar/fazer/desempenhar/surgir/aparecer/surgir/aparecer/tornar/ficar/estar
examinar	ver/examinar/inspecionar/traspassar/perfurar/penetrar/analizar/pesquisar/examinar/analizar/examinar/analizar/examinar/analizar
reforçar	leccionar/instruir/ensinar/lecionar/fortalecer/fortificar
associar	interagir/fazer/agir/atuar/julgar/avaliar/balizar/raciocinar/cogitar/pensar/refletir
ordenar	organizar/arranjar/dispor/arranjar/dispor/arranjar/dispor/arranjar/dispor/impetrar/mandar/intimar/ordenar
interromper	fazer/agir/atuar/parar/interromper/interromper/suspender/parar/terminar/finalizar/concluir/encerrar/terminar/finalizar/concluir/encerrar/terminar/finalizar/concluir/encerrar
exilar	expulsar/expulsar
executar	penalizar/punir/castigar/executar/assassinar/matar/despachar/executar/fazer/desempenhar/provocar/produzir/ocasionar/efetuar/realizar/efetuar/levar_a_cabo/executar/atingir/cumprir/recriar/fazer/causar/provocar/criar/o_fazendeiro_matou_um_porco_para_o_natal./matar/o_fazendeiro_matou_um_porco_para_o_natal./matar/terminar/acabar/encerrar/finalizar/terminar/acabar/encerrar/finalizar
cogitar	ruminar/ponderar/cogitar/especular/contemplar/refletir/raciocinar/cogitar/pensar/refletir/raciocinar/cogitar/pensar/refletir
classificar	incluir/abarcar/conter/limitar/restringir/denominar/designar/julgar/avaliar/balizar
baixar	transferir/transmitir/trazer/deslocar/mover/viajar/ir/caminhar/andar/mudar/modificar/alterar/mudar/modificar/alterar
comprar	estar/ser/receber/obter/comprar/adquirir/receber/obter/comprar/adquirir/comprar/adquirir/obter/atingir/comprar/adquirir/obter/atingir
recomendar	aconselhar/sugerir/propor/enaltecer/louvar/elogiar
escolar	lustrar/refinar/polir
dominar	jazer/influir/influenciar/governar/reger
regular	acertar/ajustar/corrigir/acertar/ajustar/corrigir/conter/limitar/restringir
acrescentar	falar/contar/dizer/combinar/fundir/misturar/combinar/fundir/misturar/adicionar/somar/acrescentar/acrescer/mudar_a_dimensão/acrescer/acrescentar/crescer/aumentar/acrescer/acrescentar/crescer/aumentar
regressar	viajar/ir/caminhar/andar
aproveitar	usar/aproveitar/explorar
acontecer	transformar/transmutar/mudar/acontecer/ocorrer/suceder/passar/acontecer/ocorrer/suceder/passar/acontecer/ocorrer/suceder/passar/acontecer/ocorrer/suceder/passar/acontecer/ocorrer/suceder/passar/acontecer/ocorrer/suceder/passar/acontecer/ocorrer/suceder/passar/alterar/mudar
convencer	influir/influenciar/persuadir
prometer	estar/ser
possibilitar	prover/dar/mudar/modificar/alterar
empenhar	procurar/tentar/consignar
agravar	encolerizar/enraivecer/irar/zangar/mudar/modificar/alterar
anular	julgar/declarar/enfraquecer
redigir	transmitir/comunicar/mudar/modificar/alterar
situar	deslocar/mover/colocar/carregar/botar/pôr/colocar/carregar/botar/pôr/colocar/carregar/botar/pôr/achar/determinar
vetar	opor
posicionar	colocar/carregar/botar/pôr/seleccionar/escolher/selecionar
levantar	alçar/erguer/elevar/levantar/alçar/erguer/elevar/levantar/alçar/erguer/elevar/levantar/alçar/erguer/elevar/levantar/alçar/erguer/elevar/levantar/alçar/erguer/elevar/levantar/ascender/subir/deslocar/mover/deslocar/mover/descansar/repousar/colocar/carregar/botar/pôr/melhorar/aperfeiçoar
sancionar	autorizar/permitir
consistir	estar/ser/ser/existir
precisar	não_ter/carecer/faltar/necessitar/estar/ser
investir	aparelhar/equipar/suprir/apetrechar/investir/gastar/despender/mudar/modificar/alterar
cometer	fazer/agir/atuar
recorrer	acontecer/ocorrer/suceder/passar
implicar	dispõe/apresenta/exprimir/expressar/mostrar/exprimir/expressar/mostrar
ressaltar	surgir/aparecer
fornecer	prover/dar/prover/suprir/abastecer/fornecer/prover/suprir/abastecer/fornecer/prover/suprir/abastecer/fornecer/dar/entregar/dar/entregar
avaliar	determinar/determinar/determinar/estimar/avaliar/medir/adivinhar/aproximar/julgar/avaliar/chutar/estimar/julgar/avaliar/balizar/julgar/avaliar/balizar/julgar/avaliar/balizar/calcular/computar/raciocinar/cogitar/pensar/refletir
prorrogar	adiar/alongar
formular	construir/confeccionar/fabricar/imaginar/exprimir/expressar/mostrar/hipotetizar/especular/teorizar/supor/conjecturar
suprimir	limitar/controlar/refrear/o_fazendeiro_matou_um_porco_para_o_natal./matar/reduzir/diminuir/conter/limitar/restringir
discordar	estar/ser
eliminar	o_fazendeiro_matou_um_porco_para_o_natal./matar/tirar/remover/retirar
acreditar	antecipar/achar/pensar/crer/aceitar/crer/acreditar/crer/acreditar/crer/acreditar
gastar	gastar/despender/gastar/despender/pagar/pagar
acelerar	ajudar/assistir/auxiliar/socorrer/solidarizar_se/acorrer/fazer/agir/atuar/apressar/correr/viajar/ir/caminhar/andar/aprofundar/intensificar/mudar/modificar/alterar
proferir	transmitir/comunicar
observar	ver/prestar_atenção/dar_atenção/divisar/avistar/olhar/ver/enxergar/checar/conferir
embarcar	proceder/deslocar/mover/iniciar/começar/principiar
facilitar	ajudar/assistir/auxiliar/socorrer/solidarizar_se/acorrer/fazer/provocar/causar
verificar	testar/tentar/ensaiar
acentuar	enunciar/articular/falar/dizer/pronunciar/exprimir/expressar/mostrar
conferir	conceder/premiar/outorgar/presentear/discutir/examinar/analizar
patrocinar	suportar/ajudar/apoiar/suportar/ajudar/apoiar/financiar/manter/sustentar/manter
rebatizar	denominar/chamar/nomear
agir	fazer/agir/atuar
mover	alterar/variar/mudar/modificar
figurar	estar/ser/conjeturar/pensar/imaginar/conjecturar/recriar
reformar	forjar/formar/modelar/moldar/melhorar/aperfeiçoar/melhorar/aperfeiçoar/melhorar/mudar/modificar/alterar/mudar/modificar/alterar
ceder	transferir/oferecer/dar_de_presente/dar/regalar/entregar/dar/entregar/concordar/aprovar/consentir/aceitar
residir	morar/habitar/povoar/viver/ser/existir
deslocar	deslocar/mover/deslocar/mover
incentivar	promover/encorajar/estimular/encorajar/alentar/encorajar/alentar/encorajar/alentar/encorajar/alentar/fazer/provocar/causar
intervir	jazer/interagir/acontecer/ocorrer/suceder/passar
forçar	forçar/obrigar/compelir/forçar/obrigar/compelir/fazer/agir/atuar/empurrar/propulsionar/deslocar/mover/deslocar/mover/prender/fixar/induzir
acirrar	acrescer/acrescentar/crescer/aumentar
recuperar	receber/obter/comprar/adquirir/receber/obter/comprar/adquirir/melhorar/transformar/converter/transmudar
protestar	asseverar/jurar/afirmar/opor
dissolver	virar/mudar/tornar/mudar
valer	estar/ser/estar/ser
ferir	ferir/lesar/machucar/lesionar/ferir/lesar/machucar/lesionar/indispor/doer/ferir/aleijar/machucar
enfatizar	enfatizar/acentuar/pontuar/exprimir/expressar/mostrar/maquilar/maquiar
misturar	mesclar/misturar/unificar/amalgamar/misturar/unificar/amalgamar/misturar/manusear/manejar/manipular/combinar/fundir/misturar/desordenar/bagunçar/reunir/unir/combinar/adicionar/somar/acrescentar/acrescer/adicionar/somar/acrescentar/acrescer/mudar/mudar/modificar/alterar/mudar/modificar/alterar
desistir	cessar/acabar/parar/terminar/desistir/finalizar/deixar/descontinuar/passar/entregar/ceder/dar/concordar/aprovar/consentir/aceitar
achar	encontrar/achar/reganhar/encontrar/achar/reganhar/receber/obter/comprar/adquirir/receber/obter/comprar/adquirir/receber/obter/comprar/adquirir/ver/prestar_atenção/dar_atenção/divisar/avistar/alcançar/chegar/conceber/conceitualizar/achar/determinar/antecipar/antecipar/achar/pensar/achar/pensar/achar/pensar/julgar/avaliar/balizar/julgar/avaliar/balizar/raciocinar/cogitar/pensar/refletir/raciocinar/cogitar/pensar/refletir/raciocinar/cogitar/pensar/refletir
cobrar	cobrar/cobrar/calcular/contar/computar/contabilizar/determinar
mandar	transferir/transmitir/trazer
constar	dispõe/apresenta
liberar	passar/entregar/ceder/dar/desculpar/perdoar
atrair	tirar/puxar/arredar/convidar/pedir/mudar/modificar/alterar
sentir	encontrar/achar/reganhar/aperceber/entender/perceber/aperceber-se/aperceber/entender/perceber/aperceber-se
responsabilizar	imputar/atribuir
lograr	vitimar/victimizar
depender	estar/ser/crer/crer
pregar	propulsionar/propulsar/tocar/impulsionar/anexar/juntar/unir/palestrar/falar/impelir/exortar/urgir
planejar	imaginar/imaginar/destinar/pretender/pretender/raciocinar/cogitar/pensar/refletir
ler	dispõe/apresenta/indicar/assinalar/compreender/entender/compreender/entender/compreender/entender
comprovar	ver/examinar/inspecionar
reagir	fazer/agir/atuar/fazer/agir/atuar/virar/mudar/tornar/atuar/comportar-se/agir/parecer
lembrar	parecer/assemelhar-se/assemelhar-se_a/assemelhar/dar/legar/entregar/passar/deixar/significar/denotar/informar/conectar/associar/relacionar/pensar/lembrar/pensar/lembrar
arquivar	registar/registrar
diminuir	cair/reduzir/diminuir/reduzir/diminuir/reduzir/diminuir/reduzir/diminuir/reduzir/diminuir/reduzir/diminuir/reduzir/diminuir/reduzir/diminuir/desaparecer/sumir/reduzir/diminuir/mudar_a_dimensão/mudar/modificar/alterar/mudar/modificar/alterar/alterar/mudar
debater	dialogar/conversar/discutir
acatar	obedecer
abranger	continuar/estender/incluir/abarcar/conter
refletir	mostrar/apresentar/indicar/mostrar/apontar/ruminar/ponderar/cogitar/especular/contemplar/refletir/raciocinar/cogitar/pensar/refletir
qualificar	servir/bastar/ser_suficiente/pronunciar/julgar/rotular/pensar/lembrar/adicionar/somar/acrescentar/acrescer/amenizar
suplementar	balancear/equilibrar/compensar/representar/anexar/juntar/unir/adicionar/somar/acrescentar/acrescer
percorrer	ir/caminhar/andar
questionar	dialogar/conversar/questionar/perguntar/questionar/perguntar/dirigir-se/ruminar/ponderar/cogitar/especular/contemplar/refletir
resistir	durar/se_opor/reagir/fazer/agir/atuar/portar/defender/resistir/disputar/lutar/brigar/disputar/lutar/brigar
ratificar	autorizar/permitir
advogar	impelir/exortar/urgir
matar	superar/o_fazendeiro_matou_um_porco_para_o_natal./matar/o_fazendeiro_matou_um_porco_para_o_natal./matar/o_fazendeiro_matou_um_porco_para_o_natal./matar/beber/tomar/terminar/finalizar/concluir/encerrar
graduar	receber/acertar/ajustar/corrigir
engajar	fazer/agir/atuar/deslocar/mover/interessar
corresponder	igualar/equivaler/igualar/equivaler/combinar/corresponder/concordar/sobreviver/aguentar/lidar/virar-se/suprir/satisfazer
noticiar	informar/informar/informar/informar/informar
antecipar	fazer/agir/atuar/julgar/avaliar/balizar
preconizar	enaltecer/louvar/elogiar
empreender	fazer/provocar/causar/pioneirar/ser_pioneiro/empreender/iniciar
disciplinar	penalizar/punir/castigar/mudar/modificar/alterar
restringir	limitar/controlar/refrear/limitar/controlar/refrear/reduzir/diminuir/circunscrever/confinar/restringir/limitar/circunscrever/confinar/restringir/limitar/conter/limitar/restringir/conter/limitar/restringir/conter/limitar/restringir/amenizar
renovar	prover/suprir/abastecer/fornecer/recriar/emendar/reparar/consertar
consultar	discutir/perguntar/indagar
administrar	cuidar/guiar/lidar
motivar	fazer/provocar/causar
excluir	não_ter/carecer/faltar/necessitar/expulsar/evitar/impedir/atrapalhar/tirar/remover/retirar
esclarecer	mostrar/manifestar/demonstrar/informar/leccionar/instruir/ensinar/lecionar
travar	superar
durar	medir
expor	descobrir/revelar/trazer/mostrar/apresentar/zoar/rir/pagodear/ridicularizar/sacanear/zombar/mangar
inspirar	encorajar/alentar/estimular/excitar/emocionar/comover
explorar	analizar/pesquisar/analizar/pesquisar/analizar/pesquisar
conclamar	encorajar/alentar
isolar	receber/obter/comprar/adquirir/dividir/separar/partir/classificar/mudar/modificar/alterar
imprimir	influir/influenciar/reproduzir/escrever/mudar_a_superfície
absolver	pronunciar/julgar/rotular/desculpar/perdoar/desculpar/perdoar
compreender	incluir/abarcar/conter/incluir/abarcar/conter/olhar/ver/enxergar/adivinhar/inferir/supor/conhecer/saber/entender/realizar/perceber/entender/compreender/compreender/entender
preservar	conservar/reter/manter/manter/guardar/segurar/reter/cozinhar/preparar/defender/proteger/preservar/conservar
afetar	fazer/agir/atuar/afetar/impactar/mudar/modificar/alterar/mudar/modificar/alterar
mencionar	falar/contar/dizer/referir/mencionar/conectar/associar/relacionar
datar	prover/suprir/abastecer/fornecer/determinar
projetar	mostrar/apresentar/enviar/lançar/imaginar/imaginar/imputar/atribuir
atravessar	continuar/estender/passar/atravessar/passar/atravessar/passar/atravessar/passar/atravessar/ir/caminhar/andar/andar/ir/viajar/andar/ir/viajar/viajar/ir/caminhar/andar/deslocar/mexer/mover/perfurar/furar
alertar	avisar/alertar/advertir/informar
proceder	fazer/agir/atuar
pensar	imaginar/imaginar/focar/centrar/concentrar/antecipar/julgar/avaliar/balizar/ruminar/ponderar/cogitar/especular/contemplar/refletir/raciocinar/cogitar/pensar/refletir/raciocinar/cogitar/pensar/refletir/raciocinar/cogitar/pensar/refletir/raciocinar/cogitar/pensar/refletir
trocar	substituir/trocar/trocar/trocar/transferir/viajar/ir/caminhar/andar/jogar_fora/substituir/substituir/tornar/inverter/virar/reverter/mudar/modificar/alterar/mudar/modificar/alterar/mudar/modificar/alterar/alterar/mudar/vestir/vestir-se/arrumar-se
revogar	julgar/declarar
ouvir	aperceber/entender/perceber/aperceber-se/aperceber/entender/perceber/aperceber-se
importar	estar/ser/comerciar/transferir/transmitir/trazer
discursar	tratar/falar/cobrir/endereçar/lidar/dialogar/falar
proclamar	reinvindicar/manter/sustentar/asseverar/proferir/falar/dizer/verbalizar/conversar
proporcionar	prover/dar/acertar/ajustar/corrigir
recolher	receber/obter/comprar/adquirir
juntar	reunir/unificar/reunir/unificar/ajuntar/coletar/coligir/reunir/recolher/juntar/unir/juntar/unir/juntar
aguardar	fazer/agir/atuar/ansiar/desejar/querer/aguardar/esperar
cair	chover/estar/ser/estar/ser/inclinar/declivar/aprumar/cair/descer/baixar/cair/descer/baixar/cair/viajar/ir/caminhar/andar/viajar/ir/caminhar/andar/separar/descolar/desgrudar/crer/acreditar/expirar/morrer/bater_as_botas/falecer/comer_capim_pela_raiz/perecer/acontecer/ocorrer/suceder/passar/virar/mudar/tornar/mudar/modificar/alterar
somar	enumerar/contar/calcular/computar/adicionar/somar/acrescentar/acrescer/acrescer/acrescentar/crescer/aumentar
reorganizar	organizar
cobrir	continuar/estender/realizar/satisfazer/cumprir/estar/ser/esconder/encobrir/omitir/tampar/tapar/acobertar/ocultar/acasalar/copular/cobrir/tampar/cobrir/tampar/cobrir/tampar/cobrir/tampar/cobrir/tampar/cobrir/cobrir/cobrir/tocar/encostar/defender/proteger/defender/proteger/iniciar/abordar/encetar
avançar	delegar/viajar/ir/caminhar/andar/desenvolver/progredir
expressar	receber/obter/comprar/adquirir/substanciar/concretizar/realizar/exprimir/expressar/mostrar/verbalizar/exprimir/proferir/expressar/significar/denotar/passar/transmitir/passar/transmitir
ultrapassar	ultrapassar/ganhar_terreno
reservar	protocolar/registar/registrar/lotear/atribuir
interessar	absorver/engajar/ocupar
aglutinar	juntar/grudar/aderir/colar
reiterar	fazer/agir/atuar/informar/contar
interpretar	executar/fazer/desempenhar/esclarecer/explicar
traduzir	estar/ser/reiterar/redizer/repetir/reapresentar/mudar/modificar/alterar
solucionar	calcular/computar
render	auferir/ganhar
influenciar	fazer/provocar/causar/persuadir/afetar/impactar
descobrir	encontrar/achar/reganhar/encontrar/achar/reganhar/ver/prestar_atenção/dar_atenção/divisar/avistar/descobrir/revelar/trazer/mostrar/apresentar/conceber/conceitualizar
dispensar	dar/entregar
rever	examinar/analizar/lembrar/relembrar/recordar/lembrar-se/lembrar/recordar/recordar-se
ausentar	desaparecer/sumir
repetir	fazer/agir/atuar/reproduzir/recriar/soltar/emitir/repetir/ecoar/informar/contar/acontecer/ocorrer/suceder/passar
desaparecer	escapar/evadir-se/fugir/deslocar/mexer/mover/desaparecer/sumir/desaparecer/sumir/desaparecer/sumir
advertir	avisar/alertar/advertir/avisar/alertar/advertir/informar/informar/informar/informar
converter	substituir/mudar/modificar/alterar/mudar/modificar/alterar/alterar/mudar/alterar/mudar
adiar	adiar/adiar/esperar/reter/aguardar
relatar	mostrar/anunciar/recontar/narrar/contar/informar/informar
invadir	atacar/assaltar
assistir	suportar/ajudar/apoiar/ajudar/assistir/auxiliar/socorrer/solidarizar_se/acorrer/ouvir/dar_atenção_a/escutar
pesar	medir/medir/estar/ser/mensurar/quantificar/mensurar/quantificar
enfraquecer	reduzir/diminuir/enfraquecer/amortecer/enfraquecer/mudar/modificar/alterar/mudar/modificar/alterar
perceber	aperceber/entender/perceber/aperceber-se/realizar/perceber/entender/compreender/compreender/entender
assassinar	o_fazendeiro_matou_um_porco_para_o_natal./matar/o_fazendeiro_matou_um_porco_para_o_natal./matar/o_fazendeiro_matou_um_porco_para_o_natal./matar
melhorar	aperfeiçoar/perfazer/melhorar/aperfeiçoar/melhorar/aperfeiçoar/melhorar/aperfeiçoar/melhorar/aperfeiçoar/melhorar/aperfeiçoar/melhorar/melhorar/melhorar/melhorar/melhorar/virar/mudar/tornar/mudar/modificar/alterar
moderar	discutir/enfraquecer/mudar/modificar/alterar/mudar/modificar/alterar/mudar/modificar/alterar
depositar	depositar/dar/entregar
abalar	deslocar/mexer/mover/enfraquecer
unificar	associar-se/juntar-se/filiar_se/afiliar_se/ingressar/mudar/modificar/alterar/mudar/modificar/alterar/mudar/modificar/alterar
requerer	estar/ser/exigir/demandar/transmitir/comunicar
elogiar	saudar/estimar/avaliar/medir
devolver	viajar/ir/caminhar/andar/renunciar/repudiar
acarretar	incluir/abarcar/conter
comentar	escrever/compor/falar/contar/dizer/esclarecer/explicar/esclarecer/explicar
oficializar	julgar/declarar/mudar/modificar/alterar
cercar	fechar_(se)/contornar/rodear/defender/proteger/atacar/assaltar
paralisar	estar/ser
contornar	tocar/encostar
cancelar	julgar/declarar
assessorar	discutir
respeitar	achar/considerar/ver/aceitar
reclamar	proferir/falar/dizer/verbalizar/conversar
fugir	escapar/evadir-se/fugir/escapar/evadir-se/fugir/escapar/evadir-se/fugir/escapulir/escapar/fugir/escapar/fugir/escapulir/foragir/escapar/fugir/escapulir/foragir
aprofundar	aprofundar/intensificar/acrescer/acrescentar/crescer/aumentar
reprimir	limitar/controlar/refrear/conter/limitar/restringir/alterar/mudar
prolongar	alongar/aumentar/crescer
alinhar	situar/posicionar/acertar/ajustar/corrigir
internar	institucionalizar/internar/admitir/transferir/transmitir/trazer
prevalecer	ser/existir
condicionar	prover/suprir/abastecer/fornecer
merecer	estar/ser
desviar	virar-se/tornar-se/virar/virar-se/tornar-se/virar
coincidir	acontecer/ocorrer/suceder/passar
outorgar	causar/provocar/dar/conceder/premiar/outorgar/presentear/alocar/dar/entregar/dar/entregar/dar/entregar/dar/entregar
formalizar	julgar/declarar/autorizar/permitir
desvincular	desconectar
alimentar	promover/encorajar/estimular/prover/suprir/abastecer/fornecer/prover/suprir/abastecer/fornecer/encorajar/alentar/estimular/excitar/emocionar/comover/servir/fornecer/prover/provisionar/abastecer/servir/fornecer/prover/provisionar/abastecer/servir/fornecer/prover/provisionar/abastecer/servir/fornecer/prover/provisionar/abastecer/servir/fornecer/prover/provisionar/abastecer/usar/aproveitar/explorar
apreender	segurar/agarrar/capturar/pegar
traçar	recriar/copiar/desenhar/examinar/analizar/marcar
surpreender	fazer/agir/atuar/parecer/impressionar/comover/afetar
proteger	defender/proteger/defender/proteger/defender
acertar	alienar/dispor/golpear/bater/virar/mudar/tornar/mudar/modificar/alterar
quebrar	dividir/separar/arruinar/destroçar/estraçalhar/destruir/partir/dividir/separar/dividir/separar/partir/resolver/solucionar/quebrar/romper/quebrar/romper/separar/dividir/desmoronar/avariar/danificar/avariar/danificar/mudar/modificar/alterar/alterar/mudar/alterar/mudar/alterar/mudar/ferir/lesar/machucar/lesionar
absorver	interessar/focar
acolher	amparar/abrigar/cumprimentar/saudar
tender	estar/ser/sentir/experimentar
reabrir	abrir
conservar	conservar/reter/manter/manter/guardar/segurar/reter/cozinhar/preparar/preservar/conservar/ficar/permanecer/continuar/manter
confiar	passar/entregar/ceder/dar/deixar/permitir/consentir/antecipar
privar	reter/conter/decair/piorar
preocupar	governar/reger/emocionar/disturbar/perturbar
influir	afetar/impactar
despertar	virar/mudar/tornar/mudar/modificar/alterar
coligar	reunir/unificar
perseguir	procurar/tentar/perseguir/perseguir/viajar/ir/caminhar/andar/ansiar/desejar/querer
originar	tornar_se/fazer/causar/provocar/criar
neutralizar	o_fazendeiro_matou_um_porco_para_o_natal./matar/enfraquecer/mudar/modificar/alterar/mudar/modificar/alterar
dotar	oferecer/dar_de_presente/dar/regalar/entregar
desagradar	desgostar/desagradar/parecer/impressionar/comover/afetar
aconselhar	discutir
destruir	arruinar/destroçar/estraçalhar/destruir/arruinar/destroçar/estraçalhar/destruir/arruinar/destroçar/estraçalhar/destruir/arruinar/destroçar/estraçalhar/destruir/enfraquecer
comissionar	passar/entregar/ceder/dar
celebrar	celebrar/reunir/encontrar
precipitar	descer/baixar/cair/provocar/produzir/ocasionar/efetuar/provocar/produzir/ocasionar/efetuar/virar/mudar/tornar
cuidar	ajudar/assistir/auxiliar/socorrer/solidarizar_se/acorrer/governar/reger/cuidar/guiar/lidar
abordar	discutir
contrair	estreitar/apertar/reduzir/diminuir/adoentar/adoecer
escapar	escapar/evadir-se/fugir/escapar/evadir-se/fugir/escapulir/escapar/fugir/escapar/fugir/escapulir/foragir/escapar/fugir/escapulir/foragir/escapar/fugir/escapulir/foragir/escapar/fugir/escapulir/foragir/escapar/fugir/escapulir/foragir
enquadrar	representar
tirar	deslocar/mover/deslocar/mover/deslocar/mover/transportar/levar/carregar/tirar/puxar/arredar/tirar/puxar/arredar/cerrar/fechar/tirar/remover/tirar/remover/retirar/tirar/remover/retirar/tirar/remover/retirar/tirar/remover/retirar/tirar/remover/retirar/tirar/remover/retirar/tirar/remover/retirar/tirar/remover/retirar/tirar/remover/retirar/tirar/remover/retirar/tirar/remover/retirar/tirar/remover/retirar/tirar/remover/retirar/tirar/remover/retirar
centralizar	mudar/modificar/alterar
remunerar	pagar
ocasionar	fazer/provocar/causar
homenagear	aceitar
conciliar	acordar/concordar/acertar/ajustar/corrigir
barrar	tolher/evitar/estorvar/impedir/reter/entravar/atrapalhar
sufocar	limitar/controlar/refrear/o_fazendeiro_matou_um_porco_para_o_natal./matar/expirar/morrer/bater_as_botas/falecer/comer_capim_pela_raiz/perecer/sofrer/doer
consumar	realizar/efetuar/levar_a_cabo/executar/atingir/cumprir/realizar/efetuar/levar_a_cabo/executar/atingir/cumprir
consagrar	consagrar/devotar/comprometer/dedicar
evidenciar	informar/contar/informar/surgir/aparecer
reverter	tornar/inverter/virar/reverter/alterar/mudar
interferir	tolher/evitar/estorvar/impedir/reter/entravar/atrapalhar/interagir
apreciar	amar/passar/transmitir/apreciar/agradecer/achar/considerar/ver/realizar/perceber/entender/compreender/acrescer/acrescentar/crescer/aumentar
vedar	cerrar/fechar
restaurar	mudar/modificar/alterar
objetivar	mudar/modificar/alterar/mudar/modificar/alterar
incumbir	passar/entregar/ceder/dar
assinalar	indicar/mostrar/apontar/evidenciar/sugerir/indicar/sinalizar/denotar/informar/informar
adaptar	adequar/ajustar/adaptar/alterar/variar/mudar/modificar
lotar	apinhar/completar/encher/completar/encher
fundir	forjar/formar/modelar/moldar/dissolver/derreter/fundir/modelar/formar/mudar
fracassar	mudar
correr	fazer/agir/atuar/fazer/agir/atuar/manar/fluir/correr/manar/fluir/correr/apressar/correr/acelerar/apressar/despachar-se/apressar-se/passar/passar/atravessar/correr/correr/correr/viajar/ir/caminhar/andar/deslocar/mexer/mover/deslocar/mexer/mover/competir/concorrer
batizar	denominar/chamar/nomear/denominar/chamar/nomear
morar	estar/morar/habitar/povoar/viver/morar/habitar/povoar/viver/morar/habitar/povoar/viver
bater	soar/ressoar/fazer/soar/ressoar/fazer/soar/ressoar/fazer/empurrar/propulsionar/empurrar/propulsionar/deslocar/mover/deslocar/mover/deslocar/mover/deslocar/mover/deslocar/mexer/mover/deslocar/mexer/mover/deslocar/mexer/mover/deslocar/mexer/mover/deslocar/mexer/mover/deslocar/mexer/mover/deslocar/mexer/mover/deslocar/mexer/mover/deslocar/mexer/mover/lavar/propulsionar/propulsar/tocar/impulsionar/acertar/bater/golpear/acertar/bater/golpear/acertar/bater/golpear/acertar/bater/golpear/golpear/bater/golpear/bater/golpear/bater/golpear/bater/golpear/bater/golpear/bater/bater/bater_repetidamente/cerrar/fechar/bater/colidir/atingir/mostrar/ler/registrar/cadastrar
remeter	transferir/transmitir/trazer/despachar/remeter/enviar/transmitir
obedecer	obedecer
endossar	suportar/ajudar/apoiar
comparar	estar/ser/comparar/examinar/analizar
separar	expulsar/partir/separar_se/separar/partir/separar_se/separar/lotear/atribuir/dividir/separar/deslocar/mover/deslocar/mexer/mover/partir/dividir/separar/partir/dividir/separar/dividir/separar/partir/dividir/separar/partir/dividir/separar/partir/dividir/separar/partir/desconectar/distinguir/separar/diferenciar/identificar/reconhecer/mudar/mudar/mudar/mudar/alterar/mudar
desmentir	representar
anteceder	jazer
espalhar	continuar/estender/lançar/dividir/separar/separar/partir/viajar/ir/caminhar/andar/bater/bater_repetidamente/distribuir/disseminar/espalhar/derramar/desaguar/cobrir/tampar
restar	estar
recuar	viajar/ir/caminhar/andar/viajar/ir/caminhar/andar/deslocar/mexer/mover
variar	amenizar
arrecadar	cobrar
repassar	enviar/embarcar/despachar/transportar/trazer/expedir
inscrever	protocolar/registar/registrar/registar/inscrever/registrar/recrutar/associar-se/juntar-se/filiar_se/afiliar_se/ingressar/delinear/traçar
compensar	balancear/equilibrar/compensar/balancear/equilibrar/compensar/balancear/equilibrar/compensar/alienar/dispor/pagar/pagar/mudar/modificar/alterar
agrupar	classificar
reintegrar	pagar
necessitar	estar/ser
conceber	imaginar/fazer/causar/provocar/criar/virar/mudar/tornar
centrar	raciocinar/cogitar/pensar/refletir
desenrolar	deslocar/mover/ordenar
apressar	ajudar/assistir/auxiliar/socorrer/solidarizar_se/acorrer/fazer/agir/atuar/viajar/ir/caminhar/andar/viajar/ir/caminhar/andar/impelir/exortar/urgir/aprofundar/intensificar/mudar/modificar/alterar
marchar	ir/caminhar/andar/ir/caminhar/andar/ir/caminhar/andar
deliberar	discutir/discutir
provar	estar/ser/testar/tentar/ensaiar/trabalhar/amassar/ingerir/tomar/consumir/evidenciar/testificar/mostrar/testemunhar/atestar/provar/informar/demonstrar/validar
bloquear	reter/conter
desembarcar	descer/baixar/cair
apelar	desafiar
tramitar	interagir
sujeitar	afetar/impactar
reino	governar/reger/reinar/gerir
ignorar	tratar/rejeitar
recair	virar/mudar/tornar
diferenciar	caracterizar/qualificar/caraterizar/distinguir/separar/diferenciar/distinguir/separar/diferenciar/calcular/computar/identificar/reconhecer/desenvolver/progredir/evoluir/desenvolver
contemplar	observar/mirar/olhar/ver/observar/mirar/olhar/ver/raciocinar/cogitar/pensar/refletir/raciocinar/cogitar/pensar/refletir
descartar	livrar/descartar/jogar_fora/rejeitar
competir	competir/concorrer/competir/concorrer
estimar	imaginar/respeitar/prezar/venerar/adivinhar/aproximar/julgar/avaliar/chutar/estimar/adivinhar/aproximar/julgar/avaliar/chutar/estimar/adivinhar/aproximar/julgar/avaliar/chutar/estimar/adivinhar/aproximar/julgar/avaliar/chutar/estimar/julgar/avaliar/balizar/calcular/computar
cortar	estar/ser/escrever/forjar/formar/modelar/moldar/fazer/causar/provocar/criar/fazer/causar/provocar/criar/dividir/separar/partir/dividir/separar/partir/acertar/bater/golpear/separar/descolar/desgrudar/derrubar/abater/traspassar/perfurar/penetrar
pautar	desenhar
saudar	acostar/cumprimentar/cumprimentar/saudar/cumprimentar/saudar/cumprimentar/saudar/cumprimentar/saudar/enaltecer/louvar/elogiar/transmitir/comunicar
inserir	colocar/carregar/botar/pôr/anexar/juntar/unir
atrasar	adiar/mudar/modificar/alterar
rebelar	protestar
prestigiar	reconhecer/aceitar
atenuar	melhorar/aperfeiçoar
gozar	atuar/comportar-se/agir/parecer
distinguir	caracterizar/qualificar/caraterizar/distinguir/separar/diferenciar/identificar/reconhecer
combinar	compatibilizar/harmonizar/concordar/igualar/equivaler/combinar/corresponder/concordar/interagir/dar/conceder/entregar/contribuir/outorgar/compartir/dividir/compartilhar/partilhar/unificar/amalgamar/misturar/acertar/ajustar/corrigir/adicionar/somar/acrescentar/acrescer/mudar
ascender	ascender/subir/viajar/ir/caminhar/andar/viajar/ir/caminhar/andar
findar	estar/ser
conspirar	interagir
privatizar	mudar/modificar/alterar
herdar	receber/obter/comprar/adquirir
expandir	aumentar/crescer/aumentar/crescer/aumentar/ampliar/progredir/mudar/modificar/alterar
esvaziar	esvaziar/evaziar/esvaziar/evaziar/tirar/remover/retirar/virar/mudar/tornar/mudar/modificar/alterar
caminhar	caminhar/passear/fazer_trilha/ir/caminhar/andar/ir/caminhar/andar/ir/caminhar/andar/ir/caminhar/andar/ir/caminhar/andar/ir/caminhar/andar/ir/caminhar/andar/viajar/ir/caminhar/andar/viajar/ir/caminhar/andar/viajar/ir/caminhar/andar/viajar/ir/caminhar/andar/viajar/ir/caminhar/andar
entrevistar	dialogar/conversar/dialogar/conversar
doar	pagar/oferecer/dar_de_presente/dar/regalar/entregar/dar/entregar
telegrafar	telecomunicar
gravar	parecer/impressionar/comover/afetar/registar/registrar/registar/registrar/registar/registrar/registar/registrar
encarar	estar/observar/mirar/olhar/ver/virar-se/tornar-se/virar
desgastar	tirar/remover/retirar
corrigir	balancear/equilibrar/compensar/penalizar/punir/castigar/descer/baixar/cair/estimar/avaliar/medir/tornar/inverter/virar/reverter/mudar/modificar/alterar/mudar/modificar/alterar
transportar	transportar/deslocar/mover/deslocar/mover/deslocar/mover/deslocar/mover/transportar/levar/carregar/transportar/levar/carregar/mudar/modificar/alterar
sobreviver	sobreviver/aguentar/lidar/virar-se/fazer/agir/atuar
refutar	renunciar/repudiar
expedir	deslocar/mover/despachar/remeter/enviar
subir	inclinar/declivar/ascender/subir/ascender/subir/ascender/subir/montar/subir/trepar/galgar/montar/subir/trepar/galgar/montar/subir/trepar/galgar/montar/subir/trepar/galgar/viajar/ir/caminhar/andar/viajar/ir/caminhar/andar/deslocar/mexer/mover/avançar/progredir/aumentar/crescer/aumentar/crescer/acrescer/acrescentar/crescer/aumentar/acrescer/acrescentar/crescer/aumentar/acrescer/acrescentar/crescer/aumentar/acrescer/acrescentar/crescer/aumentar/acrescer/acrescentar/crescer/aumentar/aumentar/subir/aumentar/ampliar/progredir/alterar/mudar/alterar/mudar
esgotar	consumir/gastar/consumir/gastar/absorver/engajar/ocupar
desfechar	abrir
descrever	informar
opinar	discutir
assentar	prover/suprir/abastecer/fornecer/abalroar/submergir/afundar/aprumar/colocar/carregar/botar/pôr/virar/mudar/tornar
requisitar	transmitir/comunicar
experimentar	receber/sofrer/experimentar/receber/sofrer/experimentar/ingerir/tomar/consumir/analizar/pesquisar/alterar/mudar/alterar/mudar/pôr/usar/colocar/caber/vestir
delinear	mostrar/apresentar/desenhar/desenhar/descrever/marcar
avisar	avisar/alertar/advertir/informar/informar/discutir
repudiar	rejeitar/recusar/rejeitar/rejeitar
programar	imaginar/imaginar/planejar
expulsar	expulsar/expulsar/expulsar/deslocar/mover
estreitar	mudar/modificar/alterar/alterar/mudar/alterar/mudar
esboçar	preparar/escrever/compor/imaginar/descrever
repercutir	afetar/impactar/afetar/impactar
difundir	lançar
adiantar	mudar/modificar/alterar
livrar	passar/entregar/ceder/dar
liquidar	alienar/dispor/pagar/custear/descartar/jogar_fora/o_fazendeiro_matou_um_porco_para_o_natal./matar
exibir	ter/possuir/descobrir/revelar/trazer/expor/apresentar/exibir/mostrar/mostrar/apresentar/mostrar/apresentar
calcular	calcular/computar/raciocinar
derivar	resultar/redundar/seguir/suceder/sobrevir/fazer/causar/provocar/criar/evoluir/desenvolver
agitar	expor/apresentar/exibir/mostrar/deslocar/mover/deslocar/mover/deslocar/mover/deslocar/mover/deslocar/mover/deslocar/mover/deslocar/mexer/mover/deslocar/mexer/mover/deslocar/mexer/mover/deslocar/mexer/mover/deslocar/mexer/mover/deslocar/mexer/mover/deslocar/mexer/mover/emocionar/disturbar/perturbar
idealizar	pensar/inventar/achar/considerar/ver
cotar	determinar
aperfeiçoar	aperfeiçoar/perfazer/melhorar/aperfeiçoar/mudar/modificar/alterar
selar	cerrar/fechar/anexar/juntar/unir/resolver/decidir
reproduzir	fazer/causar/provocar/criar/repetir/ecoar
frisar	enrolar
exportar	comerciar/transferir/transmitir/trazer
estacionar	manobrar/guiar/canalizar/dirigir/colocar/carregar/botar/pôr
esquecer	perder
agregar	compartir/dividir/compartilhar/partilhar/unificar/amalgamar/misturar
salvar	bater/defender/proteger
culpar	imputar/atribuir
vitimar	trapacear/defraudar/calotear/maltratar/injustiçar/penalizar/punir/castigar
valorizar	determinar/achar/considerar/ver/estimar/avaliar/medir
retardar	mudar/modificar/alterar
inocentar	pronunciar/julgar/rotular
equilibrar	portar
acionar	desafiar
impulsionar	coagir/forçar/compelir/obrigar/empurrar/propulsionar/deslocar/mover/deslocar/mexer/mover/fazer/provocar/causar/propulsionar/propulsar/tocar/impulsionar
exaltar	intoxicar/elevar/estimular/excitar/emocionar/comover/enaltecer/louvar/elogiar/enaltecer/louvar/elogiar
confessar	julgar/declarar/conceder/admitir/confessar
inclinar	inclinar/debruçar/torcer/dobrar/curvar/vergar/torcer/dobrar/curvar/vergar/aprumar/rebaixar/baixar/arriar/sentir/experimentar
incidir	enfatizar/acentuar/pontuar
conversar	confabular/papear/prosear/conversar/fofocar/bater_papo/boquejar/confabular/dialogar/conversar/dialogar/falar/proferir/falar/dizer/verbalizar/conversar/transmitir/comunicar
suprir	prover/suprir/abastecer/fornecer/prover/suprir/abastecer/fornecer/prover/suprir/abastecer/fornecer/prover/suprir/abastecer/fornecer/dar/entregar/servir/fornecer/prover/provisionar/abastecer
subscrever	escrever/redigir/acordar/concordar
selecionar	resolver/decidir/seleccionar/escolher/selecionar/seleccionar/escolher/selecionar/seleccionar/escolher/selecionar/seleccionar/escolher/selecionar
desarticular	dividir/separar/partir
declinar	descer/baixar/cair
compartilhar	fazer/agir/atuar/transmitir/comunicar
censurar	estimar/avaliar/medir
priorizar	hierarquizar/classificar/ranquiar
ensinar	informar/habituar/habituar-se/acostumar-se
custar	estar/ser
capitanear	estar/ser/liderar/comandar/encabeçar
abster	limitar/controlar/refrear
suicidar	o_fazendeiro_matou_um_porco_para_o_natal./matar
resumir	falar/contar/dizer/reiterar/redizer/repetir/reapresentar/reduzir/diminuir
modernizar	amenizar/alterar/mudar
diversificar	mudar/modificar/alterar/alterar/variar/mudar/modificar/alterar/variar/mudar/modificar
subsidiar	pagar/financiar/manter
penetrar	associar-se/juntar-se/filiar_se/afiliar_se/ingressar/ganhar_terreno/parecer/impressionar/comover/afetar/inserir/introduzir/traspassar/perfurar/penetrar/traspassar/perfurar/penetrar/traspassar/perfurar/penetrar
movimentar	deslocar/mexer/mover
lamentar	sentir_saudade/sentir_falta/afligir-se/magoar/sofrer/sentir/experimentar/informar/rejeitar/recusar
atestar	aconselhar/sugerir/propor/informar
rechaçar	deslocar/mover/desgostar/desagradar
perguntar	questionar/perguntar/questionar/perguntar/dirigir-se/desafiar/transmitir/comunicar/ruminar/ponderar/cogitar/especular/contemplar/refletir
englobar	incluir/abarcar/conter
andar	caminhar/passear/fazer_trilha/ir/caminhar/andar/ir/caminhar/andar/ir/caminhar/andar/ir/caminhar/andar/ir/caminhar/andar/ir/caminhar/andar/viajar/viajar/ir/caminhar/andar/viajar/ir/caminhar/andar/viajar/ir/caminhar/andar/viajar/ir/caminhar/andar/viajar/ir/caminhar/andar/viajar/ir/caminhar/andar/viajar/ir/caminhar/andar/viajar/ir/caminhar/andar/viajar/ir/caminhar/andar/viajar/ir/caminhar/andar/viajar/ir/caminhar/andar/viajar/ir/caminhar/andar/viajar/ir/caminhar/andar/mensurar/quantificar
poupar	gastar/despender/guardar/preservar/conservar/manter/poupar/manter/guardar/segurar/reter
esconder	disfarçar/mascarar/esconder/encobrir/esconder/encobrir/omitir/tampar/tapar/acobertar/ocultar/esconder/encobrir/omitir/tampar/tapar/acobertar/ocultar/esconder/encobrir/omitir/tampar/tapar/acobertar/ocultar/esconder/encobrir/omitir/tampar/tapar/acobertar/ocultar/esconder/encobrir/omitir/tampar/tapar/acobertar/ocultar/segurar/agarrar/capturar/pegar/mudar/modificar/alterar
confundir	estar/ser/comportar-se/resistir/conduzir/disconcertar/confundir/errar/equivocar/confundir/mudar/modificar/alterar
amparar	prover/suprir/abastecer/fornecer
obstruir	tolher/evitar/estorvar/impedir/reter/entravar/atrapalhar/conter/limitar/restringir
gerir	governar/reger/conduzir/dirigir/cuidar/guiar/lidar
direcionar	governar/reger/situar/posicionar/classificar/rotular/destinar
medir	estar/ser/resolver/decidir/julgar/avaliar/balizar/medir/mensurar/enfraquecer
instruir	informar/leccionar/instruir/ensinar/lecionar/leccionar/instruir/ensinar/lecionar/instruir/impetrar/mandar/intimar/ordenar/preparar/educar/treinar/instruir/habituar/habituar-se/acostumar-se
institucionalizar	transferir/transmitir/trazer
generalizar	distribuir/disseminar/espalhar/proferir/falar/dizer/verbalizar/conversar
emprestar	dar/entregar/mudar/modificar/alterar
colher	ajuntar/coletar/coligir/reunir/recolher/juntar/ajuntar/coletar/coligir/reunir/recolher/juntar
repelir	forçar/empurrar/desgostar/desagradar
regularizar	arranjar/dispor/resolver/decidir
polarizar	partir/dividir/separar/dividir/separar/partir/mudar/modificar/alterar
desfazer	tornar/inverter/virar/reverter
defrontar	estar/lidar/começar
recriar	imaginar/fazer/causar/provocar/criar/fazer/causar/provocar/criar/fazer/causar/provocar/criar
marginalizar	interagir
legalizar	deixar/permitir/consentir
conviver	morar/habitar/povoar/viver
bastar	realizar/satisfazer/cumprir
atualizar	informar/amenizar
agredir	fazer/agir/atuar
reeditar	imprimir/editar/publicar
protocolar	protocolar/registar/registrar/registar/registrar
hostilizar	fazer/agir/atuar
evoluir	desenvolver/progredir
esmagar	humilhar/rebaixar/mortificar/aviltar/apertar/pressionar/prensar/separar/dividir/desmoronar
cunhar	verbalizar/construir/confeccionar/fabricar
avistar	aperceber/entender/perceber/aperceber-se
adequar	alterar/variar/mudar/modificar
abater	o_fazendeiro_matou_um_porco_para_o_natal./matar
violar	arruinar/destroçar/estraçalhar/destruir
totalizar	estar/ser/reunir/unir/combinar
supervisionar	gerenciar/gerir/administrar
providenciar	prover/dar/acordar/concordar/aprontar/preparar
preceder	jazer/viajar/ir/caminhar/andar/falar/contar/dizer
guardar	reter/conter/ter/manter/guardar/segurar/reter/manter/guardar/segurar/reter/sentir/experimentar/defender/proteger/defender/proteger/checar/conferir
explodir	pegar_fogo/conflagrar/combustir/começar_a_queimar/acender/expressar_sentimentos/fazer/causar/provocar/criar/arruinar/destroçar/estraçalhar/destruir/separar/dividir/desmoronar/explodir/arrebentar/estourar
desrespeitar	relacionar_se/relacionar/relacionar-se/achar/considerar/ver
versar	escrever/compor
reter	compreender/incluir/ter/conter/evitar/impedir/atrapalhar/fazer/agir/atuar/negar/ter/manter/guardar/segurar/reter/manter/guardar/segurar/reter/pensar/lembrar/desativar/desabilitar/incapacitar
predominar	surgir
distanciar	conservar/reter/manter
cruzar	viajar/ir/caminhar/andar/criar/reproduzir
congelar	reter/conter/solidificar/solidificar/gelar/gelar/suspender/interromper/virar/mudar/tornar/alterar/mudar
agradar	estar/ser/querer/desejar/esperar
jogar	fazer/agir/atuar/enviar/lançar/propulsionar/propulsar/tocar/impulsionar/lançar/atirar/jogar/colocar/carregar/botar/pôr/bater/derramar/desaguar/usar/aproveitar/explorar/alinhar/apostar/jogar/jogar/competir/concorrer/atuar/comportar-se/agir/parecer
fraudar	trapacear/defraudar/calotear
desdobrar	operar/funcionar/deformar
arregimentar	governar/reger/delegar/planejar
trair	iludir/lograr/enganar/iludir/lograr/enganar/divulgar/revelar/descerrar/desinformar/enganar/informar
torturar	angustiar/doer/machucar/angustiar/doer/machucar/ferir/lesar/machucar/lesionar
seqüestrar	tomar/capturar/pegar/tomar/capturar/pegar
sensibilizar	mudar/modificar/alterar
captar	aperceber/entender/perceber/aperceber-se/transformar/converter/transmudar
aprisionar	involver
acometer	superar/iniciar/começar/principiar
minimizar	informar/reduzir/diminuir/reduzir/diminuir
manipular	interagir/manusear/tocar/usar/aproveitar/explorar
legitimar	deixar/permitir/consentir
domiciliar	morar/habitar/povoar/viver
radicalizar	mudar/modificar/alterar
supor	especular/especular/antecipar/antecipar/antecipar/resolver/solucionar
saldar	vender
respaldar	suportar/ajudar/apoiar
girar	girar/virar/manar/fluir/correr/girar/rodar/dar_a_volta/girar/rodar/dar_a_volta/virar-se/tornar-se/virar/virar-se/tornar-se/virar/virar-se/tornar-se/virar/virar-se/tornar-se/virar/deslocar/mover/deslocar/mexer/mover/controlar/operar
reger	governar/reger/governar/reger/apresentar/fazer/desempenhar/executar/fazer/desempenhar
alijar	descartar/jogar_fora/lançar/atirar/jogar
ajustar	servir/ficar/caber/aceitar/resolver/decidir/concluir/adequar/ajustar/adaptar/acertar/ajustar/corrigir/acertar/ajustar/corrigir/mudar/modificar/alterar/alterar/variar/mudar/modificar/alterar/mudar
falhar	alterar/mudar
exprimir	receber/obter/comprar/adquirir/significar/denotar/passar/transmitir/transmitir/comunicar
afiliar	associar-se/juntar-se/filiar_se/afiliar_se/ingressar
acrescer	falar/contar/dizer/mudar_a_dimensão/acrescer/acrescentar/crescer/aumentar
premiar	fazer/agir/atuar/alocar
induzir	aceitar/admitir/fazer/provocar/causar/produzir/provocar/produzir/ocasionar/efetuar
exortar	encorajar/alentar
desentender	compreender/entender
descentralizar	mudar/modificar/alterar
deferir	autorizar/permitir
instar	impelir/exortar/urgir
habilitar	mudar/modificar/alterar
forjar	forjar/formar/modelar/moldar/forjar/formar/modelar/moldar/construir/confeccionar/fabricar/imaginar/forjar/transformar
fabricar	construir/confeccionar/fabricar/pensar/inventar/fazer/causar/provocar/criar
emendar	melhorar/aperfeiçoar/melhorar/aperfeiçoar
arcar	transportar/levar/carregar
aclamar	gesticular/enaltecer/louvar/elogiar
tecer	construir/confeccionar/fabricar/construir/confeccionar/fabricar
estabilizar	fortalecer/fortificar/mudar/modificar/alterar
dobrar	torcer/dobrar/curvar/vergar/torcer/dobrar/curvar/vergar/virar-se/tornar-se/virar/deslocar/mexer/mover/mudar_a_superfície/deformar
satisfazer	satisfazer/combinar/corresponder/concordar/sobreviver/aguentar/lidar/virar-se/fazer/agir/atuar/suprir/satisfazer/servir/fornecer/prover/provisionar/abastecer/servir/fornecer/prover/provisionar/abastecer/ingerir/tomar/consumir/circunscrever/confinar/restringir/limitar
prevenir	avisar/alertar/advertir
multiplicar	calcular/computar/aumentar/ampliar/progredir
costumar	fazer/agir/atuar/habituar/habituar-se/acostumar-se
recrutar	protocolar/registar/registrar/engajar/empregar/enlistar
parar	cessar/acabar/parar/terminar/desistir/finalizar/deixar/descontinuar/protestar/parar/interromper/parar/interromper/suspender/interromper/interromper/suspender/parar/terminar/finalizar/concluir/encerrar
infiltrar	associar-se/juntar-se/filiar_se/afiliar_se/ingressar/passar/atravessar
finalizar	estar/ser/terminar/finalizar/concluir/encerrar/terminar/finalizar/concluir/encerrar/terminar/finalizar/concluir/encerrar/terminar/finalizar/concluir/encerrar/terminar/finalizar/concluir/encerrar/mudar/modificar/alterar
aventar	seleccionar/escolher/selecionar
arrematar	terminar/acabar/encerrar/finalizar
aliviar	ajudar/assistir/auxiliar/socorrer/solidarizar_se/acorrer/suprir/satisfazer/melhorar/aperfeiçoar/aliviar/melhorar/atenuar/amenizar/aliviar/melhorar/atenuar/amenizar
resgatar	trocar/trocar/tirar/remover/retirar
inverter	mudar/modificar/alterar/alterar/mudar
emergir	emergir/surgir/aparecer/surgir/aparecer
dinamizar	mudar/modificar/alterar/mudar/modificar/alterar
desmembrar	partir/dividir/separar
redundar	provar/resultar
reconquistar	receber/obter/comprar/adquirir
rebater	responder/retrucar/replicar/renunciar/repudiar
reaparecer	surgir/aparecer
legendar	prover/suprir/abastecer/fornecer
erguer	alçar/erguer/elevar/levantar/alçar/erguer/elevar/levantar/alçar/erguer/elevar/levantar/alçar/erguer/elevar/levantar/alçar/erguer/elevar/levantar/alçar/erguer/elevar/levantar/deslocar/mover/colocar/carregar/botar/pôr
enumerar	achar/determinar/proclamar
endereçar	acessar/classificar/rotular/iniciar/abordar/encetar/dirigir-se
acenar	deslocar/mexer/mover/gesticular/gesticular
sepultar	esconder/encobrir/omitir/tampar/tapar/acobertar/ocultar/pôr/deitar/colocar
restituir	pagar
notar	falar/contar/dizer
dispersar	dividir/separar/separar/partir
alugar	prestar/emprestar/receber/obter/comprar/adquirir/dar/entregar
tocar	soar/soar/ressoar/fazer/deslocar/mover/deslocar/mover/parecer/impressionar/comover/afetar/apresentar/fazer/desempenhar/fazer/provocar/causar/recriar/tocar/encostar/ingerir/tomar/consumir/mudar/modificar/alterar
sistematizar	ordenar
reajustar	aceitar/resolver/decidir/concluir/acertar/ajustar/corrigir
irradiar	ir/estender/levar/aparecer_como/parecer/iluminar-se/iluminar/alterar/variar/mudar/modificar
incitar	fazer/provocar/causar/fazer/provocar/causar/fazer/causar/provocar/criar/desafiar/induzir
esforçar	procurar/tentar
equiparar	mudar/modificar/alterar
deportar	expulsar/expulsar
cultivar	lustrar/refinar/polir/aprontar/preparar/adequar/ajustar/adaptar
consumir	gastar/despender/papar/alimentar_se/comer/consumir/gastar/ingerir/tomar/consumir/absorver/engajar/ocupar
arrastar	involver/deslocar/mover/tirar/puxar/arredar/tirar/puxar/arredar
alistar	registar/inscrever/registrar/recrutar
sintetizar	reiterar/redizer/repetir/reapresentar/reunir/unir/combinar/alterar/mudar
ditar	governar/reger/reinar/gerir/transmitir/comunicar/proclamar
detectar	ver/prestar_atenção/dar_atenção/divisar/avistar
atirar	propulsionar/propulsar/tocar/impulsionar/lançar/atirar/jogar/lançar/atirar/jogar/lançar/atirar/jogar/lançar/atirar/jogar/lançar/atirar/jogar/lançar/atirar/jogar/colocar/carregar/botar/pôr/verbalizar/exprimir/proferir/expressar/ferir/lesar/machucar/lesionar
aplaudir	gesticular/gesticular/enaltecer/louvar/elogiar
suspeitar	pensar/achar/supor/esperar
reconciliar	acordar/concordar/aceitar/acertar/ajustar/corrigir
racionalizar	organizar/raciocinar/raciocinar/cogitar/pensar/refletir/mudar/modificar/alterar
expirar	virar/mudar/tornar
detalhar	elaborar/expandir/elocubrar/expor
consignar	confidenciar/incumbir/comissionar/entregar/confiar
confrontar	lidar/começar
comportar	fazer/agir/atuar
soltar	dar/entregar/deslocar/mover/verbalizar/exprimir/proferir/expressar
roubar	trapacear/defraudar/calotear/fazer/agir/atuar/segurar/agarrar/capturar/pegar
relegar	delegar
indagar	transmitir/comunicar
hospitalizar	institucionalizar/internar/admitir
deteriorar	avariar/danificar/avariar/danificar/decair/piorar
creditar	calcular/contar/computar/contabilizar
carregar	dispõe/apresenta/prover/suprir/abastecer/fornecer/deslocar/mover/deslocar/mover/propulsionar/propulsar/tocar/impulsionar/colocar/carregar/botar/pôr/carregar/carregar/encher/carregar/empacotar/encaixotar/transportar/levar/carregar/transportar/levar/carregar/transportar/levar/carregar/transportar/levar/carregar/carregar/completar/encher/completar/encher/mudar/modificar/alterar/mudar/modificar/alterar/dar_à_luz/ter/parir
assolar	arruinar/destroçar/estraçalhar/destruir
pugnar	disputar/lutar/brigar
ponderar	ruminar/ponderar/cogitar/especular/contemplar/refletir/ruminar/ponderar/cogitar/especular/contemplar/refletir/raciocinar/cogitar/pensar/refletir/raciocinar/cogitar/pensar/refletir
oscilar	deslocar/mexer/mover/virar/mudar/tornar
capitalizar	prover/suprir/abastecer/fornecer/auferir/beneficiar-se/ganhar/lucrar/beneficiar/achar/considerar/ver/substituir/converter/mudar/trocar
adoecer	decair/piorar
telefonar	telecomunicar/telefonar/chamar
simplificar	mudar/modificar/alterar
sanear	mudar/modificar/alterar
reconsiderar	achar/considerar/ver/achar/considerar/ver
insurgir	protestar
especular	investir/antecipar/raciocinar/raciocinar/cogitar/pensar/refletir
equipar	prover/suprir/abastecer/fornecer/prover/suprir/abastecer/fornecer
enriquecer	melhorar/aperfeiçoar/adicionar/somar/acrescentar/acrescer/adicionar/somar/acrescentar/acrescer
engrossar	mudar/modificar/alterar
complicar	mudar/modificar/alterar/mudar/modificar/alterar
capturar	receber/obter/comprar/adquirir/agarrar/pegar/tomar/agarrar/pegar/tomar/segurar/agarrar/capturar/pegar/segurar/agarrar/capturar/pegar/jogar/mudar/modificar/alterar
apelidar	denominar/chamar/nomear/denominar/chamar/nomear
aparelhar	prover/suprir/abastecer/fornecer/virar/mudar/tornar
almejar	planear/planejar
suportar	financiar/manter/deixar/permitir/consentir/deixar/permitir/consentir
narrar	recontar/narrar/contar/informar/informar
manobrar	governar/reger/fazer/agir/atuar
duplicar	reproduzir
desativar	mudar/modificar/alterar/mudar/modificar/alterar
demandar	requerer/necessitar/precisar/reivindicar
agilizar	aprofundar/intensificar
virar	virar/derrubar/virar-se/tornar-se/virar/virar-se/tornar-se/virar/virar-se/tornar-se/virar/virar-se/tornar-se/virar/virar-se/tornar-se/virar/virar-se/tornar-se/virar/deslocar/mover/deslocar/mover/viajar/ir/caminhar/andar/deslocar/mexer/mover/deslocar/mexer/mover/deslocar/mexer/mover/transmitir/transformar/transmutar/mudar/mudar/modificar/alterar/alterar/mudar/alterar/mudar
vingar	penalizar/punir/castigar
imaginar	conjeturar/pensar/imaginar/conjecturar/imaginar/fazer/causar/provocar/criar
ilustrar	elaborar/expandir/elocubrar/expor
estourar	separar/dividir/desmoronar/explodir/arrebentar/estourar
bombardear	atacar/assaltar
animar	alegrar-se/regozijar-se/regozijar/alegrar/estimular/excitar/emocionar/comover/estimular/excitar/emocionar/comover/mudar/modificar/alterar/alterar/mudar/excitar/energizar/animar/estimular/excitar/energizar/animar/estimular/afetar/afectar
alçar	alçar/erguer/elevar/levantar/deslocar/mover
agradecer	passar/transmitir/apreciar/agradecer/imputar/atribuir
transcrever	escrever
recrudescer	acontecer/ocorrer/suceder/passar
minar	fluir/correr/explorar
lidar	governar/reger/cuidar/guiar/lidar/fazer/agir/atuar/fazer/agir/atuar/dar/entregar/iniciar/abordar/encetar
interpor	interagir/parar/interromper
inovar	pioneirar/ser_pioneiro/empreender/iniciar
incendiar	queimar/carburar/queimar/carburar
exagerar	papar/alimentar_se/comer/desinformar/enganar
desarmar	convencer/persuadir
desalojar	dividir/ejetar/separar/excluir/tirar/remover/retirar
debilitar	enfraquecer/enfraquecer/enfraquecer/mudar/modificar/alterar
crer	aceitar/crer/acreditar/crer/acreditar
amenizar	melhorar/aperfeiçoar/alterar/mudar
abortar	terminar/finalizar/concluir/encerrar/expelir/expulsar/liberar/ejetar
vislumbrar	observar/mirar/olhar/ver/olhar/ver/enxergar
sacrificar	o_fazendeiro_matou_um_porco_para_o_natal./matar
prover	prover/suprir/abastecer/fornecer/financiar/manter/dar/entregar/dar/entregar
protagonizar	dispõe/apresenta/executar/fazer/desempenhar
prosperar	virar/mudar/tornar
ensaiar	executar/fazer/desempenhar/julgar/avaliar/balizar
desestabilizar	mudar/modificar/alterar/alterar/mudar
cercear	encurtar/encolher/circunscrever/confinar/restringir/limitar
ativar	mudar/modificar/alterar
perturbar	fazer/agir/atuar/deslocar/mover/desgostar/desagradar/desconcertar/perturbar/confundir/emocionar/disturbar/perturbar/parecer/impressionar/comover/afetar
gerenciar	sobreviver/aguentar/lidar/virar-se/tratar/cuidar/tomar_conta/cuidar/guiar/lidar
especificar	estar/ser/elaborar/expandir/elocubrar/expor/seleccionar/escolher/selecionar/seleccionar/escolher/selecionar
errar	viajar/ir/caminhar/andar/viajar/ir/caminhar/andar
desafiar	resistir/desafiar/desafiar/convidar/pedir
compatibilizar	combinar/corresponder/concordar/relacionar_se/relacionar/relacionar-se/acertar/ajustar/corrigir/mudar/modificar/alterar
comercializar	explorar/mudar/modificar/alterar
coletar	cobrar/receber/obter/comprar/adquirir/buscar/procurar
avolumar	mudar/modificar/alterar
apertar	apinhar/apertar/pressionar/prensar/agarrar/segurar/estreitar/apertar/mudar/modificar/alterar/alterar/mudar
ancorar	prender/fixar
alternar	fazer/agir/atuar/tornar/inverter/virar/reverter
tencionar	mostrar/apresentar
tanger	afastar/tocar/desvanecer/rechaçar/afugentar
protelar	adiar
indenizar	pagar
honrar	reconhecer/aceitar
encobrir	esconder/encobrir/omitir/tampar/tapar/acobertar/ocultar/esconder/encobrir/omitir/tampar/tapar/acobertar/ocultar/esconder/encobrir/omitir/tampar/tapar/acobertar/ocultar/esconder/encobrir/omitir/tampar/tapar/acobertar/ocultar/cobrir/tampar/cobrir
disparar	fazer/agir/atuar/voar/correr
disfarçar	disfarçar/mascarar/esconder/encobrir/esconder/encobrir/omitir/tampar/tapar/acobertar/ocultar
chocar	emocionar/disturbar/perturbar/bater/colidir/atingir/bater/colidir/atingir
apagar	ligar/tirar/remover/tirar/remover/tirar/remover/retirar/mudar/modificar/alterar
socorrer	suportar/ajudar/apoiar/ajudar/assistir/auxiliar/socorrer/solidarizar_se/acorrer/melhorar/aperfeiçoar
revoltar	protestar
reingressar	associar-se/juntar-se/filiar_se/afiliar_se/ingressar
reconstruir	edificar/construir/hipotetizar/especular/teorizar/supor/conjecturar/mudar/modificar/alterar
propagar	viajar/ir/caminhar/andar/transmitir/procriar/gerar/reproduzir
enterrar	descartar/jogar_fora/esconder/encobrir/omitir/tampar/tapar/acobertar/ocultar/pôr/deitar/colocar
emanar	vir
desmontar	descer/baixar/cair
demover	delegar
consentir	concordar/aprovar/consentir/aceitar/concordar/aprovar/consentir/aceitar/concordar/aprovar/consentir/aceitar/suportar/tolerar/aguentar/aturar
confinar	colocar/carregar/botar/pôr/desativar/desabilitar/incapacitar/reduzir/diminuir
capacitar	alterar/mudar
atrelar	governar/reger/anexar/juntar/unir
uniformizar	mudar/modificar/alterar
salgar	preservar/conservar
relutar	resistir
pressupor	antecipar/pressupor/presumir/supor/assumir
normalizar	mudar/modificar/alterar/alterar/mudar
jantar	comer
gostar	amar/achar/considerar/ver
externar	mudar/modificar/alterar
encorajar	suportar/ajudar/apoiar/encorajar/alentar/encorajar/alentar/exaltar/animar/inspirar/induzir
desmantelar	tirar/remover/retirar
apregoar	mostrar/anunciar
abastecer	prover/suprir/abastecer/fornecer/prover/suprir/abastecer/fornecer/prover/suprir/abastecer/fornecer/prover/suprir/abastecer/fornecer/dar/entregar/dar/entregar
remodelar	forjar/formar/modelar/moldar/mudar/modificar/alterar
quitar	partir/abandonar/deixar/sair/largar/transmitir/comunicar
orçar	considerar/admitir/levar_em_conta/planejar/calcular/computar
notificar	informar/informar/informar/informar/informar
mergulhar	descer/baixar/cair/nadar/papar/alimentar_se/comer/iniciar/começar/principiar
inflamar	piorar/exacerbar/agravar/decair/piorar
indispor	mudar/modificar/alterar
impressionar	intimidar/aterrorizar/amedrontar/assustar/atemorizar/parecer/impressionar/comover/afetar/parecer/impressionar/comover/afetar
discriminar	distinguir/separar/diferenciar/distinguir/separar/diferenciar
descontar	trocar
descer	fazer/agir/atuar/descer/baixar/cair/descer/baixar/cair/viajar/ir/caminhar/andar
conflagrar	virar/mudar/tornar
apostar	apostar/jogar/apostar/jogar/apostar/jogar/apostar/jogar/jogar
apaziguar	conciliar/reconciliar
alarmar	avisar/alertar/advertir
vagar	viajar/ir/caminhar/andar/viajar/ir/caminhar/andar/viajar/ir/caminhar/andar/viajar/ir/caminhar/andar
transitar	passar/atravessar/passar/atravessar
ocultar	esconder/encobrir/omitir/tampar/tapar/acobertar/ocultar/esconder/encobrir/omitir/tampar/tapar/acobertar/ocultar/esconder/encobrir/omitir/tampar/tapar/acobertar/ocultar/alterar/mudar
naturalizar	esclarecer/explicar/adequar/ajustar/adaptar/adequar/ajustar/adaptar/mudar/modificar/alterar/mudar/modificar/alterar
nacionalizar	mudar/modificar/alterar/mudar/modificar/alterar
manufaturar	pensar/inventar/fazer/causar/provocar/criar
inteirar	completar/encher
desvalorizar	humilhar/rebaixar/mortificar/aviltar/piorar/exacerbar/agravar/mudar/modificar/alterar
demarcar	distinguir/separar/diferenciar/circunscrever/confinar/restringir/limitar
contatar	transmitir/comunicar
concitar	fazer/causar/provocar/criar/desafiar
cindir	dividir/separar/partir
aprimorar	melhorar/aperfeiçoar
amadurecer	desenvolver/progredir/amadurecer/mudar/modificar/alterar
alvejar	descolorir/colorir
acordar	deslocar/mexer/mover/alarmar/alertar/melhorar/aperfeiçoar/virar/mudar/tornar/virar/mudar/tornar/mudar/modificar/alterar
acomodar	satisfazer/servir/fornecer/prover/provisionar/abastecer/estabilizar-se/modelar/formar
zelar	ajudar/assistir/auxiliar/socorrer/solidarizar_se/acorrer
recordar	lembrar/relembrar/recordar
queimar	executar/arruinar/destroçar/estraçalhar/destruir/consumir/gastar/descolorir/colorir/avariar/danificar/virar/mudar/tornar/mudar
prescindir	abandonar
plantar	colocar/carregar/botar/pôr/colocar/carregar/botar/pôr/transmitir/comunicar
pavimentar	cobrir/revestir
imputar	julgar/avaliar/balizar
extrair	receber/obter/comprar/adquirir/fazer/causar/provocar/criar/seleccionar/escolher/selecionar/seleccionar/escolher/selecionar/compreender/entender/tirar/remover/retirar/tirar/remover/retirar
documentar	registar/registrar
contrabalançar	balancear/equilibrar/compensar
arrendar	dar/entregar
afinar	acertar/ajustar/corrigir/acertar/ajustar/corrigir/acertar/ajustar/corrigir
simpatizar	sentir/experimentar
partilhar	receber/obter/comprar/adquirir/partir/dividir/separar
ofender	provocar/magoar/ofender/encolerizar/enraivecer/irar/zangar
irritar	desgostar/desagradar/disconcertar/confundir/encolerizar/enraivecer/irar/zangar/encolerizar/enraivecer/irar/zangar/sentir/experimentar/piorar/exacerbar/agravar
inspecionar	ver/examinar/inspecionar/examinar/analizar/examinar/analizar
industrializar	mudar/modificar/alterar/mudar/modificar/alterar/alterar/mudar
falsificar	recriar/tornar/inverter/virar/reverter
erradicar	deslocar/mover/o_fazendeiro_matou_um_porco_para_o_natal./matar/o_fazendeiro_matou_um_porco_para_o_natal./matar
detonar	mudar/mudar
desprestigiar	esnobar/ignorar/menosprezar/deixar_de_lado/desconsiderar/descartar
assustar	intimidar/aterrorizar/amedrontar/assustar/atemorizar/estimular/excitar/emocionar/comover
alfabetizar	prover/suprir/abastecer/fornecer
acampar	morar/habitar/povoar/viver
secundar	suportar/ajudar/apoiar
relembrar	lembrar/relembrar/recordar
progredir	viajar/ir/caminhar/andar/desenvolver/progredir/aumentar/crescer/mudar/modificar/alterar
postar	despachar/remeter/enviar/mostrar/anunciar
pesquisar	analizar/pesquisar/analizar/pesquisar/analizar/pesquisar/analizar/pesquisar/examinar/analizar
perfazer	melhorar/aperfeiçoar
focalizar	jazer/acertar/ajustar/corrigir
eximir	desculpar/perdoar
equacionar	igualar/equivaler
enunciar	falar/contar/dizer
enaltecer	estimar/avaliar/medir
conferenciar	discutir
calcar	ferir/lesar/machucar/lesionar
ajuizar	desafiar
adicionar	constituir/enquadrar/compor/estabelecer/estar/ser/falar/contar/dizer/registar/registrar/enumerar/contar/calcular/computar/adicionar/somar/acrescentar/acrescer/acrescer/acrescentar/crescer/aumentar/mudar/modificar/alterar
tolerar	deixar/permitir/consentir/deixar/permitir/consentir
retratar	fazer/representar/atuar/representar
pegar	pegar_fogo/conflagrar/combustir/começar_a_queimar/acender/passar/reunir/encontrar/receber/obter/comprar/adquirir/escutar/ouvir_dizer/ouvir/sentir/aperceber/entender/perceber/aperceber-se/ir/viajar/andar/arruinar/destroçar/estraçalhar/destruir/transmitir/anexar/juntar/unir/agarrar/pegar/tomar/agarrar/pegar/tomar/segurar/agarrar/capturar/pegar/tornar/ficar/estar/alterar/mudar
multar	cobrar/coletar/arrecadar
interceptar	ouvir/dar_atenção_a/escutar/segurar/agarrar
improvisar	sobreviver/aguentar/lidar/virar-se/executar/fazer/desempenhar/cozinhar/preparar
hipotecar	dever
harmonizar	combinar/corresponder/concordar/relacionar_se/relacionar/relacionar-se/cantar
depredar	arruinar/destroçar/estraçalhar/destruir
decrescer	mudar_a_dimensão
certificar	conceder/premiar/outorgar/presentear/evidenciar/testificar/mostrar/testemunhar/atestar/provar/julgar/declarar/autorizar/permitir/autorizar/permitir
banir	expulsar/expulsar/expulsar/expulsar/afastar/tocar/desvanecer/rechaçar/afugentar
assimilar	mudar/modificar/alterar/alterar/mudar
aludir	passar/transmitir/referir/mencionar
alocar	lotear/atribuir
taxar	cobrar/coletar/arrecadar
subornar	pagar/pagar
sublinhar	enfatizar/acentuar/pontuar/marcar
repousar	estar/ser
renascer	excitar/energizar/animar/estimular
realçar	maquilar/maquiar
prenunciar	evidenciar/sugerir/indicar/sinalizar/denotar
olhar	observar/mirar/olhar/ver/observar/mirar/olhar/ver/observar/mirar/olhar/ver/observar/mirar/olhar/ver/aperceber/entender/perceber/aperceber-se/checar/conferir
invalidar	mudar/modificar/alterar
intimidar	afastar/tocar/desvanecer/rechaçar/afugentar/intimidar/aterrorizar/amedrontar/assustar/atemorizar/estimular/excitar/emocionar/comover
incorrer	alterar/mudar
hospedar	amparar/abrigar/entreter/divertir/servir/fornecer/prover/provisionar/abastecer/consumir/usar
habitar	estar/estar/morar/habitar/povoar/viver/ser/existir/ser/existir
federalizar	reunir/unificar
empatar	equiparar/igualar
diluir	enfraquecer
desorganizar	desordenar/bagunçar
desferir	deslocar/mover
cumprimentar	vir/acostar/cumprimentar/dirigir-se/saudar
clamar	requerer/necessitar/precisar/afirmar
atrapalhar	evitar/impedir/atrapalhar
assemelhar	parecer/assemelhar-se/assemelhar-se_a/assemelhar/combinar/corresponder/concordar
acobertar	esconder/encobrir/omitir/tampar/tapar/acobertar/ocultar/absolver/inocentar
treinar	limitar/controlar/refrear/leccionar/instruir/ensinar/lecionar/leccionar/instruir/ensinar/lecionar/preparar/educar/treinar/instruir/lustrar/refinar/polir/exercitar/malhar
sobrepor	continuar/estender/colocar/carregar/botar/pôr
sindicalizar	registar/inscrever/registrar/recrutar
riscar	deslocar/mexer/mover/fazer/causar/provocar/criar
revitalizar	fortalecer/fortificar
reavivar	excitar/energizar/animar/estimular
reaver	receber/obter/comprar/adquirir
ousar	fazer/agir/atuar/fazer/agir/atuar
monopolizar	governar/reger/ter
imobilizar	reter/conter/reter/conter
extrapolar	calcular/computar
empolgar	encorajar/alentar
divorciar	partir/separar_se/separar
desobedecer	rejeitar/recusar
desenhar	desenhar/criar/fazer/imaginar
convulsionar	contrair/comprimir/contrair/comprimir/rir/gargalhar
conformar	obedecer/mudar/modificar/alterar
colar	anexar/juntar/unir/anexar/juntar/unir/juntar/grudar/tocar/encostar
aspirar	planear/planejar
aportar	fazer/agir/atuar
alienar	passar/entregar/ceder/dar/transferir/parecer/impressionar/comover/afetar/providenciar/arranjar/mudar/modificar/alterar
alargar	mudar/modificar/alterar
acalmar	suprir/satisfazer/conciliar/reconciliar/aliviar/melhorar/atenuar/amenizar
abraçar	tocar/encostar/aceitar/iniciar/começar/principiar
vigiar	observar/espionar/guardar/mirar/olhar/ver
sinalizar	prover/suprir/abastecer/fornecer/levar/carregar/dirigir/conduzir/guiar/colocar/carregar/botar/pôr/informar/contar/evidenciar/sugerir/indicar/sinalizar/denotar/transmitir/comunicar
reviver	florescer/expandir/virar/mudar/tornar/excitar/energizar/animar/estimular
retrucar	falar/contar/dizer/responder/retrucar/replicar
reorientar	alterar/mudar
remanejar	delegar
redobrar	aprofundar/intensificar
expurgar	encurtar/condensar/abreviar/resumir
exacerbar	encolerizar/enraivecer/irar/zangar/mudar/modificar/alterar
espancar	bater/bater_repetidamente/manusear/tocar
dialogar	dialogar/falar/transmitir/comunicar
desfilar	ir/caminhar/andar
desaprovar	verbalizar/exprimir/proferir/expressar/julgar/avaliar/balizar/julgar/avaliar/balizar
advir	resultar/redundar/seguir/suceder/sobrevir
validar	autorizar/permitir/aceitar/mudar/modificar/alterar
testar	julgar/avaliar/balizar
recepcionar	cumprimentar/saudar
provir	tornar_se/tornar_se
interrogar	questionar/perguntar/questionar/perguntar
furtar	fazer/agir/atuar/segurar/agarrar/capturar/pegar
discorrer	tratar/falar/cobrir/endereçar/lidar
delimitar	estar/ser/circunscrever/confinar/restringir/limitar/conter/limitar/restringir
cristalizar	estar/ser/solidificar/modelar/formar/mudar
cantar	cantar/cantar/soltar/emitir/soltar/emitir/enunciar/articular/falar/dizer/pronunciar/proferir/falar/dizer/verbalizar/conversar/aconselhar/sugerir/propor
burlar	iludir/lograr/enganar
arrefecer	virar/mudar/tornar
armazenar	prover/suprir/abastecer/fornecer/manter/guardar/segurar/reter/manter/guardar/segurar/reter
anotar	escrever/compor/registar/registrar
urbanizar	acertar/ajustar/corrigir/mudar/modificar/alterar/mudar/modificar/alterar
subdividir	fraccionar/fender/repartir/dividir/separar/fracionar/partir/dividir/separar
sofisticar	aculturar/cultivar/treinar/escolar/civilizar/educar
simbolizar	significar/querer_dizer/indicar
sequestrar	tomar/capturar/pegar/tomar/capturar/pegar/alterar/mudar
sacar	deslocar/mover/compreender/entender/tirar/remover/retirar/tirar/remover/retirar/tirar/remover/retirar/tirar/remover/retirar/tirar/remover/retirar/tirar/remover/retirar/tirar/remover/retirar/tirar/remover/retirar/tirar/remover/retirar/tirar/remover/retirar/tirar/remover/retirar/tirar/remover/retirar/tirar/remover/retirar/tirar/remover/retirar/tirar/remover/retirar/tirar/remover/retirar
recolocar	colocar/carregar/botar/pôr
reagrupar	ajuntar/coletar/coligir/reunir/recolher/juntar
readquirir	comprar/adquirir/obter/atingir
reacender	florescer/expandir
piorar	avariar/danificar/decair/piorar/decair/piorar/decair/piorar/virar/mudar/tornar/virar/mudar/tornar/mudar/modificar/alterar
mediar	jazer
leiloar	vender
evocar	exprimir/expressar/mostrar
evadir	fazer/agir/atuar/escapar/evadir-se/fugir
escoltar	acompanhar
educar	leccionar/instruir/ensinar/lecionar/leccionar/instruir/ensinar/lecionar/lustrar/refinar/polir/melhorar/aperfeiçoar
desprezar	rejeitar/recusar
despachar	consignar/enviar/embarcar/despachar/transportar/trazer/expedir/deslocar/mover/transmitir/o_fazendeiro_matou_um_porco_para_o_natal./matar/o_fazendeiro_matou_um_porco_para_o_natal./matar
coroar	cobrir/tampar
blindar	aparelhar/equipar/suprir/apetrechar
atropelar	ferir/lesar/machucar/lesionar
arriscar	ser/existir/arriscar/procurar/tentar/procurar/tentar/afetar/impactar
acalentar	amar
voar	ir/viajar/andar/viajar/ir/caminhar/andar/viajar/ir/caminhar/andar/viajar/ir/caminhar/andar/deslocar/mexer/mover/controlar/operar
vestir	cobrir/virar/mudar/tornar/alterar/mudar/vestir/vestir-se/arrumar-se/vestir/vestir-se/arrumar-se/vestir/vestir-se/arrumar-se/cuidar-se
tutelar	relacionar/inter-relacionar
triplicar	reproduzir
subverter	arruinar/destroçar/estraçalhar/destruir/mudar/modificar/alterar
recompensar	fazer/agir/atuar/pagar/pagar
recomeçar	iniciar/começar/principiar/alterar/mudar
padronizar	regularizar/regulamentar/estimar/avaliar/medir/mudar/modificar/alterar
onerar	carregar
listar	protocolar/registar/registrar
inibir	tolher/evitar/estorvar/impedir/reter/entravar/atrapalhar/conter/limitar/restringir
diagnosticar	examinar/analizar/examinar/analizar
desacreditar	zoar/rir/pagodear/ridicularizar/sacanear/zombar/mangar/esnobar/ignorar/menosprezar/deixar_de_lado/desconsiderar/descartar/rejeitar
calar	alterar/mudar
arrancar	deslocar/mover/tirar/puxar/arredar/tirar/remover/retirar
anexar	suplementar/anexar/anexar/juntar/unir/anexar/juntar/unir/adicionar/somar/acrescentar/acrescer
ventilar	agitar/sacudir/tremer
torpedear	atacar/assaltar
salvaguardar	defender/proteger
rodar	girar/virar/virar-se/tornar-se/virar/deslocar/mover/viajar/ir/caminhar/andar
retificar	aprumar/achar/determinar/corrigir/retificar/substituir/converter/mudar/trocar/tornar/inverter/virar/reverter/mudar/modificar/alterar
repartir	mudar
reintroduzir	introduzir/apresentar
reinar	governar/reger/reinar/gerir/governar/reger
rebaixar	deslocar/mover/desvalorizar/rebaixar/aviltar/degradar/humilhar/rebaixar/mortificar/aviltar/provocar/magoar/ofender/hierarquizar/classificar/ranquiar/piorar/exacerbar/agravar
pintar	criar/fazer/cobrir/revestir/maquilar/maquiar
informatizar	prover/suprir/abastecer/fornecer
fragmentar	separar/dividir/desmoronar
edificar	fazer/causar/provocar/criar/leccionar/instruir/ensinar/lecionar
desqualificar	pronunciar/julgar/rotular/mudar/modificar/alterar
desconsiderar	tratar/rejeitar
computar	raciocinar
atracar	vir/aproximar-se_de/chegar/avizinhar/acercar/vir/chegar/prender/fixar/prender/fixar
testemunhar	informar
sonhar	aperceber/entender/perceber/aperceber-se/conjeturar/pensar/imaginar/conjecturar/conjeturar/pensar/imaginar/conjecturar/conjeturar/pensar/imaginar/conjecturar
saltar	deslocar/mover/viajar/ir/caminhar/andar/deslocar/mexer/mover/deslocar/mexer/mover/deslocar/mexer/mover
revezar	controlar/operar
reapresentar	informar/contar
readmitir	admitir/aceitar/admitir
postergar	adiar
portar	dispõe/apresenta/dispõe/apresenta/dispõe/apresenta
persuadir	influir/influenciar/induzir/persuadir
oficiar	fazer/efetuar/performar/exercer/servir
louvar	enaltecer/louvar/elogiar/enaltecer/louvar/elogiar/estimar/avaliar/medir
gritar	soltar/emitir/soltar/emitir/soltar/emitir/soltar/emitir/proferir/falar/dizer/verbalizar/conversar/verbalizar/exprimir/proferir/expressar/verbalizar/exprimir/proferir/expressar/gritar/esganiçar/berrar/gritar/berrar/gritar
escalar	montar/subir/trepar/galgar/montar/subir/trepar/galgar/montar/subir/trepar/galgar/deslocar/mexer/mover/avançar/progredir/mudar_a_dimensão
engendrar	fazer/causar/provocar/criar
encetar	discutir
economizar	gastar/despender/guardar/preservar/conservar/manter/poupar
dissociar	partir/separar_se/separar/distinguir/separar/diferenciar
democratizar	mudar/modificar/alterar/alterar/mudar
contrastar	distinguir/separar/diferenciar
congratular	sentir/experimentar/enaltecer/louvar/elogiar
cadastrar	indicar/assinalar
antever	fazer/agir/atuar/conjeturar/pensar/imaginar/conjecturar
amar	amar
agendar	destinar/planejar/planejar
afundar	aprumar/descer/baixar/cair/descer/baixar/cair/deslocar/mover/inundar
abrandar	mudar/modificar/alterar
trilhar	agitar/sacudir/tremer
subvencionar	pagar/financiar/manter
solidificar	mudar/mudar
relaxar	virar/mudar/tornar/virar/mudar/tornar/afetar/afectar
refinar	melhorar/aperfeiçoar/mudar/modificar/alterar/mudar/modificar/alterar
reerguer	edificar/construir
reaparelhar	aparelhar/equipar/suprir/apetrechar
ostentar	expor/apresentar/exibir/mostrar
mexer	deslocar/mover/deslocar/mover/deslocar/mover/deslocar/mexer/mover/deslocar/mexer/mover/deslocar/mexer/mover/mudar/modificar/alterar
ironizar	tratar
inundar	superar/cobrir/completar/encher/inundar
faturar	cobrar
entravar	evitar/impedir/atrapalhar
endurecer	amenizar/mudar/modificar/alterar/alterar/mudar/alterar/mudar/alterar/mudar/atuar/comportar-se/agir/parecer
encarnar	substanciar/concretizar/realizar
emancipar	virar/mudar/tornar
desculpar	desculpar/perdoar/conceder
confidenciar	passar/entregar/ceder/dar/divulgar/revelar/descerrar
colorir	influir/influenciar/afetar/impactar/mudar/modificar/alterar/alterar/mudar
castigar	penalizar/punir/castigar/mudar/modificar/alterar
barganhar	piorar/exacerbar/agravar
assaltar	disputar/lutar/brigar
arruinar	arruinar/destroçar/estraçalhar/destruir/arruinar/destroçar/estraçalhar/destruir
argüir	dialogar/conversar
ambicionar	ansiar/desejar/querer
aflorar	surgir/aparecer
acercar	vir
abarcar	incluir/abarcar/conter
transpor	tornar/inverter/virar/reverter
trancar	tolher/evitar/estorvar/impedir/reter/entravar/atrapalhar/superar/trancar/prender/fixar/prender/fixar
tombar	expirar/morrer/bater_as_botas/falecer/comer_capim_pela_raiz/perecer
sitiar	atacar/assaltar
revidar	penalizar/punir/castigar
reportar	mostrar/anunciar/mostrar/anunciar
repensar	achar/pensar
realocar	alocar
rasgar	cindir/rasgar/dividir/dividir/separar/partir
politizar	mudar/modificar/alterar
perdoar	desculpar/perdoar/desculpar/perdoar/conceder
minuciosamente	examinar/analizar
materializar	acontecer/ocorrer/suceder/passar
lavrar	trabalhar
instigar	promover/encorajar/estimular/induzir
infligir	transmitir/comunicar
guiar	governar/reger/governar/reger/conduzir/dirigir/levar/carregar/dirigir/conduzir/guiar/levar/carregar/dirigir/conduzir/guiar/manobrar/guiar/canalizar/dirigir/forçar/empurrar/deslocar/mover
fotografar	registar/registrar
foragir	escapar/evadir-se/fugir
focar	enfatizar/acentuar/pontuar/focar/centrar/concentrar/raciocinar/cogitar/pensar/refletir/acertar/ajustar/corrigir
empurrar	forçar/empurrar/forçar/empurrar/forçar/empurrar/forçar/empurrar/forçar/empurrar/deslocar/mover/deslocar/mover/deslocar/mover/viajar/ir/caminhar/andar/apertar/pressionar/prensar
empobrecer	privar
embutir	inserir/introduzir
desobrigar	passar/entregar/ceder/dar
desanimar	limitar/controlar/refrear
colidir	bater/colidir/atingir/bater/colidir/atingir
circunscrever	reduzir/diminuir
carecer	não_ter/carecer/faltar/necessitar
auferir	obter/receber/obter/comprar/adquirir/receber/obter/comprar/adquirir
atrever	fazer/agir/atuar/fazer/agir/atuar
asfaltar	cobrir/revestir
arquitetar	criar/fazer/criar/fazer/imaginar/destinar
aplacar	suprir/satisfazer
apadrinhar	suportar/ajudar/apoiar
zerar	acertar/ajustar/corrigir
truncar	substituir/trocar/adivinhar/aproximar/julgar/avaliar/chutar/estimar/encurtar/encolher
sobrecarregar	carregar/completar/encher/completar/encher
segurar	pospor/protelar/adiar/procrastinar/postergar/atrasar/delongar/prorrogar/evitar/impedir/atrapalhar/ter/manter/guardar/segurar/reter/cobrir/tampar/agarrar/pegar/tomar/segurar/agarrar/capturar/pegar/segurar/agarrar/capturar/pegar/defender/proteger
sedimentar	acumular/alterar/mudar
retransmitir	controlar/operar
reparar	falar/contar/dizer/melhorar/aperfeiçoar
reavaliar	estimar/avaliar/medir
perpetrar	fazer/agir/atuar
permear	correr/traspassar/perfurar/penetrar/traspassar/perfurar/penetrar/traspassar/perfurar/penetrar/enrolar
patentear	protocolar/registar/registrar
ofertar	prover/suprir/abastecer/fornecer
mentir	mentir/desinformar/enganar/desinformar/enganar
lesar	ferir/lesar/machucar/lesionar/doer/ferir/aleijar/machucar
irrigar	molhar
exemplificar	elaborar/expandir/elocubrar/expor
estranhar	verbalizar/exprimir/proferir/expressar/mudar/modificar/alterar
estigmatizar	classificar/rotular/marcar
enganar	iludir/lograr/enganar/vitimar/victimizar/desinformar/enganar/informar
dizimar	o_fazendeiro_matou_um_porco_para_o_natal./matar/o_fazendeiro_matou_um_porco_para_o_natal./matar
distorcer	significar/denotar/desmentir/representar/apresentar/modelar/formar
convir	combinar/corresponder/concordar
comedir	enfraquecer/mudar/modificar/alterar
balizar	raciocinar/cogitar/pensar/refletir
apedrejar	o_fazendeiro_matou_um_porco_para_o_natal./matar
apaixonar	parecer/impressionar/comover/afetar
almoçar	comer
alavancar	abrir
admirar	observar/mirar/olhar/ver/respeitar/prezar/venerar
acorrer	suportar/ajudar/apoiar
acender	pegar_fogo/conflagrar/combustir/começar_a_queimar/acender/pegar_fogo/conflagrar/combustir/começar_a_queimar/acender/construir/confeccionar/fabricar/virar/mudar/tornar
acantonar	fraccionar/fender/repartir/dividir/separar/fracionar
revender	vender
reequipar	substituir/trocar
redistribuir	distribuir/disseminar/espalhar
pulverizar	separar/desintegrar/separar/desintegrar/fragmentar
provisionar	dar/entregar
planificar	planejar
parabenizar	enaltecer/louvar/elogiar
orgulhar	sentir/experimentar
meter	fechar_(se)/acasalar/copular
mecanizar	aparelhar/equipar/suprir/apetrechar/mudar/modificar/alterar/mudar/modificar/alterar
legar	oferecer/dar_de_presente/dar/regalar/entregar
insultar	provocar/magoar/ofender/encolerizar/enraivecer/irar/zangar/verbalizar/exprimir/proferir/expressar
impregnar	completar/encher/completar/encher
habituar	mudar/modificar/alterar
golpear	acertar/bater/golpear
galvanizar	cobrir/revestir
galgar	ascender/subir
fortificar	fechar_(se)/adicionar/somar/acrescentar/acrescer/mudar/modificar/alterar
falir	avariar/danificar
estocar	prover/suprir/abastecer/fornecer
enxergar	aperceber/entender/perceber/aperceber-se
enraizar	colocar/pôr/plantar/estabilizar-se/aumentar/crescer
empunhar	manusear/manejar/manipular
dormir	repousar/descansar/cochilar/dormir
dissipar	dividir/separar/esbanjar/desperdiçar/dilapidar/delapidar
dissimular	disfarçar/mascarar/esconder/encobrir
desprover	reduzir/diminuir
deslanchar	começar/iniciar/começar/principiar
desertar	escapar/evadir-se/fugir
degolar	o_fazendeiro_matou_um_porco_para_o_natal./matar
danificar	avariar/danificar/avariar/danificar/mudar/modificar/alterar/ferir/lesar/machucar/lesionar
contra-atacar	atacar/assaltar
constrangir	desconcertar/perturbar/confundir/conter/limitar/restringir
comer	acasalar/copular/papar/alimentar_se/comer/comer/comer/ingerir/tomar/consumir/ingerir/tomar/consumir/ingerir/tomar/consumir/avariar/danificar
coagir	forçar/obrigar/compelir
calçar	adequar/ajustar/adaptar
atar	prender/fixar/prender/fixar/deter/manter/prender/confinar/reter/anexar/juntar/unir/ligar/amarrar/atar/conectar/ligar/amarrar/atar/conectar/modelar/formar
amanhecer	alterar/mudar
afrouxar	afrouxar/mudar/modificar/alterar
afigurar	conjeturar/pensar/imaginar/conjecturar
acessar	encontrar/reconquistar/recuperar/reganhar/re-adquirir/alcançar/chegar
vivenciar	receber/sofrer/experimentar
vazar	derramar/desaguar
varrer	continuar/estender/deslocar/mexer/mover/deslocar/mexer/mover/assear/limpar/purgar/esfregar/enxugar/limpar
trasladar	deslocar/mover
soldar	unir/juntar
sobrevir	provar/resultar
sintonizar	acertar/ajustar/corrigir
simular	reproduzir/recriar/desmentir/atuar/comportar-se/agir/parecer
satirizar	zoar/rir/pagodear/ridicularizar/sacanear/zombar/mangar
rivalizar	competir/concorrer/competir/concorrer
revestir	cobrir/tampar/cobrir/tampar/cobrir/tampar
retroceder	viajar/ir/caminhar/andar
ressuscitar	virar/mudar/tornar
presentear	alocar
pormenorizar	elaborar/expandir/elocubrar/expor/examinar/analizar
parcelar	fraccionar/fender/repartir/dividir/separar/fracionar
lucrar	auferir/beneficiar-se/ganhar/lucrar/beneficiar/auferir/ganhar/receber/obter/comprar/adquirir
logar	acessar
injetar	dispensar/administrar
incomodar	desgostar/desagradar/angustiar/doer/machucar/disconcertar/confundir/provocar/aborrecer/irritar/molestar/importunar/incomodar/assediar/provocar/aborrecer/irritar/molestar/importunar/incomodar/assediar/encolerizar/enraivecer/irar/zangar/parecer/impressionar/comover/afetar/afetar/impactar
imitar	imitar/copiar/imitar/copiar/parecer/assemelhar-se/assemelhar-se_a/assemelhar/simular/imitar/copiar/simular/imitar/copiar/reproduzir/recriar/copiar
gravitar	estar/ser/deslocar/mexer/mover
fretar	receber/obter/comprar/adquirir
fracionar	mudar
folgar	fazer/agir/atuar/deslocar/mover
familiarizar	informar
esposar	reunir/unificar/seleccionar/escolher/selecionar
escrúpulo	vacilar
entrever	olhar/ver/enxergar
encher	estar/papar/alimentar_se/comer/ingerir/tomar/consumir/completar/encher/completar/encher/completar/encher/completar/encher/completar/encher/virar/mudar/tornar/mudar/modificar/alterar/mudar/modificar/alterar
embaraçar	desconcertar/perturbar/confundir
embalar	estar/ser/deslocar/mover/deslocar/mover/cobrir/tampar/cobrir/tampar/cobrir/embrulhar/embalar
desfigurar	deteriorar/estragar/avariar/danificar
contentar	circunscrever/confinar/restringir/limitar
contaminar	contaminar/macular/manchar/sujar/mudar/modificar/alterar/mudar/modificar/alterar
contactar	transmitir/comunicar
compelir	forçar/obrigar/compelir/induzir
coexistir	ser/existir/ser/existir
baratear	piorar/exacerbar/agravar
balear	o_fazendeiro_matou_um_porco_para_o_natal./matar
amotinar	protestar
afugentar	deslocar/mover
afrontar	resistir
adulterar	tornar/inverter/virar/reverter
acoplar	unir/acoplar/juntar
abusar	tratar/esgotar/gastar/despender
viciar	habituar/habituar-se/acostumar-se/mudar/modificar/alterar
vacilar	adiar
ruir	alterar/mudar
rolar	virar-se/tornar-se/virar/deslocar/mexer/mover/deslocar/mexer/mover/achatar/aplainar/enxugar
revolucionar	mudar/modificar/alterar
retribuir	pagar
repor	colocar/carregar/botar/pôr
redimensionar	reduzir/diminuir
proliferar	aumentar/crescer
povoar	estar/completar/encher
planar	voar/avionar/pilotar/deslizar/passar_gradativamente_a/escorregar
pilotar	manobrar/guiar/canalizar/dirigir/controlar/operar
pichar	cobrir/revestir
obstinar	persistir/perseverar
motorizar	aparelhar/equipar/suprir/apetrechar/aparelhar/equipar/suprir/apetrechar/aparelhar/equipar/suprir/apetrechar
modelar	forjar/formar/modelar/moldar/construir/confeccionar/fabricar/recriar/mudar/modificar/alterar
limpar	esfregar/esvaziar/evaziar/esvaziar/evaziar/tirar/remover/retirar/tirar/remover/retirar/tirar/remover/retirar/tirar/remover/retirar/tirar/remover/retirar/tirar/remover/retirar/mudar/modificar/alterar/mudar/modificar/alterar/mudar/modificar/alterar/cuidar-se/cuidar-se/limpar/lavar/limpar/lavar
imperar	persuadir
humilhar	provocar/magoar/ofender
grampear	ouvir/dar_atenção_a/escutar/prender/fixar
furar	causar_dor/doer/fazer/causar/provocar/criar/perfurar/furar/perfurar/furar/traspassar/perfurar/penetrar/separar/dividir/desmoronar
filmar	fazer/causar/provocar/criar/registar/registrar/registar/registrar
escoar	manar/fluir/correr/esvaziar
erigir	edificar/construir
entrincheirar	prender/fixar
encenar	recriar
despencar	cair
desobstruir	mudar/modificar/alterar
desesperar	atuar/comportar-se/agir/parecer
descarregar	transferir/transmitir/trazer
desafogar	exprimir/expressar/mostrar
desabar	chover/chover_a_cântaros/chover_a_potes/chover_canivetes/chover_fortemente/mudar_a_dimensão/alterar/mudar
degradar	humilhar/rebaixar/mortificar/aviltar/piorar/exacerbar/agravar/decair/piorar
deduzir	manter/guardar/segurar/reter/calcular/computar/raciocinar/cogitar/pensar/refletir
curvar	torcer/dobrar/curvar/vergar/torcer/dobrar/curvar/vergar/torcer/dobrar/curvar/vergar/virar-se/tornar-se/virar/virar-se/tornar-se/virar/mudar_a_superfície/deformar
confeccionar	fazer/causar/provocar/criar
codificar	transformar/converter/transmudar
cingir	contornar/rodear/prender/fixar
arrepender	sentir/experimentar
arbitrar	jazer
aquecer	prover/suprir/abastecer/fornecer/virar/mudar/tornar/mudar/modificar/alterar/mudar/modificar/alterar/alterar/mudar
apanhar	receber/obter/comprar/adquirir/transportar/ajuntar/coletar/coligir/reunir/recolher/juntar/segurar/agarrar/capturar/pegar/jogar
aniquilar	o_fazendeiro_matou_um_porco_para_o_natal./matar
amarrar	construir/confeccionar/fabricar/prender/fixar/prender/fixar/deter/manter/prender/confinar/reter/anexar/juntar/unir/unir/juntar/ligar/amarrar/atar/conectar/ligar/amarrar/atar/conectar
alongar	deslocar/mexer/mover/alongar/aumentar/crescer/aumentar/ampliar/progredir/estressar/tensionar
alojar	morar/habitar/povoar/viver
aferir	distinguir/separar/diferenciar
usurpar	tomar/capturar/pegar
subestimar	adivinhar/aproximar/julgar/avaliar/chutar/estimar/calcular/computar
sobrar	estar/ser
seduzir	provocar/animar/excitar/persuadir/persuadir
sacudir	agitar/sacudir/tremer/oscilar/forçar/empurrar/deslocar/mover/deslocar/mexer/mover/lançar/atirar/jogar/gesticular/mudar/modificar/alterar/mover_involuntariamente/mover_reflexivamente/mover_involuntariamente
ridicularizar	zoar/rir/pagodear/ridicularizar/sacanear/zombar/mangar/zoar/rir/pagodear/ridicularizar/sacanear/zombar/mangar/zombar/ironizar/menosprezar/zombar/ironizar/menosprezar
revistar	ver/examinar/inspecionar/ver/examinar/inspecionar
reinstalar	restabelecer/instalar/colocar
refazer	moldar/fundir/mudar/modificar/alterar
reexaminar	examinar/analizar
reabilitar	restabelecer/restabelecer
quadruplicar	reproduzir
presumir	evidenciar/testificar/mostrar/testemunhar/atestar/provar/antecipar/atuar/comportar-se/agir/parecer
pontuar	exprimir/expressar/mostrar/adicionar/somar/acrescentar/acrescer
objetar	estar/ser
naufragar	descer/baixar/cair
modular	proferir/falar/dizer/verbalizar/conversar/acertar/ajustar/corrigir/acertar/ajustar/corrigir
mitigar	reduzir/diminuir
mirar	observar/mirar/olhar/ver/observar/mirar/olhar/ver/observar/mirar/olhar/ver/situar/posicionar/checar/conferir
mapear	calcular/computar
lotear	fraccionar/fender/repartir/dividir/separar/fracionar/conceder/lidar/entregar
largar	deslocar/mover/alterar/mudar
laminar	cobrir/tampar/cobrir/revestir
internacionalizar	governar/reger/mudar/modificar/alterar
iludir	vitimar/victimizar
igualar	competir/concorrer/mudar_a_superfície/mudar/modificar/alterar
flutuar	mostrar/apresentar/deslocar/mover/viajar/ir/caminhar/andar/virar/mudar/tornar
florescer	desabrochar/florir/florescer/desenvolver/progredir/desenvolver/progredir/aumentar/crescer
festejar	celebrar
exercitar	executar/fazer/desempenhar
estremecer	agitar/sacudir/tremer/tremular/tiritar/estremecer/tremer/mover_involuntariamente/mover_reflexivamente/mover_involuntariamente
emocionar	parecer/impressionar/comover/afetar/estimular/excitar/emocionar/comover/fazer/representar/atuar
distrair	disconcertar/confundir
desordenar	mudar/modificar/alterar
desmerecer	reduzir/diminuir
descontrolar	desconcertar/perturbar/confundir
descansar	estar/ser/sentar/sentar-se/estar_sentado
desaguar	distribuir/disseminar/espalhar
deformar	modelar/formar/deformar/deformar/mudar/modificar/alterar/alterar/mudar
decifrar	ler
decair	descer/baixar/cair/decair/piorar/virar/mudar/tornar/mudar/alterar/mudar
corroer	avariar/danificar/avariar/danificar
conectar	prender/fixar/unir/acoplar/juntar/raciocinar/cogitar/pensar/refletir
brigar	disputar/lutar/brigar
avizinhar	vir
atritar	tocar/encostar
atemorizar	afastar/tocar/desvanecer/rechaçar/afugentar/estimular/excitar/emocionar/comover
asfixiar	contrair/comprimir/o_fazendeiro_matou_um_porco_para_o_natal./matar/expirar/morrer/bater_as_botas/falecer/comer_capim_pela_raiz/perecer/sofrer/doer
ansiar	ansiar/desejar/querer
amortizar	liquidar/terminar_de_pagar
afligir	desconcertar/perturbar/confundir/emocionar/disturbar/perturbar/avariar/danificar
afixar	anexar/juntar/unir/anexar/juntar/unir
adorar	amar/amar/amar
acalorar	virar/mudar/tornar
abreviar	reduzir/diminuir/encurtar/encolher/encurtar/encolher/encurtar/condensar/abreviar/resumir/encurtar/condensar/abreviar/resumir
urgir	aconselhar/sugerir/propor/impelir/exortar/urgir
transpirar	evaporar/vaporizar/alterar/mudar
tapar	tolher/evitar/estorvar/impedir/reter/entravar/atrapalhar/esconder/encobrir/omitir/tampar/tapar/acobertar/ocultar
subtrair	calcular/computar/diminuir/reduzir
submergir	afundar/naufragar/deslocar/mover/cobrir/tampar/cobrir
subjugar	limitar/controlar/refrear
suavizar	amortecer/enfraquecer/mudar/modificar/alterar/mudar/modificar/alterar/alterar/mudar
sobrevoar	viajar/ir/caminhar/andar
seriar	arranjar/dispor
semear	semear/plantar/colocar/carregar/botar/pôr
rotular	anexar/juntar/unir/denominar/designar/julgar/declarar/distinguir/separar/diferenciar
respirar	existir/viver/subsistir/sobreviver/estar/ser
reputar	achar/pensar
renomear	denominar/chamar/nomear
principiar	estar/ser
premeditar	ruminar/ponderar/cogitar/especular/contemplar/refletir
personificar	fazer/representar/atuar/representar/imputar/atribuir
perfurar	perfurar/furar/traspassar/perfurar/penetrar/traspassar/perfurar/penetrar
padecer	estar/ser/sofrer/doer
ovacionar	gesticular
nutrir	servir/fornecer/prover/provisionar/abastecer
molhar	prover/suprir/abastecer/fornecer/molhar/molhar/mudar/modificar/alterar
ludibriar	iludir/lograr/enganar
lavar	estar/ser/lavar/assear/limpar/purgar/tirar/remover/retirar/tirar/remover/retirar/cuidar-se/limpar/lavar
inutilizar	enfraquecer
iluminar	iluminar-se/iluminar/alterar/mudar
frutificar	dar/dar/melhorar/aperfeiçoar/melhorar/procriar/gerar/reproduzir
favelar	passar
fartar	ingerir/tomar/consumir
evacuar	esvaziar/evaziar/esvaziar/evaziar
esfacelar	alterar/mudar
envergonhar	forçar/obrigar/compelir/desconcertar/perturbar/confundir
encaixar	inserir/introduzir/adequar/ajustar/adaptar
eletrificar	completar/encher/adequar/ajustar/adaptar
dourar	cozinhar
discernir	examinar/analizar
devastar	arruinar/destroçar/estraçalhar/destruir/o_fazendeiro_matou_um_porco_para_o_natal./matar
desvirtuar	esgotar/gastar/despender/significar/denotar/mudar/modificar/alterar
despender	pagar
desencantar	sentir/experimentar
descrer	rejeitar
denegar	reter/conter
decolar	partir/departir/sair
debandar	fazer/agir/atuar/escapar/evadir-se/fugir
datilografar	escrever/redigir
cristianizar	adequar/ajustar/adaptar
corromper	pagar/mudar/modificar/alterar
confabular	pioneirar/ser_pioneiro/empreender/iniciar/fabricar/manufaturar/inventar/dialogar/conversar/dialogar/conversar/discutir
chorar	expressar_sentimentos/mudar/modificar/alterar/chorar/choramingar
cavar	cavar/cavar/cavar/tirar/remover/retirar
aterrissar	vir/chegar/vir/chegar
arranjar	pioneirar/ser_pioneiro/empreender/iniciar/colocar/carregar/botar/pôr/servir/fornecer/prover/provisionar/abastecer/servir/fornecer/prover/provisionar/abastecer/acordar/concordar/hierarquizar/classificar/ranquiar
aparentar	combinar/corresponder/concordar/estar/ser/desmentir
aparar	estar/ser
amortecer	amenizar/mudar/modificar/alterar/mudar/modificar/alterar
alhear	parecer/impressionar/comover/afetar/mudar/modificar/alterar
aglomerar	acrescer/acrescentar/crescer/aumentar
acuar	manobrar/guiar/canalizar/dirigir
acostumar	habituar/habituar-se/acostumar-se
vibrar	tremular/tiritar/estremecer/tremer/deslocar/mexer/mover/estimular/excitar/emocionar/comover
vasculhar	revistar/procurar/buscar/revistar/procurar/buscar
tolher	evitar/impedir/atrapalhar
sumariar	falar/contar/dizer
sucumbir	dar/entregar/concordar/aprovar/consentir/aceitar/expirar/morrer/bater_as_botas/falecer/comer_capim_pela_raiz/perecer
reverenciar	amar/respeitar/prezar/venerar
reunificar	reunir/unificar
replicar	reproduzir/falar/contar/dizer/responder/retrucar/replicar/responder/retrucar/replicar
relativizar	achar/considerar/ver
refiliar	associar-se/juntar-se/filiar_se/afiliar_se/ingressar
quantificar	exprimir/transmitir
puxar	deslocar/mover/tirar/puxar/arredar/tirar/puxar/arredar/tirar/puxar/arredar/tirar/remover/retirar/ferir/lesar/machucar/lesionar
professar	dialogar/falar
prefaciar	falar/contar/dizer
pousar	vir/chegar/descer/baixar/cair/sentar/sentar-se/estar_sentado
personalizar	edificar/construir/mudar/modificar/alterar/mudar/modificar/alterar
perecer	virar/mudar/tornar
otimizar	aperfeiçoar/perfazer/amenizar
obscurecer	superar/mudar/modificar/alterar
navegar	manobrar/guiar/canalizar/dirigir/andar/viajar/viajar/ir/caminhar/andar/buscar/procurar
namorar	fazer/agir/atuar
mutilar	avariar/danificar/ferir/lesar/machucar/lesionar
moldar	forjar/formar/modelar/moldar/construir/confeccionar/fabricar/fazer/provocar/causar/modelar/formar
meditar	raciocinar/cogitar/pensar/refletir
maximizar	explorar/aumentar/ampliar/progredir
mascarar	disfarçar/mascarar/esconder/encobrir/esconder/encobrir/omitir/tampar/tapar/acobertar/ocultar
manchar	dispersar_se/esfregar/deteriorar/estragar/mudar_a_superfície/mudar/modificar/alterar/mudar/modificar/alterar
licitar	vender
irmanar	crescer
inventar	pensar/inventar/conceber/conceitualizar/imaginar/imaginar/imaginar
interiorizar	imputar/atribuir
incapacitar	mudar/modificar/alterar/ferir/lesar/machucar/lesionar
hierarquizar	julgar/avaliar/balizar
fluir	manar/fluir/correr/deslocar/mexer/mover/deslocar/mexer/mover
fascinar	interessar/absorver/engajar/ocupar
esterilizar	desinfectar/desinfetar/operar
estatizar	mudar/modificar/alterar
espionar	checar/conferir
escavar	descobrir/revelar/trazer/escavar/explorar/esvaziar/evaziar/tirar/remover/retirar
escalonar	arranjar/dispor
engolir	beber/tomar/papar/alimentar_se/comer/ingerir/tomar/consumir/crer/acreditar/suportar/tolerar/aguentar/aturar
encurtar	reduzir/diminuir/diminuir/reduzir
drenar	consumir/gastar/esvaziar/evaziar
dramatizar	escrever/compor/representar
despejar	prover/suprir/abastecer/fornecer/dividir/ejetar/separar/excluir/dividir/ejetar/separar/excluir/verbalizar/exprimir/proferir/expressar
desmoronar	desconcertar/perturbar/confundir/separar/desintegrar/mudar/mudar/alterar/mudar/alterar/mudar/atuar/comportar-se/agir/parecer
desintegrar	desconcertar/perturbar/confundir/mudar/mudar/modificar/alterar
descongelar	amolecer/derreter/degelar/descongelar
degenerar	decair/piorar
curar	melhorar/melhorar
criminalizar	tratar
copiar	parecer/assemelhar-se/assemelhar-se_a/assemelhar/simular/imitar/copiar/reproduzir/recriar/copiar/fazer/causar/provocar/criar
conglomerar	acrescer/acrescentar/crescer/aumentar
comungar	transmitir/comunicar
comprimir	estreitar/apertar
cobiçar	ansiar/desejar/querer
catalogar	classificar
batalhar	procurar/tentar/disputar/lutar/brigar/disputar/lutar/brigar
atribular	avariar/danificar
arrogar	reclamar/reivindicar
amarelar	descolorir/colorir
agüentar	deixar/permitir/consentir
afogar	estar/ser/o_fazendeiro_matou_um_porco_para_o_natal./matar/cobrir/expirar/morrer/bater_as_botas/falecer/comer_capim_pela_raiz/perecer
transplantar	inserir/introduzir
transgredir	passar/atravessar
tragar	fumar/fumar
temperar	aplicar/colocar/acertar/ajustar/corrigir/enfraquecer/amenizar/mudar/modificar/alterar/mudar/modificar/alterar
surrar	golpear/bater
soterrar	esconder/encobrir/omitir/tampar/tapar/acobertar/ocultar/pôr/deitar/colocar
soar	soar/tocar/soar/tocar/soar/soar/ressoar/fazer/soar/ressoar/fazer/aparecer_como/parecer/mostrar/anunciar
sincronizar	controlar/operar/organizar/ordenar/arrumar/acontecer/ocorrer/suceder/passar/acertar/ajustar/corrigir/mudar/modificar/alterar
rondar	estar/ser/ir/caminhar/andar
reposicionar	deslocar/mover/colocar/carregar/botar/pôr
reordenar	arranjar/dispor/hierarquizar/classificar/ranquiar
reinterpretar	compreender/entender
regredir	alterar/mudar
redimir	trocar/pagar
recensear	enumerar/contar
pretextar	desmentir
pressurizar	conservar/reter/manter/acertar/ajustar/corrigir/mudar/modificar/alterar
pisotear	ir/caminhar/andar/ir/caminhar/andar/ferir/lesar/machucar/lesionar
pisar	pisar/caminhar/andar/viajar/ir/caminhar/andar
picar	causar_dor/doer/perfurar/furar/perfurar/furar
penhorar	prometer
molestar	desgostar/desagradar
mesclar	unificar/amalgamar/misturar
liberalizar	mudar/modificar/alterar/alterar/mudar
ladear	jazer
intrometer	parar/interromper
inferir	crer/acreditar/resolver/solucionar/raciocinar/cogitar/pensar/refletir
individualizar	distinguir/separar/diferenciar/modelar/formar
impelir	fazer/provocar/causar/induzir
impactar	mudar/modificar/alterar
humanizar	mudar/modificar/alterar
granar	deformar
fumar	ingerir/tomar/consumir
flagelar	penalizar/punir/castigar
filtrar	traspassar/perfurar/penetrar
fender	fazer/causar/provocar/criar/mudar
federar	reunir/unificar
extraditar	expulsar
exclamar	proferir/falar/dizer/verbalizar/conversar/verbalizar/exprimir/proferir/expressar
exasperar	encolerizar/enraivecer/irar/zangar/encolerizar/enraivecer/irar/zangar
estrelar	dispõe/apresenta/executar/fazer/desempenhar
estrangular	contrair/comprimir/contrair/comprimir/o_fazendeiro_matou_um_porco_para_o_natal./matar/expirar/morrer/bater_as_botas/falecer/comer_capim_pela_raiz/perecer
espantar	afastar/tocar/desvanecer/rechaçar/afugentar
esfriar	virar/mudar/tornar/mudar/modificar/alterar/atuar/comportar-se/agir/parecer
escutar	obedecer/ouvir/dar_atenção_a/escutar/aperceber/entender/perceber/aperceber-se/aperceber/entender/perceber/aperceber-se/focar/centrar/concentrar
erodir	avariar/danificar/tirar/remover/retirar
entoar	cantar/pronunciar/julgar/rotular
engordar	virar/mudar/tornar/mudar/modificar/alterar
encurralar	manobrar/guiar/canalizar/dirigir
encantar	governar/reger/interessar
digitalizar	mudar/modificar/alterar/dispensar/administrar
devassar	atuar/comportar-se/agir/parecer
desunir	partir/dividir/separar
desfraldar	preparar/educar/treinar/instruir/mudar_a_superfície
desembolsar	pagar
desacelerar	mudar/modificar/alterar
denotar	informar/contar/significar
deitar	colocar/carregar/botar/pôr
dançar	deslocar/mexer/mover/deslocar/mexer/mover/deslocar/mexer/mover
constitucionalizar	prover/suprir/abastecer/fornecer/mudar/modificar/alterar
condensar	reduzir/diminuir/encurtar/condensar/abreviar/resumir/tirar/remover/retirar/mudar/modificar/alterar
colecionar	receber/obter/comprar/adquirir
chutar	dançar/propulsionar/propulsar/tocar/impulsionar/golpear/bater/adivinhar/aproximar/julgar/avaliar/chutar/estimar/calcular/computar
chantagear	influir/influenciar
brincar	fazer/agir/atuar/viajar/ir/caminhar/andar/simular/fingir/manusear/manejar/manipular/atuar/comportar-se/agir/parecer/atuar/comportar-se/agir/parecer
bradar	proferir/falar/dizer/verbalizar/conversar/verbalizar/exprimir/proferir/expressar/berrar/gritar
botar	deslocar/mover/pôr/deitar/colocar
beber	beber/tomar/consumir/usar/ingerir/tomar/consumir/ingerir/tomar/consumir/focar
aviltar	humilhar/rebaixar/mortificar/aviltar/provocar/magoar/ofender/mudar/modificar/alterar
aventurar	arriscar/proceder/especular
atormentar	angustiar/doer/machucar/angustiar/doer/machucar/provocar/aborrecer/irritar/molestar/importunar/incomodar/assediar/ferir/lesar/machucar/lesionar
atomizar	fragmentar
aterrorizar	coagir/forçar/compelir/obrigar/intimidar/aterrorizar/amedrontar/assustar/atemorizar/estimular/excitar/emocionar/comover
assomar	parecer
asseverar	comportar-se/resistir/conduzir/teimar/insistir
amordaçar	aparelhar/equipar/suprir/apetrechar/ligar/amarrar/atar/conectar
amedrontar	intimidar/aterrorizar/amedrontar/assustar/atemorizar/estimular/excitar/emocionar/comover
alentar	encorajar/alentar/exaltar/animar/inspirar
alcunhar	denominar/chamar/nomear
acamar	aprumar
vistoriar	inspeccionar/inspecionar/vistoriar/ver/examinar/inspecionar
verter	entornar/verter/derramar/manar/fluir/correr/deslocar/mover/deslocar/mover/deslocar/mover
vaticinar	evidenciar/sugerir/indicar/sinalizar/denotar
varar	parecer/impressionar/comover/afetar/traspassar/perfurar/penetrar
traumatizar	ferir/lesar/machucar/lesionar
transfigurar	tornar/inverter/virar/reverter/mudar/modificar/alterar
transacionar	interagir
torrar	gastar/despender/cozinhar
sumir	escapar/evadir-se/fugir
soprar	informar
socializar	interagir/aprontar/preparar/mudar/modificar/alterar
segregar	manar/fluir/correr
saturar	mudar/modificar/alterar
safar	escapar/fugir/escapulir/foragir
rodear	tocar/encostar
robustecer	cobrir/tampar
revolver	deslocar/mover/revistar/procurar/buscar
retalhar	provocar/aborrecer/irritar/molestar/importunar/incomodar/assediar/fragmentar
resignar	partir/abandonar/deixar/sair/largar/aceitar
repatriar	admitir
regenerar	recriar/fazer/causar/provocar/criar/melhorar/aperfeiçoar/aumentar/ampliar/progredir/mudar/modificar/alterar/alterar/mudar
reembolsar	repagar/restituir/reintegrar/retribuir
redirecionar	enviar/lançar
recontar	recriar/enumerar/contar/informar
rechear	emendar/reparar/consertar
rebentar	desenvolver/progredir
ratear	alienar/dispor/soar/ressoar/fazer
ramificar	aumentar/crescer/alterar/mudar
rachar	fraccionar/fender/repartir/dividir/separar/fracionar/glorificar/louvar/exaltar/mudar/modificar/alterar/alterar/mudar
primar	ser/existir
posar	comportar-se/resistir/conduzir/expor/apresentar/exibir/mostrar/colocar/carregar/botar/pôr
pescar	segurar/agarrar
perigar	ser/existir
passear	ir/progredir/avançar/prosseguir/seguir/continuar/ir/caminhar/andar/ir/caminhar/andar/ir/caminhar/andar/viajar/ir/caminhar/andar
orquestrar	planejar
ofuscar	mudar/modificar/alterar
minguar	reduzir/diminuir/mudar_a_dimensão
matizar	influir/influenciar
massacrar	o_fazendeiro_matou_um_porco_para_o_natal./matar/o_fazendeiro_matou_um_porco_para_o_natal./matar
macular	deteriorar/estragar/mudar/modificar/alterar
lixar	alisar/alisar
lastimar	afligir-se/magoar/sofrer
internalizar	imputar/atribuir
inter-relacionar	estar/ser/conectar/associar/relacionar
injustiçar	tratar
inflar	expandir
inchar	intoxicar/elevar/expandir/expandir/inflar/inchar/entumescer/inflar/inchar/entumescer
hipertrofiar	aumentar/crescer
hastear	alçar/erguer/elevar/levantar
gratificar	oferecer/dar_de_presente/dar/regalar/entregar
gear	precipitar/cair
fraturar	interromper/suspender/parar/ferir/lesar/machucar/lesionar
fincar	bater/bater_repetidamente
exultar	alegrar-se/regozijar-se/regozijar/alegrar/intoxicar/elevar/animar-se/alegrar-se/animar/alegrar
extirpar	deslocar/mover/tirar/remover/retirar
exterminar	o_fazendeiro_matou_um_porco_para_o_natal./matar
exaurir	consumir/gastar/esvaziar/evaziar/exaurir/exaurir-se/cansar-se/indispor
esquentar	prover/suprir/abastecer/fornecer/virar/mudar/tornar/mudar/modificar/alterar/mudar/modificar/alterar/alterar/mudar
espremer	apertar/pressionar/prensar/apertar/pressionar/prensar/agarrar/segurar
escancarar	estar/ser
enxugar	esfregar/enxugar/limpar/esfregar/beber/tomar/ingerir/tomar/consumir/modelar/formar/mudar/modificar/alterar
envenenar	corromper/perverter/subverter/aviltar/depravar/viciar/desvirtuar/o_fazendeiro_matou_um_porco_para_o_natal./matar/o_fazendeiro_matou_um_porco_para_o_natal./matar/mudar/modificar/alterar/mudar/modificar/alterar
engessar	cobrir/tampar/cobrir/revestir
emudecer	parecer/impressionar/comover/afetar
emboscar	esperar/aguardar/iludir/lograr/enganar/manobrar/guiar/canalizar/dirigir/atacar/assaltar
ecoar	parecer/assemelhar-se/assemelhar-se_a/assemelhar/soar/ressoar/fazer/soltar/emitir
driblar	bater
devorar	arruinar/destroçar/estraçalhar/destruir/engolir/ingurgitar/deglutir/comer/papar/alimentar_se/comer/papar/alimentar_se/comer/papar/alimentar_se/comer/papar/alimentar_se/comer/papar/alimentar_se/comer/comer
destilar	fazer/causar/provocar/criar/melhorar/aperfeiçoar/alterar/mudar
despovoar	reduzir/diminuir
desperdiçar	gastar/despender/gastar/despender/esgotar/gastar/despender/esbanjar/desperdiçar/dilapidar/delapidar
desinfetar	assear/limpar/purgar
descortinar	descobrir/revelar/trazer
descontrair	virar/mudar/tornar
desconcertar	desconcertar/perturbar/confundir
descolar	partir/dividir/separar
derramar	prover/suprir/abastecer/fornecer/manar/fluir/correr/deslocar/mover/deslocar/mover/deslocar/mover/distribuir/disseminar/espalhar
debitar	calcular/contar/computar/contabilizar/pagar
custodiar	observar/espionar/guardar/mirar/olhar/ver
consertar	emendar/reparar/consertar/emendar/reparar/consertar/melhorar/aperfeiçoar/mudar/modificar/alterar
confederar	reunir/unificar
civilizar	lustrar/refinar/polir/mudar/modificar/alterar
catalisar	virar/mudar/tornar
caiar	cobrir/tampar
auscultar	ver/examinar/inspecionar
atalhar	fazer/causar/provocar/criar/encurtar/encolher/encurtar/encolher
arrombar	acertar/bater/golpear/abrir/separar/dividir/desmoronar
arremeter	correr/lançar/atirar/jogar
arrebentar	separar/desintegrar/separar/dividir/desmoronar/separar/dividir/desmoronar/separar/dividir/desmoronar
arranhar	raspar/rascar/coçar/raspar/roçar/tocar/encostar/ferir/lesar/machucar/lesionar
arguir	dialogar/conversar/representar/apresentar/representar/apresentar/impelir/exortar/urgir
apunhalar	empurrar/propulsionar/ferir/lesar/machucar/lesionar
aprazar	determinar
apear	descer/baixar/cair
apartar	dividir/separar/partir
amontoado	cobrir/tampar
amoldar	forjar/formar/modelar/moldar
alinhavar	fazer/causar/provocar/criar/unir/acoplar/juntar/discutir
algemar	deter/manter/prender/confinar/reter
aguerrir	disputar/lutar/brigar
agenciar	discutir
aduzir	tirar/puxar/arredar/evidenciar/testificar/mostrar/testemunhar/atestar/provar
abstrair	achar/considerar/ver
abocanhar	agarrar/segurar
abaixar	reduzir/diminuir
visualizar	conjeturar/pensar/imaginar/conjecturar/conjeturar/pensar/imaginar/conjecturar/mudar/modificar/alterar
vergar	deformar
verbalizar	fazer/causar/provocar/criar/proferir/falar/dizer/verbalizar/conversar/transmitir/comunicar/transformar/converter/transmudar
venerar	respeitar/prezar/venerar/achar/considerar/ver
vegetar	viver/crescer/pegar_leve/relaxar/descontrair
trucidar	o_fazendeiro_matou_um_porco_para_o_natal./matar
tremer	agitar/sacudir/tremer/agitar/sacudir/tremer/tremular/tiritar/estremecer/tremer/tremular/tiritar/estremecer/tremer/deslocar/mexer/mover/deslocar/mexer/mover/tirar/puxar/arredar/mover_involuntariamente/mover_reflexivamente/mover_involuntariamente/mover_involuntariamente/mover_reflexivamente/mover_involuntariamente/mover_involuntariamente/mover_reflexivamente/mover_involuntariamente
transviar	levar/carregar/dirigir/conduzir/guiar
transtornar	emocionar/disturbar/perturbar
transmutar	alterar/mudar
transmudar	mudar/modificar/alterar/mudar/modificar/alterar
transladar	deslocar/mover/deslocar/mover/deslocar/mover
transar	dançar/acasalar/copular
tranquilizar	afetar/afectar
traficar	comerciar/comerciar
torcer	significar/denotar/modelar/formar/deformar/deformar/deformar/ferir/lesar/machucar/lesionar
sussurrar	soar/ressoar/fazer/proferir/falar/dizer/verbalizar/conversar
sujar	estar/ser/contaminar/macular/manchar/sujar/mudar/modificar/alterar
sugar	beber/tomar
soçobrar	virar/derrubar
sobressaltar	parecer/impressionar/comover/afetar
segmentar	partir/dividir/separar
sangrar	expelir/expulsar/liberar/ejetar
sambar	dançar
saciar	suprir/satisfazer/ingerir/tomar/consumir
revalorizar	acrescer/acrescentar/crescer/aumentar
retorquir	responder/retrucar/replicar
retaliar	penalizar/punir/castigar
repulsar	desgostar/desagradar
remendar	emendar/reparar/consertar
reler	ler
reinvindicar	comportar-se/resistir/conduzir/teimar/insistir
refrescar	virar/mudar/tornar/mudar/modificar/alterar/mudar/modificar/alterar/alterar/mudar
reenviar	enviar/embarcar/despachar/transportar/trazer/expedir
recobrir	cobrir/tampar/cobrir/revestir
reclassificar	classificar
recitar	executar/fazer/desempenhar/recriar/repetir/ecoar/recitar/recitar
recapturar	sentir/experimentar/pegar/capturar
recalcular	calcular/computar
recalcar	sentir/experimentar
reanimar	excitar/energizar/animar/estimular
raspar	cortar/raspar/roçar/ferir/lesar/machucar/lesionar/cuidar-se
rascunhar	escrever/compor/desenhar/descrever
raciocinar	raciocinar/raciocinar/cogitar/pensar/refletir
purificar	melhorar/aperfeiçoar/mudar/modificar/alterar/alterar/mudar/alterar/mudar
pular	viajar/ir/caminhar/andar/deslocar/mexer/mover/deslocar/mexer/mover/deslocar/mexer/mover/deslocar/mexer/mover/lançar/atirar/jogar
prostituir	vender
propagandear	pronunciar/julgar/rotular/informar/contar
prezar	achar/considerar/ver
prefigurar	evidenciar/sugerir/indicar/sinalizar/denotar
porvir	evoluir/desenvolver
poluir	contaminar/macular/manchar/sujar
permutar	trocar
perambular	estar/ser/inspeccionar/inspecionar/vistoriar/ir/caminhar/andar/viajar/ir/caminhar/andar/viajar/ir/caminhar/andar
particularizar	elaborar/expandir/elocubrar/expor
parodiar	fazer/representar/atuar
oxigenar	mudar/modificar/alterar
numerar	denominar/designar
moer	fragmentar/moer/triturar
mensurar	exprimir/transmitir/resolver/decidir
menosprezar	tratar/rejeitar/adivinhar/aproximar/julgar/avaliar/chutar/estimar
maquinar	planejar
maquiar	embelezar/empetecar/embonecar/cuidar-se
manejar	manusear/manejar/manipular/manusear/tocar
malhar	consumir/gastar
machucar	causar_dor/doer/provocar/magoar/ofender/desconcertar/perturbar/confundir/avariar/danificar/ferir/lesar/machucar/lesionar/ferir/lesar/machucar/lesionar/ferir/lesar/machucar/lesionar/indispor/doer/ferir/aleijar/machucar
irar	encolerizar/enraivecer/irar/zangar
intuir	compreender/entender
interpenetrar	traspassar/perfurar/penetrar
intencionar	denominar/designar
incorporada	combinar/misturar
inabilitar	mudar/modificar/alterar
homogeneizar	virar/mudar/tornar/virar/mudar/tornar
guilhotinar	decapitar/degolar
grifar	enfatizar/acentuar/pontuar/marcar
glorificar	enaltecer/louvar/elogiar/mudar/modificar/alterar/mudar/modificar/alterar
germinar	crescer
flertar	fazer/agir/atuar/observar/mirar/olhar/ver/dialogar/falar
flabelar	agitar/sacudir/tremer
fingir	simular/fingir/fazer/representar/atuar/desmentir/atuar/comportar-se/agir/parecer
fiar	financiar/manter/construir/confeccionar/fabricar
fervilhar	estar_furioso/estar_enraivecido
extender	alongar/alongar
experienciar	receber/sofrer/experimentar/alterar/mudar
exorcizar	dividir/ejetar/separar/excluir
eternizar	mudar/modificar/alterar
estragar	avariar/danificar/avariar/danificar/avariar/danificar/amenizar/virar/mudar/tornar
estalar	soar/ressoar/fazer/deslocar/mexer/mover/soltar/emitir
estagnar	estar/ser
esquartejar	dividir
esfaquear	empurrar/propulsionar/ferir/lesar/machucar/lesionar
escamotear	lançar/atirar/jogar
esboroar	mudar
esbanjar	gastar/despender/gastar/despender/esbanjar/desperdiçar/dilapidar/delapidar
entreter	entreter/divertir/sentir/experimentar
enrijecer	endurecer/inrijecer/enrijecer/endurecer/amenizar/mudar/modificar/alterar
enlatar	preservar/conservar
enlamear	contaminar/macular/manchar/sujar/contaminar/macular/manchar/sujar/mudar/modificar/alterar
engraxar	cobrir/tampar
enforcar	executar
encostar	estar/deslocar/mexer/mover/tocar/encostar/tocar/encostar
encolher	diminuir/reduzir/reduzir/diminuir
encapuzar	cobrir/tampar/cobrir
encadear	arranjar/dispor/prender/fixar
embriagar	tomar/beber/tomar/beber/afetar/afectar
dragar	tirar/remover/retirar
domesticar	adequar/ajustar/adaptar/adequar/ajustar/adaptar/mudar/modificar/alterar
doer	estar/ser/aparecer_como/parecer/aperceber/entender/perceber/aperceber-se/desconcertar/perturbar/confundir/indispor
divertir	entreter/divertir/alentar/animar/alegrar
dilapidar	gastar/despender
dilacerar	provocar/magoar/ofender
digerir	compreender/entender/alterar/mudar
desprender	tirar/remover/retirar
despersonalizar	mudar/modificar/alterar
desmarcar	tirar/remover
desinformar	informar
desencontrar	estar/ser
descerrar	descobrir/revelar/trazer/informar/contar
desatar	abrir
desagravar	penalizar/punir/castigar
desabonar	esnobar/ignorar/menosprezar/deixar_de_lado/desconsiderar/descartar
deprimir	parecer/impressionar/comover/afetar/reduzir/diminuir
decantar	entornar/verter/derramar
debruçar	torcer/dobrar/curvar/vergar
cozinhar	construir/confeccionar/fabricar/construir/confeccionar/fabricar/mudar
contradizer	demonstrar/validar
condescender	interagir/fazer/agir/atuar/fazer/agir/atuar
cochilar	dormitar/sonecar/cochilar/dormir/capotar/repousar/descansar/cochilar/dormir
cegar	mudar/modificar/alterar/mudar/modificar/alterar
catar	assear/limpar/purgar/ajuntar/coletar/coligir/reunir/recolher/juntar
camuflar	disfarçar/mascarar/esconder/encobrir
banhar	cobrir/revestir
automatizar	mudar/modificar/alterar/mudar/modificar/alterar
atrofiar	enrugar/murchar
aterrar	vir/chegar/vir/chegar
arredar	deslocar/mover
arejar	secar/enxugar
aquilatar	determinar
apor	anexar/juntar/unir
apodrecer	deteriorar/piorar/degenerar/degradar
anuir	gesticular/transmitir/comunicar
antagonizar	fazer/agir/atuar
angustiar	sofrer/desconcertar/perturbar/confundir/desconcertar/perturbar/confundir/emocionar/disturbar/perturbar
amealhar	gastar/despender
amalgamar	mudar/modificar/alterar
alfinetar	provocar/magoar/ofender/perfurar/furar/prender/fixar
alagar	completar/encher
aguar	prover/suprir/abastecer/fornecer/molhar
agastar	desgostar/desagradar
agasalhar	virar/mudar/tornar
agarrar	agarrar/pegar/tomar/segurar/agarrar/capturar/pegar/segurar/agarrar/capturar/pegar/segurar/agarrar/capturar/pegar/segurar/agarrar/capturar/pegar/segurar/agarrar/capturar/pegar
afagar	tratar/afagar/acariciar/afagar/acariciar/afagar
adubar	cobrir/tampar/transformar/converter/transmudar
vulgarizar	mudar/modificar/alterar/atuar/comportar-se/agir/parecer
volver	virar-se/tornar-se/virar
vocalizar	cantar/falar/contar/dizer/enunciar/articular/falar/dizer/pronunciar/enunciar/articular/falar/dizer/pronunciar/enunciar/articular/falar/dizer/pronunciar/proferir/falar/dizer/verbalizar/conversar
vivificar	mudar/modificar/alterar/excitar/energizar/animar/estimular
vitalizar	fortalecer/fortificar/mudar/modificar/alterar
vindicar	absolver/inocentar
vidrar	alterar/mudar
vendar	cobrir/tampar
valorar	determinar
valar	escavar
usinar	fazer/causar/provocar/criar
troçar	atuar/comportar-se/agir/parecer
tropeçar	ir/caminhar/andar/ir/caminhar/andar/deslocar/mexer/mover/deslocar/mexer/mover/errar/equivocar/confundir
triturar	fragmentar
trincar	abocanhar/morder
triangular	medir/mensurar
tremular	agitar/sacudir/tremer/tremular/tiritar/estremecer/tremer
transvazar	entornar/verter/derramar
transbordar	estar_furioso/estar_enraivecido/completar/encher
topar	receber/obter/comprar/adquirir
tingir	descolorir/colorir
territorializar	organizar/mudar/modificar/alterar
tergiversar	desinformar/enganar
tensionar	estreitar/apertar/mudar/modificar/alterar/afetar/afectar
talhar	operar/funcionar
subsumir	incluir/abarcar/conter
substanciar	estar/ser/fazer/causar/provocar/criar/fortalecer/fortificar
subjazer	jazer/estar/ser
sorver	beber/tomar/papar/alimentar_se/comer/ingerir/tomar/consumir
sorrir	exprimir/expressar/mostrar
soletrar	recitar
secar	secar/mudar/modificar/alterar/alterar/mudar
satanizar	mudar/modificar/alterar
salivar	reagir/agir_involuntariamente/agir_reflexivamente
ruborizar	descolorir/colorir
rosar	descolorir/colorir
romancear	transformar/converter/transmudar
roer	abocanhar/morder/abocanhar/morder/mastigar/mascar
rir	expressar_sentimentos/zombar/ironizar/menosprezar
rimar	combinar/corresponder/concordar/verbalizar
reverberar	soar/ressoar/fazer/soar/ressoar/fazer/indicar/mostrar/apontar
retrogradar	viajar/ir/caminhar/andar
resvalar	deslizar/passar_gradativamente_a/escorregar
respingar	entornar/verter/derramar
replantar	colocar/pôr/plantar
remoer	reiterar/redizer/repetir/reapresentar
remir	trocar
reimprimir	reproduzir
regozijar	sentir/experimentar
refrigerar	esfriar/refrigerar/refrescar/resfriar/preservar/conservar/mudar/modificar/alterar
recortar	fazer/causar/provocar/criar/encurtar/encolher
reclinar	inclinar/debruçar/colocar/carregar/botar/pôr
reatribuir	imputar/atribuir
rearranjar	arranjar/dispor
raptar	tomar/capturar/pegar/tomar/capturar/pegar
rabiscar	escrever/redigir
pulular	zumbir/apinhar
pré-pagar	pagar
profetizar	evidenciar/sugerir/indicar/sinalizar/denotar
predizer	evidenciar/sugerir/indicar/sinalizar/denotar/julgar/avaliar/balizar
predicar	impelir/exortar/urgir
pontificar	dialogar/falar
piscar	irradiar/radiar/reagir/agir_involuntariamente/agir_reflexivamente
pingar	precipitar/cair/entornar/verter/derramar/descer/baixar/cair
petrificar	amortecer/enfraquecer
perverter	mudar/modificar/alterar
peregrinar	passar/viajar
pentear	cuidar-se
pendurar	prender/fixar/prender/fixar/prender/fixar
parir	receber/sofrer/experimentar/dar_à_luz/ter/parir/dar_à_luz/ter/parir/dar_à_luz/ter/parir/dar_à_luz/ter/parir/dar_à_luz/ter/parir/dar_à_luz/ter/parir/dar_à_luz/ter/parir
parafrasear	reiterar/redizer/repetir/reapresentar
palpitar	agitar/sacudir/tremer/pulsar/pulsar
palestrar	leccionar/instruir/ensinar/lecionar
paganizar	mudar/modificar/alterar
ondular	deslocar/mexer/mover/alterar/mudar
nadar	estar/ser/viajar/ir/caminhar/andar/viajar/ir/caminhar/andar/viajar/ir/caminhar/andar
mutuar	deslocar/mexer/mover
morder	abocanhar/morder/abocanhar/morder/perfurar/furar/agarrar/segurar/mastigar/mascar
mitificar	fabricar/manufaturar/inventar/compreender/entender/mudar/modificar/alterar
mistificar	iludir/lograr/enganar
minutar	escrever/compor
minerar	explorar/minar/escavar/minerar
militarizar	mudar/modificar/alterar/mudar/modificar/alterar
mendigar	pedir_esmola/pedir/mendigar
martelar	forjar/transformar/bater/bater_repetidamente
maltratar	tratar/tratar/manusear/tocar
maldizer	discutir/conversar/falar
malbaratar	gastar/despender
magoar	sofrer/avariar/danificar
madurar	mudar/modificar/alterar
liquefazer	virar/mudar/tornar/mudar
lesionar	doer/ferir/aleijar/machucar
lapidar	o_fazendeiro_matou_um_porco_para_o_natal./matar
justiçar	executar/assassinar/matar/despachar
jungir	anexar/juntar/unir
jorrar	chover/chover_a_cântaros/chover_a_potes/chover_canivetes/chover_fortemente/fluir/correr/manar/fluir/correr
jazer	estar/estar/estar/ser
içar	alçar/erguer/elevar/levantar
invejar	ansiar/desejar/querer
injuriar	encolerizar/enraivecer/irar/zangar
infectar	causar/provocar/dar/parecer/impressionar/comover/afetar
incandescer	alterar/mudar
imunizar	defender/proteger
imortalizar	mudar/modificar/alterar
imergir	traspassar/perfurar/penetrar/papar/alimentar_se/comer
hidrogenar	mudar/modificar/alterar
guerrear	disputar/lutar/brigar
gesticular	transmitir/comunicar
gemer	soltar/emitir/soltar/emitir/chorar/choramingar
gelar	solidificar/esfriar/refrigerar/refrescar/resfriar/mudar/modificar/alterar/alterar/mudar
flanquear	jazer/viajar/ir/caminhar/andar
filosofar	raciocinar/cogitar/pensar/refletir
ferver	reduzir/diminuir/virar/mudar/tornar/mudar/modificar/alterar/alterar/mudar
fermentar	estar_furioso/estar_enraivecido
exteriorizar	deslocar/mover
expatriar	expulsar
excursionar	andar/viajar
excitar	intoxicar/elevar/emocionar/disturbar/perturbar/estimular/excitar/emocionar/comover/estimular/excitar/emocionar/comover/estimular/excitar/emocionar/comover/mudar/modificar/alterar/mudar/modificar/alterar/afetar/afectar
europeizar	mudar/modificar/alterar/mudar/modificar/alterar
eufemizar	significar/denotar
estressar	afetar/afectar
estratificar	colocar/carregar/botar/pôr/arranjar/dispor/distinguir/separar/diferenciar/alterar/mudar/fecundar/inseminar/fertilizar
estirar	ferir/lesar/machucar/lesionar
estilizar	fazer/causar/provocar/criar/escrever/redigir
esticar	deslocar/mexer/mover/tirar/puxar/arredar/gesticular/enunciar/articular/falar/dizer/pronunciar/alongar/aumentar/crescer/deformar/alongar/esticar/estender/estressar/tensionar
estandardizar	regularizar/regulamentar/estimar/avaliar/medir
estalinizar	transformar/transubstanciar/transmudar
esquiar	viajar/ir/caminhar/andar
esquematizar	imaginar/planejar/mudar/modificar/alterar
espreitar	esconder/encobrir/omitir/tampar/tapar/acobertar/ocultar
espaçar	colocar/carregar/botar/pôr
esmiuçar	separar/desintegrar
esfomear	privar
esfarrapar	cindir/rasgar/dividir
escusar	desculpar/perdoar/desculpar/perdoar/desculpar/perdoar
escurecer	escurecer/mudar/modificar/alterar/alterar/mudar
escorregar	escapar/fugir/escapulir/foragir/deslizar/passar_gradativamente_a/escorregar/viajar/ir/caminhar/andar/viajar/ir/caminhar/andar
escorraçar	expulsar/expulsar
escorar	prender/fixar
escarnecer	simular/imitar/copiar/zombar/ironizar/menosprezar
escaldar	queimar/atear_fogo
enxertar	unir/juntar
envelhecer	desenvolver/progredir/desenvolver/progredir/mudar/modificar/alterar
entristecer	sentir/experimentar/parecer/impressionar/comover/afetar
ensacar	empacotar/encaixotar
enraivecer	encolerizar/enraivecer/irar/zangar/sentir/experimentar
engravidar	virar/mudar/tornar/fecundar/inseminar/fertilizar
engenhar	planejar
engarrafar	colocar/carregar/botar/pôr
enfurecer	irritar_se/zangar_se/enraivecer/encolerizar/enraivecer/irar/zangar/encolerizar/enraivecer/irar/zangar/encolerizar/enraivecer/irar/zangar/encolerizar/enraivecer/irar/zangar/sentir/experimentar
enfileirar	jazer/levantar/ficar_de_pé/arranjar/dispor
enfiar	forçar/empurrar/fechar_(se)
enfeitar	mudar/modificar/alterar
enfadar	provocar/aborrecer/irritar/molestar/importunar/incomodar/assediar
encilhar	anexar/juntar/unir
encharcar	servir/fornecer/prover/provisionar/abastecer/completar/encher/inundar
encerar	cobrir/tampar
emparelhar	balancear/equilibrar/compensar/reunir/unificar/arranjar/dispor/unir/acoplar/juntar
emparedar	defender/proteger
empalidecer	descolorir/colorir
embrulhar	cobrir/tampar/cobrir/tampar/cobrir/embrulhar/embalar
embrenhar	escapar/evadir-se/fugir
embotar	reduzir/diminuir
embolar	involver
emassar	cobrir/tampar/cobrir/revestir
eletrizar	estimular/excitar/emocionar/comover/completar/encher
duelar	disputar/lutar/brigar
domar	adequar/ajustar/adaptar/conter/limitar/restringir/mudar/modificar/alterar
dinamitar	fazer/causar/provocar/criar
desumanizar	desvalorizar/rebaixar/aviltar/degradar
destravar	abrir
destratar	tratar
desterrar	expulsar
despir	tirar/remover/retirar
desnudar	tirar/remover/retirar
desnortear	desconcertar/perturbar/confundir
deslizar	deslizar/passar_gradativamente_a/escorregar/deslizar/passar_gradativamente_a/escorregar/deslocar/mover/deslocar/mover/viajar/ir/caminhar/andar/viajar/ir/caminhar/andar
deslindar	separar/desintegrar
deserdar	privar
desentranhar	tirar/remover/retirar
desembaraçar	cuidar-se
desdenhar	exprimir/expressar/mostrar
desassociar	distinguir/separar/diferenciar
desarmonizar	mudar/modificar/alterar
desamarrar	mudar/modificar/alterar
desafinar	mudar/modificar/alterar
desacatar	rejeitar/recusar
desabrochar	desenvolver/progredir/aumentar/crescer
desabilitar	mudar/modificar/alterar
depravar	mudar/modificar/alterar
depenar	jogar_fora
demonizar	mudar/modificar/alterar
degredar	expulsar
defraudar	vitimar/victimizar/trapacear/defraudar/calotear
decorar	estar/ser/arranjar/dispor/mudar/modificar/alterar
debochar	esnobar/ignorar/menosprezar/deixar_de_lado/desconsiderar/descartar
curtir	celebrar/transformar/converter/transmudar
crucificar	limitar/controlar/refrear/executar/provocar/aborrecer/irritar/molestar/importunar/incomodar/assediar
cravar	prender/fixar/anexar/juntar/unir/anexar/juntar/unir
correlatar	conectar/associar/relacionar
convalescer	melhorar
contagiar	causar/provocar/dar
consternar	intimidar/aterrorizar/amedrontar/assustar/atemorizar
conotar	exprimir/expressar/mostrar
conjeturar	imaginar
confortar	aliviar/melhorar/atenuar/amenizar
concretar	cobrir/tampar
complexificar	alterar/mudar
compartimentar	dividir/separar/partir
comover	parecer/impressionar/comover/afetar
clicar	soar/ressoar/fazer/deslocar/mexer/mover/enunciar/articular/falar/dizer/pronunciar
clarificar	enfatizar/acentuar/pontuar/leccionar/instruir/ensinar/lecionar/derreter/fundir/mudar/modificar/alterar
circundar	incluir/abarcar/conter
cimentar	cobrir/tampar/cobrir/revestir
cicatrizar	melhorar
chover	chover/chover_a_cântaros/chover_a_potes/chover_canivetes/chover_fortemente/precipitar/cair/chover
chapar	cobrir/revestir
chacinar	o_fazendeiro_matou_um_porco_para_o_natal./matar
catequizar	leccionar/instruir/ensinar/lecionar
categorizar	raciocinar
catapultar	propulsionar/propulsar/tocar/impulsionar
carpir	soltar/emitir
canonizar	glorificar/louvar/exaltar/julgar/declarar
caducar	perder/jogar_fora/deixar_passar
buzinar	soar/ressoar/fazer/soar/ressoar
brilhar	estar/ser/estar/ser/irradiar/radiar/parecer/sentir/experimentar/sentir/experimentar/acontecer/ocorrer/suceder/passar/iluminar-se/iluminar
bramir	soltar/emitir
berrar	soltar/emitir/soltar/emitir/mostrar/anunciar/proferir/falar/dizer/verbalizar/conversar/proferir/falar/dizer/verbalizar/conversar/verbalizar/exprimir/proferir/expressar/berrar/gritar
benzer	gesticular
balancear	portar
açambarcar	governar/reger
azedar	virar/mudar/tornar
aviar	enviar/embarcar/despachar/transportar/trazer/expedir
autopsiar	ver/examinar/inspecionar
auditar	examinar/analizar
atraiçoar	iludir/lograr/enganar
atear	mudar/modificar/alterar
assombrar	parecer/impressionar/comover/afetar
assentir	transmitir/comunicar
assar	construir/confeccionar/fabricar/cozinhar/cozinhar
arrumar	organizar/fazer/causar/provocar/criar/arranjar/dispor/arranjar/dispor/servir/fornecer/prover/provisionar/abastecer/acertar/ajustar/corrigir/ordenar/arrumar/organizar/cuidar-se/cuidar-se
arremessar	deslocar/mexer/mover/lançar/atirar/jogar
arrebanhar	deslocar/mover
arder	sentir/experimentar/queimar/carburar/queimar/carburar/queimar/carburar
arar	trabalhar
aplainar	alisar/alisar/modelar/formar
amputar	tirar/remover/retirar
alegrar	alegrar-se/regozijar-se/regozijar/alegrar/alegrar-se/regozijar-se/regozijar/alegrar/sentir/experimentar
ajoelhar	soar/tocar
aguentar	sobreviver/aguentar/lidar/virar-se/fazer/agir/atuar/resistir/deixar/permitir/consentir/deixar/permitir/consentir/suportar/tolerar/aguentar/aturar
agachar	torcer/dobrar/curvar/vergar/sentar/sentar-se/estar_sentado
afiar	aprofundar/intensificar/deformar/mudar/modificar/alterar
aerotransportar	transportar/levar/carregar
admoestar	avisar/alertar/advertir
adjudicar	causar/provocar/dar/resolver/decidir
aculturar	lustrar/refinar/polir
acovardar	torcer/dobrar/curvar/vergar
acorrentar	deter/manter/prender/confinar/reter/atar/amarrar
aconchegar	colocar/carregar/botar/pôr
acabrunhar	desconcertar/perturbar/confundir
abastardar	corromper/perverter/subverter/aviltar/depravar/viciar/desvirtuar/julgar/declarar
abarrotar	completar/encher/completar/encher
abalroar	deslocar/mover/bater/colidir/atingir