partido	integridade
são	bem-estar/bem_estar/saúde
novo	idade
grande	magnitude/dimensão/tamanho/medida
liberal	ideologia
pequeno	magnitude/dimensão/tamanho/medida
importante	magnitude/importância
alto	grau/gritaria/volume/intensidade_sonora
superior	calibre/qualidade
antigo	idade
prestes	preparação/prontidão/rapidez
bom	bondade/virtude
comercial	comércio/mercantilismo/comercialismo
forte	força
amplo	anchura/largura
possível	potenciabilidade/potencial
conservador	ideologia
livre	liberdades_civis/liberdade
existente	realidade/realismo/realidade/verdade
intenso	grau
intelectual	inteligência
ativo	atividade/atividade
humano	humanidade
presente	presença
jovem	idade
próximo	distância/distância/distância/distância
crítico	crise
capaz	habilidade
curto	duração
velho	idade/idade
claro	luminosidade
leal	lealdade
verdadeiro	verdade
baixo	grau
fiel	lealdade
integral	integridade
difícil	dificuldade
disposto	preparação/prontidão/rapidez
diferente	semelhança/similardidade
ausente	presença
dominante	classe/condição/posição/status/estado
alta	gritaria/volume/intensidade_sonora
largo	anchura/largura
falso	verdade
potencial	potenciabilidade/potencial
inferior	calibre/qualidade
doente	bem-estar/bem_estar/saúde
boa	bondade/virtude
parcial	integridade
analfabeto	alfabetização/alfabetismo
perto	distância/distância
estreito	anchura/largura
vizinho	distância/distância
pronto	preparação/prontidão/rapidez
inativo	atividade
baixa	grau
inteiro	integridade
sexual	sexo/sexualidade/gênero
incapaz	habilidade
sensível	sensibilidade
convencional	convenção
longe	distância/distância
líquido	estados_físicos_da_matéria/fases_da_matéria
valente	coragem/ânimo/denodo
funcional	função/propósito
similar	semelhança/similardidade
sólido	estados_físicos_da_matéria/fases_da_matéria
subordinado	classe/condição/posição/status/estado
distante	distância/distância/distância/distância
intensivo	grau
frio	temperatura_do_ar/calor/temperatura/temperatura/temperatura_do_ar/calor/temperatura/temperatura
meridional	estados_confederados_da_américa
leve	peso
fino	textura
oriental	levante/oriente/nascente/oriente/do_leste
ambicioso	aspiração/ambição
delicado	força
estreita	anchura/largura
vário	diversidade
brilhante	luminosidade
preparado	preparação/prontidão/rapidez
confiante	confiança
inteligente	inteligência
saudável	bem-estar/bem_estar/saúde
pesado	peso
vertical	orientação
incômodo	conforto
alarmante	consternação/medo/estupefação
árduo	dificuldade
caloroso	temperatura_do_ar/calor/temperatura/temperatura
tímido	confiança
receoso	consternação/temor/medo/terror
horizontal	orientação
corajoso	coragem/ânimo/denodo
suave	grau/gritaria/volume/intensidade_sonora
quente	temperatura_do_ar/calor/temperatura/temperatura
maduro	idade
inseguro	confiança
insalubre	bem-estar/bem_estar/saúde
bravo	coragem/ânimo/denodo
sulista	estados_confederados_da_américa/estados_confederados_da_américa
incrível	credibilidade
irreal	realidade/realismo/realidade/verdade
errado	verdade
arrojado	coragem/ânimo/denodo
relutante	disposição/temperamento
inquietante	consternação/medo/estupefação
inclinado	orientação
gasoso	estados_físicos_da_matéria/fases_da_matéria
débil	força
corriqueiro	convenção
confortável	conforto
varão	sexo/sexualidade/gênero
luminoso	luminosidade
longínquo	distância/distância
imaturo	idade
valoroso	coragem/ânimo/denodo
perpendicular	orientação
macho	sexo/sexualidade/gênero
estúpido	inteligência
doentio	bem-estar/bem_estar/saúde
desconfortável	conforto
brava	coragem/ânimo/denodo
subordinada	classe/condição/posição/status/estado
sarcástico	sátira/ironia/sarcasmo
radiante	luminosidade
quebrado	integridade
mensurável	grandeza/número/magnitude
intrincado	dificuldade
fresco	temperatura_do_ar/calor/temperatura/temperatura
excitante	excitação/excitamento
emocionante	excitação/excitamento