sul	região_geográfica/região/área_geográfica
sem	homem
nome	distrito/arraial/aldeia/povoado/vila/burgo
maria	progenitora/mãe
pedro	santo
paraná	rio
porto	porto
santos	porto
recife	porto
morte	creatura_imaginaria/ser_imaginario
eduardo	santo/santo
natal	distrito/território/domínio/comarca/districto/circunscrição/circunscrição_administrativa
norte	região_geográfica/região/área_geográfica
joaquim	compositor
inácio	santo
levante	região_geográfica/região/área_geográfica
amazonas	rio
américa	relevo_(geografia)/chão/terra_firme/terra/relevo/solo
sete	homem
belém	distrito/arraial/aldeia/povoado/vila/burgo/porto
virgílio	poetas/poeta/poetisa
maurício	nação/país/terra
paris	distrito/arraial/aldeia/povoado/vila/burgo
plínio	escritor/autor
acre	distrito/arraial/aldeia/povoado/vila/burgo/porto/distrito/território/domínio/comarca/districto/circunscrição/circunscrição_administrativa
benedito	santo
lisboa	porto
hugo	poetas/poeta/poetisa
nilo	rio
gilberto	poetas/poeta/poetisa
deus	ser_sobrenatural/espirito
cuba	ilha/nação/país/terra
lucas	produtores_de_cinema/cineasta/produtor_cinematográfico
israel	nação/país/terra
tiago	santo
ilha	ilha
cabo	província/estado
jesus	hebreu/judeu/hebraico/hebreia/judia/hebraica
domingos	nação/país/terra
assunção	porto
frederico	distrito/arraial/aldeia/povoado/vila/burgo
tiro	porto
aragão	escritor/autor/distrito/território/domínio/comarca/districto/circunscrição/circunscrição_administrativa
horácio	poetas/poeta/poetisa
petrônio	escritor/autor
sudeste	região_geográfica/região/área_geográfica/região_geográfica/região/área_geográfica
john	santo
redonda	ilha
américas	relevo_(geografia)/chão/terra_firme/terra/relevo/solo
nazaré	distrito/arraial/aldeia/povoado/vila/burgo
lafayette	distrito/arraial/aldeia/povoado/vila/burgo
madeira	rio/ilha
senhor	ser_sobrenatural/espirito
cristo	hebreu/judeu/hebraico/hebreia/judia/hebraica
jordão	rio
urss	nação/país/terra
tomás	santo
parnaíba	rio
noroeste	região_geográfica/região/área_geográfica
sena	rio
simão	santo
leonardo	escritor/autor
montenegro	região_geográfica/região/área_geográfica
tchecoslováquia	região_geográfica/região/área_geográfica
sudoeste	região_geográfica/região/área_geográfica
rute	mulher/esposa
caribe	mar/região_geográfica/região/área_geográfica
rússia	nação/país/terra/nação/país/terra
ovídio	poetas/poeta/poetisa
raquel	mulher/esposa
nicolau	santo
sol	estrela/estrela
thomas	santo
setúbal	porto
malta	ilha/nação/país/terra
lídia	região_geográfica/região/área_geográfica
homero	poetas/poeta/poetisa
hamilton	porto
estêvão	escritor/autor
amarelo	rio
mateus	santo
james	escritor/autor
turquia	nação/país/terra
hamburgo	porto
austrália	nação/país/terra
nápoles	porto
formosa	ilha/ilha
jr.	artista/intérprete/actor/ator
cairo	distrito/arraial/aldeia/povoado/vila/burgo/porto
tomé	santo
chicago	porto
america	relevo_(geografia)/chão/terra_firme/terra/relevo/solo
suriname	rio
barcelona	porto
grã-bretanha	ilha
sara	mulher/esposa
haiti	ilha/nação/país/terra
marcial	poetas/poeta/poetisa
texas	porto
lagos	porto
adão	homem
eva	mulher
argel	porto
mediterrâneo	mar
oslo	porto
houston	porto
reno	rio
indonésia	nação/país/terra
columbia	distrito/arraial/aldeia/povoado/vila/burgo
colorado	rio/rio
utopia	livro
galiléia	região_geográfica/região/área_geográfica
himalaia	serra/cadeia_de_montanhas/cadeia_montanhosa/cordilheira
monroe	distrito/arraial/aldeia/povoado/vila/burgo/distrito/arraial/aldeia/povoado/vila/burgo
kansas	rio/distrito/arraial/aldeia/povoado/vila/burgo
helsinque	porto
selma	distrito/arraial/aldeia/povoado/vila/burgo
cartagena	porto
beira	porto
ucrânia	nação/país/terra
irlanda	ilha
cingapura	ilha
servia	região_geográfica/região/área_geográfica
ohio	rio
hull	porto
filipinas	nação/país/terra
tigre	rio
luanda	porto
guadalupe	ilha
vichy	distrito/arraial/aldeia/povoado/vila/burgo
sevilha	porto
princeton	distrito/arraial/aldeia/povoado/vila/burgo
granada	nação/país/terra
dublin	porto
chade	lago
california	distrito/arraial/aldeia/povoado/vila/burgo
antuérpia	porto
taiwan	ilha/ilha
pirâmide	monumento/monumentos
peter	santo
manhattan	ilha
havaí	ilha
diabo	ser_sobrenatural/espirito
canaã	região_geográfica/região/área_geográfica
andes	serra/cadeia_de_montanhas/cadeia_montanhosa/cordilheira
zelândia	ilha
túnis	porto
trípoli	porto
tennessee	rio
salina	distrito/arraial/aldeia/povoado/vila/burgo
palermo	porto
goethe	poetas/poeta/poetisa
glasgow	porto
congo	rio
baltimore	porto
açores	ilha
xangai	porto
timor	ilha
sussex	condado/condados_do_reino_unido
rebeca	mulher/esposa
prússia	região_geográfica/região/área_geográfica
maryland	porto
marselha	porto
jamaica	ilha/nação/país/terra
chipre	ilha/nação/país/terra
barbuda	ilha
trinidad	ilha
mascate	porto
gibraltar	assentamento/colônia
catalunha	distrito/território/domínio/comarca/districto/circunscrição/circunscrição_administrativa
casablanca	porto
bordeaux	porto
baviera	província/estado
barém	ilha
apeninos	serra/cadeia_de_montanhas/cadeia_montanhosa/cordilheira
wiesbaden	balñaei
valparaíso	porto
tobago	ilha
paramaribo	porto
osaka	porto
nantes	porto
málaga	porto
mombaça	porto
lícia	região_geográfica/região/área_geográfica
kobe	porto
doha	porto
corinto	porto
canárias	ilha
cannes	porto
bordéus	porto
babilônia	região_geográfica/região/área_geográfica
adriático	mar
surrey	condado/condados_do_reino_unido
núbia	região_geográfica/região/área_geográfica
lawrence	distrito/arraial/aldeia/povoado/vila/burgo
hong-kong	porto
gotemburgo	porto
freetown	porto
fenícia	região_geográfica/região/área_geográfica
ebro	rio
delaware	rio
calvário	montanha/barranco/ladeira/colina/morro/monte
bahrein	ilha
bahamas	nação/país/terra
alexandria	porto
yokohama	porto
voltaire	escritor/autor
victoria	porto
vancouver	distrito/arraial/aldeia/povoado/vila/burgo/porto
toulon	porto
sérvia	região_geográfica/região/área_geográfica
sião	montanha/barranco/ladeira/colina/morro/monte
silésia	região_geográfica/região/área_geográfica
sicília	ilha
sibéria	região_geográfica/região/área_geográfica
saxônia	região_geográfica/região/área_geográfica
samoa	ilha/nação/país/terra
salônica	porto
renânia	região_geográfica/região/área_geográfica
neolítico	tempo/etapa/período/tempo/etapa/período
nagasaki	porto
monterey	distrito/arraial/aldeia/povoado/vila/burgo
mongólia	região_geográfica/região/área_geográfica
midland	distrito/arraial/aldeia/povoado/vila/burgo
manchúria	região_geográfica/região/área_geográfica
mallorca	ilha
liverpool	porto
latrão	locação/sítio/lugar
java	ilha
ithaca	distrito/arraial/aldeia/povoado/vila/burgo
islândia	ilha
horacio	poetas/poeta/poetisa
hongkong	porto
hiroshima	porto
havai	ilha
galícia	região_geográfica/região/área_geográfica
essex	condado/condados_do_reino_unido
escandinávia	região_geográfica/região/área_geográfica
durban	porto
dumas	escritor/autor
detroit	porto
danúbio	rio
curaçao	ilha
creta	ilha
charleston	porto
catulo	poetas/poeta/poetisa
bósnia	província/estado
bengala	região_geográfica/região/área_geográfica
barbados	ilha/nação/país/terra
bali	ilha
bach	compositor
arcádia	região_geográfica/região/área_geográfica
aral	lago
acapulco	porto
willard	educador/educacionista/pedagogo
watertown	distrito/arraial/aldeia/povoado/vila/burgo
volga	rio
villa-lobos	compositor
vieques	ilha
turíngia	região_geográfica/região/área_geográfica
terranova	ilha
sumatra	ilha
satanás	ser_sobrenatural/espirito
portsmouth	distrito/arraial/aldeia/povoado/vila/burgo/porto/porto
pope	poetas/poeta/poetisa
platéias	distrito/arraial/aldeia/povoado/vila/burgo
patagônia	região_geográfica/região/área_geográfica
ourives	escritor/autor
orinoco	rio
níger	rio
normandia	região_geográfica/região/área_geográfica
newport	porto
moravia	região_geográfica/região/área_geográfica
monróvia	porto
messina	porto
mesopotâmia	região_geográfica/região/área_geográfica
mazatlán	porto
maurícia	nação/país/terra
martinica	ilha
maldivas	nação/país/terra
maiorca	ilha
madagascar	ilha
louvre	museu/museus
jonia	região_geográfica/região/área_geográfica
ibéria	região_geográfica/região/área_geográfica
hollywood	bairro/vizinhança
hokkaido	ilha
hipócrates	médico
hesse	escritor/autor
harlem	bairro/vizinhança
hampshire	condado/condados_do_reino_unido
hamburg	porto
haifa	porto
gália	região_geográfica/região/área_geográfica
goa	província/estado
eureka	distrito/arraial/aldeia/povoado/vila/burgo
devon	condado/condados_do_reino_unido
cólquida	região_geográfica/região/área_geográfica
cumaná	porto
celebes	ilha
castries	porto
cantão	porto
cantuária	distrito/arraial/aldeia/povoado/vila/burgo
caledônia	região_geográfica/região/área_geográfica
caim	homem
báltico	mar
bristol	porto
bridgetown	porto
bergen	porto
bancoc	porto
assíria	região_geográfica/região/área_geográfica
aruba	ilha
antígua	ilha
antioquia	distrito/arraial/aldeia/povoado/vila/burgo
andaluzia	região_geográfica/região/área_geográfica
alpes	serra/cadeia_de_montanhas/cadeia_montanhosa/cordilheira
aden	porto